AGE,CANDIDATES,CATEGORY,CONSTITUENCY,GENERAL VOTES POLLED,No,PARTY,POSTAL VOTES POLLED,SEX,TERRITORY,TOTAL VOTES POLLED,TOTAL GENERAL VOTES POLLED,TOTAL POSTAL VOTES POLLED,TOTAL ELECTORS,TOTAL MEN ELECTORS,TOTAL WOMEN ELECTORS,% OF TOTAL VOTES,TOTAL VOTES RECEIVED,% OF TOTAL POLLED
47,YERRANNAIDU KINJARAPU,GEN,SRIKAKULAM,361586,1,TDP,320,M,ANDHRA PRADESH,723774,722856,918,958626,456636,501990,37.752575039692225,361906,50.00262512883856
39,KILLI KRUPARANI,GEN,SRIKAKULAM,329432,2,INC,595,F,ANDHRA PRADESH,723774,722856,918,958626,456636,501990,34.427086267219956,330027,45.59807343176185
49,DUNGA RANGARAO NAIDU,GEN,SRIKAKULAM,13848,5,IND,0,M,ANDHRA PRADESH,723774,722856,918,958626,456636,501990,1.4445675372877431,13848,1.913304429283174
37,MYLAPALLI LAKSHMUDU,GEN,SRIKAKULAM,13008,3,BSP,3,M,ANDHRA PRADESH,723774,722856,918,958626,456636,501990,1.357255071320828,13011,1.797660595710816
37,TAMMINENI JAGANMOHAN RAO,GEN,SRIKAKULAM,4982,4,IND,0,M,ANDHRA PRADESH,723774,722856,918,958626,456636,501990,0.5197021570456049,4982,0.6883364144056018
57,KISHORE CHANDRA SURYANARAYANA DEO,ST,PARVATHIPURAM (ST),321355,1,INC,433,M,ANDHRA PRADESH,660923,660212,711,896336,432612,463724,35.90037664447261,321788,48.687668608899976
35,DADICHILUKA VEERA GOURI SANKARA RAO,ST,PARVATHIPURAM (ST),314098,2,TDP,272,M,ANDHRA PRADESH,660923,660212,711,896336,432612,463724,35.072785205547916,314370,47.565298832087855
32,UOOYAKA MUTYALU,ST,PARVATHIPURAM (ST),13895,4,IND,1,M,ANDHRA PRADESH,660923,660212,711,896336,432612,463724,1.550311490333982,13896,2.102514211186477
55,ARIKA GUMPASWAMY,ST,PARVATHIPURAM (ST),10864,3,IND,5,M,ANDHRA PRADESH,660923,660212,711,896336,432612,463724,1.2126033094732334,10869,1.6445183478256922
73,KONDAPALLI PYDITHALLI NAIDU,GEN,BOBBILI,373469,1,TDP,453,M,ANDHRA PRADESH,746725,745517,1208,976012,474981,501031,38.31120928841039,373922,50.0749271820282
37,JHANSI BOTCHA,GEN,BOBBILI,341850,2,INC,724,F,ANDHRA PRADESH,746725,745517,1208,976012,474981,501031,35.09936353241558,342574,45.87686229870434
55,PEDDINTI JAGANMOHAN RAO,GEN,BOBBILI,16067,4,IND,31,M,ANDHRA PRADESH,746725,745517,1208,976012,474981,501031,1.6493649668241783,16098,2.155813719910275
47,G VENKATESH,SC,BOBBILI,14131,3,TRS,0,M,ANDHRA PRADESH,746725,745517,1208,976012,474981,501031,1.4478305594603345,14131,1.8923967993571928
69,JANARDHANA REDDY NEDURUMALLI,GEN,VISAKHAPATNAM,523889,2,INC,233,M,ANDHRA PRADESH,965740,965365,375,1515574,752037,763537,34.58240904106299,524122,54.27154306542133
65,DR M V V S MURTHY,GEN,VISAKHAPATNAM,393415,3,TDP,136,M,ANDHRA PRADESH,965740,965365,375,1515574,752037,763537,25.967125326773882,393551,40.751237393087166
64,KOLAVENTI SUNDARA RAO,GEN,VISAKHAPATNAM,16673,1,BSP,0,M,ANDHRA PRADESH,965740,965365,375,1515574,752037,763537,1.1001112449804495,16673,1.7264481123283701
59,BHARANIKANA RAMA RAO,GEN,VISAKHAPATNAM,10997,8,IND,5,M,ANDHRA PRADESH,965740,965365,375,1515574,752037,763537,0.7259295817954122,11002,1.1392300205024126
43,MANDEM SUBHASH CHANDRA BOSE YADAV,GEN,VISAKHAPATNAM,5685,4,SP,0,M,ANDHRA PRADESH,965740,965365,375,1515574,752037,763537,0.3751054056087001,5685,0.5886677573674073
60,SATYANARAYANA MACHIRAJU,GEN,VISAKHAPATNAM,5602,10,IND,0,M,ANDHRA PRADESH,965740,965365,375,1515574,752037,763537,0.36962893266841473,5602,0.5800733116573819
28,VAMSI KIRAN B,GEN,VISAKHAPATNAM,2920,6,PPOI,0,M,ANDHRA PRADESH,965740,965365,375,1515574,752037,763537,0.19266627693533936,2920,0.30235881293101663
57,S V B REDDY,GEN,VISAKHAPATNAM,2358,9,IND,0,M,ANDHRA PRADESH,965740,965365,375,1515574,752037,763537,0.15558461678545554,2358,0.24416509619566343
67,MAMIDI SOMUNAIDU,GEN,VISAKHAPATNAM,2017,5,RJD,1,M,ANDHRA PRADESH,965740,965365,375,1515574,752037,763537,0.13315087221079275,2018,0.20895893304616148
63,APPARAO GUDIVADA,GEN,VISAKHAPATNAM,1809,7,IND,0,M,ANDHRA PRADESH,965740,965365,375,1515574,752037,763537,0.11936071745754413,1809,0.1873174974630853
52,MIDIYAM BABU RAO,ST,BHADRACHALAM (ST),372653,3,CPM,495,M,ANDHRA PRADESH,823415,822860,555,1193297,584519,608778,31.27033756055701,373148,45.31712441478477
38,SMT KPRK PHANEESWARAMMA,ST,BHADRACHALAM (ST),319284,2,TDP,58,F,ANDHRA PRADESH,823415,822860,555,1193297,584519,608778,26.761317593189286,319342,38.78263087264624
30,JANNI APPA RAO,ST,BHADRACHALAM (ST),71977,1,BSP,1,M,ANDHRA PRADESH,823415,822860,555,1193297,584519,608778,6.0318596292456945,71978,8.741400144520078
50,KETCHELA RANGA REDDI,ST,BHADRACHALAM (ST),38218,5,IND,1,M,ANDHRA PRADESH,823415,822860,555,1193297,584519,608778,3.2028070128392176,38219,4.641523411645403
25,MADAKAM BHEEMA RAJU,ST,BHADRACHALAM (ST),20728,4,MCPI(S),0,M,ANDHRA PRADESH,823415,822860,555,1193297,584519,608778,1.7370361276362885,20728,2.5173211564035145
58,CHALAPATHIRAO PAPPALA,GEN,ANAKAPALLI,385199,1,TDP,207,M,ANDHRA PRADESH,782106,781747,359,1023113,495523,527590,37.669934797036106,385406,49.27797510823341
57,NANDA GOPAL GANDHAM,GEN,ANAKAPALLI,369841,2,INC,151,M,ANDHRA PRADESH,782106,781747,359,1023113,495523,527590,36.16335634480258,369992,47.30714251009454
50,SADARAM APPALA RAJU,GEN,ANAKAPALLI,26707,3,BSP,1,M,ANDHRA PRADESH,782106,781747,359,1023113,495523,527590,2.6104643377613224,26708,3.41488238167205
41,MALLIPUDI MANGAPATI PALLAM RAJU,GEN,KAKINADA,410826,2,INC,156,M,ANDHRA PRADESH,832284,832052,232,1164984,577524,587460,35.27790939618055,410982,49.38001932032815
48,MUDRAGADA PADMANABHAM,GEN,KAKINADA,353654,3,TDP,76,M,ANDHRA PRADESH,832284,832052,232,1164984,577524,587460,30.36350713829546,353730,42.50111740703894
52,CHANDRAVATHI DWARAMPUDI,GEN,KAKINADA,30153,5,IND,0,F,ANDHRA PRADESH,832284,832052,232,1164984,577524,587460,2.588275890484333,30153,3.622921983361449
67,APPARAO PUAGALA,SC,KAKINADA,16373,1,BSP,0,M,ANDHRA PRADESH,832284,832052,232,1164984,577524,587460,1.4054270273239804,16373,1.9672371450130004
51,NAINALASETTI MURTHY,GEN,KAKINADA,9458,4,CPI(ML)(L),0,M,ANDHRA PRADESH,832284,832052,232,1164984,577524,587460,0.8118566435247179,9458,1.136390943476025
33,PUVVALA ANANDA RAO,SC,KAKINADA,8544,7,IND,0,M,ANDHRA PRADESH,832284,832052,232,1164984,577524,587460,0.7334006303949239,8544,1.026572660293842
39,CHAGANTI SURYANARAYANA MURTHY,GEN,KAKINADA,3044,6,IND,0,M,ANDHRA PRADESH,832284,832052,232,1164984,577524,587460,0.26129114219594435,3044,0.36574054048858323
49,ARUNA KUMAR VUNDAVALLI,GEN,RAJAHMUNDRY,413531,1,INC,396,M,ANDHRA PRADESH,816125,815493,632,1074223,530732,543491,38.532688277946015,413927,50.718578649103996
53,KANTIPUDI SARVARAYUDU,GEN,RAJAHMUNDRY,264942,2,BJP,165,M,ANDHRA PRADESH,816125,815493,632,1074223,530732,543491,24.678953997447458,265107,32.4836268953898
82,S B P B K SATYANARAYANA RAO,GEN,RAJAHMUNDRY,99601,6,IND,70,M,ANDHRA PRADESH,816125,815493,632,1074223,530732,543491,9.278427291167663,99671,12.212712513401748
46,GURRALA PARAMJYOTHI,SC,RAJAHMUNDRY,22597,3,IND,1,M,ANDHRA PRADESH,816125,815493,632,1074223,530732,543491,2.103660040792275,22598,2.7689385817123604
32,PATAMSETTI V V S V PRASAD (BABU),GEN,RAJAHMUNDRY,10192,5,IND,0,M,ANDHRA PRADESH,816125,815493,632,1074223,530732,543491,0.9487787917406348,10192,1.2488283044876705
29,DUGGIREDDY DHARMA REDDY,GEN,RAJAHMUNDRY,4630,4,IND,0,M,ANDHRA PRADESH,816125,815493,632,1074223,530732,543491,0.431009203861768,4630,0.5673150559044264
43,G V HARSHA KUMAR,SC,AMALAPURAM (SC),349233,3,INC,1113,M,ANDHRA PRADESH,704224,702715,1509,904207,446972,457235,38.74621629781676,350346,49.74922751851684
53,DUNNA JANARDHANA RAO,SC,AMALAPURAM (SC),308468,1,TDP,393,M,ANDHRA PRADESH,704224,702715,1509,904207,446972,457235,34.15821819561229,308861,43.85834620802472
59,MUNEESWARA RAO BHUPATI,SC,AMALAPURAM (SC),26698,4,IND,1,M,ANDHRA PRADESH,704224,702715,1509,904207,446972,457235,2.9527530753466853,26699,3.791265279229336
40,YALANGI RAMESH,SC,AMALAPURAM (SC),9550,5,IND,0,M,ANDHRA PRADESH,704224,702715,1509,904207,446972,457235,1.0561740840316434,9550,1.3561026037169992
59,D MURALIKRISHNA,SC,AMALAPURAM (SC),8766,2,BSP,2,M,ANDHRA PRADESH,704224,702715,1509,904207,446972,457235,0.9696894627004657,8768,1.2450583905121098
67,CHEGONDI VENKATA HARIRAMA JOGAIAH,GEN,NARASAPUR,401002,2,INC,1759,M,ANDHRA PRADESH,768537,765772,2765,996175,491586,504589,40.43074760960674,402761,52.406195147403444
64,UPPALAPATI VENKATAKRISHNAM RAJU,GEN,NARASAPUR,337348,1,BJP,1001,M,ANDHRA PRADESH,768537,765772,2765,996175,491586,504589,33.96481541897759,338349,44.02507621623943
39,ALLURI YUGANDHARA RAJU,GEN,NARASAPUR,27422,3,PPOI,5,M,ANDHRA PRADESH,768537,765772,2765,996175,491586,504589,2.753231108991894,27427,3.5687286363571302
60,KAVURU SAMBA SIVA RAO,GEN,ELURU,497721,1,INC,1470,M,ANDHRA PRADESH,896946,894854,2092,1151672,568841,582831,43.34489333768642,499191,55.65452100795366
77,BOLLA BULLI RAMAIAH,GEN,ELURU,375282,3,TDP,618,M,ANDHRA PRADESH,896946,894854,2092,1151672,568841,582831,32.639501524739686,375900,41.9088774575058
38,D S V KRISHNAJI,GEN,ELURU,8703,2,BSP,4,M,ANDHRA PRADESH,896946,894854,2092,1151672,568841,582831,0.7560312311144146,8707,0.9707384836991302
42,B N V SATYANARAYANA,GEN,ELURU,4776,4,TRS,0,M,ANDHRA PRADESH,896946,894854,2092,1151672,568841,582831,0.41470140803978905,4776,0.5324735268343914
44,S V SUBBARAO,GEN,ELURU,4736,7,IND,0,M,ANDHRA PRADESH,896946,894854,2092,1151672,568841,582831,0.4112281969171778,4736,0.5280139495577214
45,KODURI SRIRAMULU,GEN,ELURU,1904,5,IND,0,M,ANDHRA PRADESH,896946,894854,2092,1151672,568841,582831,0.16532484943629783,1904,0.21227587836948936
57,S V B REDDY,GEN,ELURU,1732,6,IND,0,M,ANDHRA PRADESH,896946,894854,2092,1151672,568841,582831,0.15039004160906927,1732,0.1930996960798086
61,BADIGA RAMAKRISHNA,GEN,MACHILIPATNAM,384956,2,INC,2171,M,ANDHRA PRADESH,755314,752413,2901,993370,488639,504731,38.971078248789475,387127,51.253783194803745
64,AMBATI BRAHMANAIAH,GEN,MACHILIPATNAM,336064,1,TDP,722,M,ANDHRA PRADESH,755314,752413,2901,993370,488639,504731,33.90337940545819,336786,44.58887297203547
46,YENDURI SUBRAHMANYESWARA RAO (MANI),GEN,MACHILIPATNAM,18476,6,IND,1,M,ANDHRA PRADESH,755314,752413,2901,993370,488639,504731,1.8600320122411589,18477,2.4462673801889014
32,ADAPALA SIVANNARAYANA,GEN,MACHILIPATNAM,6196,3,PPOI,5,M,ANDHRA PRADESH,755314,752413,2901,993370,488639,504731,0.6242387025982262,6201,0.8209830613493196
49,DODDA KAMESWARA RAO,GEN,MACHILIPATNAM,4295,5,IND,2,M,ANDHRA PRADESH,755314,752413,2901,993370,488639,504731,0.4325679253450376,4297,0.5689024697013428
42,B S RAO,GEN,MACHILIPATNAM,2426,4,TRS,0,M,ANDHRA PRADESH,755314,752413,2901,993370,488639,504731,0.2442191731177708,2426,0.32119092192121423
40,RAJAGOPAL LAGADAPATI,GEN,VIJAYAWADA,518396,3,INC,1228,M,ANDHRA PRADESH,945550,943767,1783,1464657,732558,732099,35.47752135824292,519624,54.954682459943946
53,ASWINI DUTT CHALASANI,GEN,VIJAYAWADA,404490,1,TDP,547,M,ANDHRA PRADESH,945550,943767,1783,1464657,732558,732099,27.654051426374913,405037,42.836127121780976
51,NANDETI PRABHAKAR RAO,SC,VIJAYAWADA,6468,2,BSP,4,M,ANDHRA PRADESH,945550,943767,1783,1464657,732558,732099,0.44187820083473467,6472,0.6844693564592036
51,KONERU VARA LAKSHMI,GEN,VIJAYAWADA,5102,4,PPOI,3,F,ANDHRA PRADESH,945550,943767,1783,1464657,732558,732099,0.348545768736298,5105,0.5398974142033737
41,SOMESWARA RAO MADALA,GEN,VIJAYAWADA,3039,13,IND,0,M,ANDHRA PRADESH,945550,943767,1783,1464657,732558,732099,0.20748885233880698,3039,0.32140024324467237
60,SYED MOINUDDIN,GEN,VIJAYAWADA,1442,12,IND,1,M,ANDHRA PRADESH,945550,943767,1783,1464657,732558,732099,0.09852136029118082,1443,0.1526095923007773
36,RAMACHANDRA RAO J,GEN,VIJAYAWADA,1268,5,TRS,0,M,ANDHRA PRADESH,945550,943767,1783,1464657,732558,732099,0.08657317037367794,1268,0.13410184548675375
36,DOMAKONDA RAVI KUMAR,SC,VIJAYAWADA,1005,11,IND,0,M,ANDHRA PRADESH,945550,943767,1783,1464657,732558,732099,0.06861674781194504,1005,0.10628734598910689
37,JAKKA TARAKA MALLIKARJUNA RAO,GEN,VIJAYAWADA,637,9,IND,0,M,ANDHRA PRADESH,945550,943767,1783,1464657,732558,732099,0.043491411299710445,637,0.06736819840304584
60,APPARAO DAMALAPATI,GEN,VIJAYAWADA,549,6,IND,0,M,ANDHRA PRADESH,945550,943767,1783,1464657,732558,732099,0.03748317865548043,549,0.05806144571942255
41,GATLA VENKATA NARAYANA REDDY,GEN,VIJAYAWADA,493,7,IND,0,M,ANDHRA PRADESH,945550,943767,1783,1464657,732558,732099,0.03365975788187951,493,0.052138966738935005
41,DONEPUDI SRINIVAS,GEN,VIJAYAWADA,482,10,IND,0,M,ANDHRA PRADESH,945550,943767,1783,1464657,732558,732099,0.03290872880135076,482,0.05097562265348211
42,GOTTUMUKKALA SIVA PRASADARAJU,GEN,VIJAYAWADA,396,8,IND,0,M,ANDHRA PRADESH,945550,943767,1783,1464657,732558,732099,0.027037046899035064,396,0.041880387076304794
36,BALASHOWRY VALLABHANENI,GEN,TENALI,365212,3,INC,1631,M,ANDHRA PRADESH,673462,671316,2146,880148,433606,446542,41.679694778605416,366843,54.471224805556965
67,UMMAREDDY VENKATESWARLU,GEN,TENALI,287775,1,TDP,512,M,ANDHRA PRADESH,673462,671316,2146,880148,433606,446542,32.75437767284593,288287,42.80672109191016
44,DILIP RAAJA DONEPUDI,SC,TENALI,5692,2,BSP,2,M,ANDHRA PRADESH,673462,671316,2146,880148,433606,446542,0.6469366515631462,5694,0.8454820019540821
62,VENKATESWARLU PALLA,GEN,TENALI,5679,7,IND,0,M,ANDHRA PRADESH,673462,671316,2146,880148,433606,446542,0.6452323927339493,5679,0.8432547047940344
42,NARASIMHA REDDY TERA,GEN,TENALI,4183,4,TRS,0,M,ANDHRA PRADESH,673462,671316,2146,880148,433606,446542,0.4752609788353777,4183,0.621118934698617
53,DUGGIRALA RAJA RAMKUMAR,GEN,TENALI,1622,5,IND,1,M,ANDHRA PRADESH,673462,671316,2146,880148,433606,446542,0.18440080531910544,1623,0.24099355271715406
75,MANDALI SUBRAHMANYAM,GEN,TENALI,1153,6,IND,0,M,ANDHRA PRADESH,673462,671316,2146,880148,433606,446542,0.1310006953376023,1153,0.17120490836899485
60,RAYAPATI SAMBASIVA RAO,GEN,GUNTUR,465276,2,INC,945,M,ANDHRA PRADESH,821478,820124,1354,1172954,578860,594094,39.747594534824046,466221,56.753924024745636
71,Y V RAO,GEN,GUNTUR,336023,3,TDP,406,M,ANDHRA PRADESH,821478,820124,1354,1172954,578860,594094,28.682198960914068,336429,40.954109544017
39,JUPALLI HANUMANTHA RAO GOUD,GEN,GUNTUR,9373,1,BSP,2,M,ANDHRA PRADESH,821478,820124,1354,1172954,578860,594094,0.7992640802623121,9375,1.1412356752098047
38,VENKATESWARLU GUNDI,GEN,GUNTUR,5444,4,TRS,0,M,ANDHRA PRADESH,821478,820124,1354,1172954,578860,594094,0.46412732298112286,5444,0.6627079483564988
72,MUVVA VENKAT RAO,GEN,GUNTUR,4008,5,IND,1,M,ANDHRA PRADESH,821478,820124,1354,1172954,578860,594094,0.3417866344289716,4009,0.48802280767105144
44,DAGGUBATI PURANDARESWARI,GEN,BAPATLA,409731,1,INC,1368,F,ANDHRA PRADESH,735462,733677,1785,948929,467315,481614,43.32241927478241,411099,55.89670166507583
67,DAGGUBATI RAMANAIDU,GEN,BAPATLA,316602,2,TDP,415,M,ANDHRA PRADESH,735462,733677,1785,948929,467315,481614,33.40787350792314,317017,43.104470387321165
28,CHELLAMALLA VENKATA REDDY,GEN,BAPATLA,3753,3,TRS,0,M,ANDHRA PRADESH,735462,733677,1785,948929,467315,481614,0.39549850410304666,3753,0.5102914902469469
40,PRATHIPATI SRINIVASU,GEN,BAPATLA,2159,5,IND,0,M,ANDHRA PRADESH,735462,733677,1785,948929,467315,481614,0.2275196563704977,2159,0.2935569750714517
48,INAGANTI APPARAO,GEN,BAPATLA,1432,4,IND,2,M,ANDHRA PRADESH,735462,733677,1785,948929,467315,481614,0.15111773378197949,1434,0.19497948228460477
59,MEKAPATI RAJAMOHAN REDDY,GEN,NARASARAOPET,480034,2,INC,1276,M,ANDHRA PRADESH,899784,897889,1895,1255040,622562,632478,38.35017210606833,481310,53.49172690334569
74,MADDI LAKSHMAIAH,GEN,NARASARAOPET,394439,1,TDP,616,M,ANDHRA PRADESH,899784,897889,1895,1255040,622562,632478,31.477482789393168,395055,43.90553732895895
42,PULIMAMIDI NARSIMHA REDDY,GEN,NARASARAOPET,9621,3,TRS,1,M,ANDHRA PRADESH,899784,897889,1895,1255040,622562,632478,0.7666687914329424,9622,1.0693677593733608
59,GONTU VENKATESWARA REDDY,GEN,NARASARAOPET,8277,4,IND,1,M,ANDHRA PRADESH,899784,897889,1895,1255040,622562,632478,0.6595805711371749,8278,0.9199985774363625
42,PULIMI VENKATARAMI REDDY,GEN,NARASARAOPET,5518,5,IND,1,M,ANDHRA PRADESH,899784,897889,1895,1255040,622562,632478,0.43974694033656303,5519,0.6133694308856348
49,SREENIVASULU REDDY MAGUNTA,GEN,ONGOLE,444257,2,INC,2327,M,ANDHRA PRADESH,799109,795545,3564,1063995,522994,541001,41.97237768974478,446584,55.885242188487425
47,BATHULA VIJAYA BHARATHI,GEN,ONGOLE,339326,1,TDP,1237,F,ANDHRA PRADESH,799109,795545,3564,1063995,522994,541001,32.007951165184046,340563,42.61784061999052
57,ALLA RAMA CHANDRA REDDY,GEN,ONGOLE,4741,3,IND,0,M,ANDHRA PRADESH,799109,795545,3564,1063995,522994,541001,0.4455848006804543,4741,0.5932857720285969
33,SATISH KUMAR,GEN,ONGOLE,2463,9,IND,0,M,ANDHRA PRADESH,799109,795545,3564,1063995,522994,541001,0.23148605021640142,2463,0.30821827810724195
32,RAMA RAO DAGGUPATI,GEN,ONGOLE,1041,7,IND,0,M,ANDHRA PRADESH,799109,795545,3564,1063995,522994,541001,0.09783880563348513,1041,0.1302700883108562
35,NALAMALAPU LAKSHMI NARASA REDDY,GEN,ONGOLE,986,5,IND,0,M,ANDHRA PRADESH,799109,795545,3564,1063995,522994,541001,0.09266960840981396,986,0.12338742274207899
27,VENU BABU NAIDU KAVURI,GEN,ONGOLE,982,8,IND,0,M,ANDHRA PRADESH,799109,795545,3564,1063995,522994,541001,0.09229366679354696,982,0.12288686524616792
42,GUDIPUDI NARASIMHA RAO,GEN,ONGOLE,896,4,IND,0,M,ANDHRA PRADESH,799109,795545,3564,1063995,522994,541001,0.08421092204380659,896,0.11212487908407989
47,BOYALLA RANGANAYAKULU,GEN,ONGOLE,853,6,IND,0,M,ANDHRA PRADESH,799109,795545,3564,1063995,522994,541001,0.08016954966893641,853,0.10674388600303587
46,PANABAKA LAKSHMI,SC,NELLORE (SC),448295,1,INC,1834,F,ANDHRA PRADESH,836502,833825,2677,1153181,568779,584402,39.03368161632909,450129,53.810869549624506
65,BALAKONDAIAH KARUPOTALA,SC,NELLORE (SC),321078,2,BJP,827,M,ANDHRA PRADESH,836502,833825,2677,1153181,568779,584402,27.91452512658464,321905,38.48227499754932
62,MALAKONDAIAH Y,SC,NELLORE (SC),36084,5,SP,1,M,ANDHRA PRADESH,836502,833825,2677,1153181,568779,584402,3.1291705291710494,36085,4.313797217460329
37,MARLAPATI VEMAIAH,SC,NELLORE (SC),9393,3,BSP,2,M,ANDHRA PRADESH,836502,833825,2677,1153181,568779,584402,0.8147029824459473,9395,1.1231294127210694
53,VENKATA RAM RAVINUTHALA,SC,NELLORE (SC),5981,9,IND,2,M,ANDHRA PRADESH,836502,833825,2677,1153181,568779,584402,0.5188257524187443,5983,0.7152403700170472
43,DAVA PENCHALA RAO,SC,NELLORE (SC),3875,7,IND,9,M,ANDHRA PRADESH,836502,833825,2677,1153181,568779,584402,0.33680749162533896,3884,0.46431449058101476
54,MANGALAPURI VENKATESWARLU,SC,NELLORE (SC),3419,4,BRPP,2,M,ANDHRA PRADESH,836502,833825,2677,1153181,568779,584402,0.2966576799305573,3421,0.40896495166777846
40,OURUVURU KRISHNAIAH,SC,NELLORE (SC),3415,6,IND,0,M,ANDHRA PRADESH,836502,833825,2677,1153181,568779,584402,0.2961373799949878,3415,0.4082476790252743
32,MADDELA BRAHMANAIDU,SC,NELLORE (SC),2285,8,IND,0,M,ANDHRA PRADESH,836502,833825,2677,1153181,568779,584402,0.19814755879606064,2285,0.27316133135366083
49,CHINTA MOHAN,SC,TIRUPATHI (SC),509966,1,INC,995,M,ANDHRA PRADESH,850787,848995,1792,1215573,597413,618160,42.03457957687445,510961,60.05745268792306
73,DR N VENKATA SWAMY,SC,TIRUPATHI (SC),310841,2,BJP,792,M,ANDHRA PRADESH,850787,848995,1792,1215573,597413,618160,25.636716182409447,311633,36.62879193029513
27,K ESWAR RAO,SC,TIRUPATHI (SC),16508,3,TRS,0,M,ANDHRA PRADESH,850787,848995,1792,1215573,597413,618160,1.358042667943431,16508,1.9403211379581495
35,KATTAMANCHI PRABHAKAR,SC,TIRUPATHI (SC),11680,4,IND,5,M,ANDHRA PRADESH,850787,848995,1792,1215573,597413,618160,0.9612750529996964,11685,1.3734342438236598
63,D K AUDIKESAVULU,GEN,CHITTOOR,453486,1,TDP,642,M,ANDHRA PRADESH,875992,874438,1554,1170325,577837,592488,38.80358020208062,454128,51.84156932940027
63,DR RAVURI VENKATA SWAMY,GEN,CHITTOOR,391085,2,INC,905,M,ANDHRA PRADESH,875992,874438,1554,1170325,577837,592488,33.49411488261808,391990,44.74812555365803
31,S SAHADEVA REDDY,GEN,CHITTOOR,10430,6,IND,1,M,ANDHRA PRADESH,875992,874438,1554,1170325,577837,592488,0.8912908807382565,10431,1.1907642992173446
42,A MALLA RAO,GEN,CHITTOOR,10257,3,TRS,1,M,ANDHRA PRADESH,875992,874438,1554,1170325,577837,592488,0.876508662123769,10258,1.1710152604133373
46,D A NAGARAJU,GEN,CHITTOOR,5527,4,IND,5,M,ANDHRA PRADESH,875992,874438,1554,1170325,577837,592488,0.4726892102621067,5532,0.6315126165535758
50,SHAIK JEELANI BASHA,GEN,CHITTOOR,3653,5,IND,0,M,ANDHRA PRADESH,875992,874438,1554,1170325,577837,592488,0.3121355179116912,3653,0.4170129407574498
59,ANNAYYAGARI SAI PRATHAP,GEN,RAJAMPET,368290,1,INC,1507,M,ANDHRA PRADESH,691329,688887,2442,991369,487417,503952,37.30165054586133,369797,53.4907402987579
42,GUNIPATI RAMAIAH,GEN,RAJAMPET,290781,2,TDP,931,M,ANDHRA PRADESH,691329,688887,2442,991369,487417,503952,29.42516863044941,291712,42.195828614162
76,HAJI MD AZAM SHAIK,GEN,RAJAMPET,11916,5,IND,3,M,ANDHRA PRADESH,691329,688887,2442,991369,487417,503952,1.2022768515053426,11919,1.724070594463707
47,ASHOKA RAO PEECHARA,GEN,RAJAMPET,11247,3,TRS,0,M,ANDHRA PRADESH,691329,688887,2442,991369,487417,503952,1.1344917987147067,11247,1.6268665136280989
43,MUKKA NARASIMHA REDDY,GEN,RAJAMPET,6653,4,JP,1,M,ANDHRA PRADESH,691329,688887,2442,991369,487417,503952,0.6711930673644223,6654,0.9624939789882966
51,Y S VIVEKANANDA REDDY,GEN,CUDDAPAH,458111,1,INC,3320,M,ANDHRA PRADESH,819201,814047,5154,1143505,560870,582635,40.35233776852747,461431,56.32695760869433
55,VENKATA MYSURA REDDY MULE,GEN,CUDDAPAH,327930,2,TDP,1827,M,ANDHRA PRADESH,819201,814047,5154,1143505,560870,582635,28.83739030437121,329757,40.25349090150036
39,T BHASKAR REDDY,GEN,CUDDAPAH,10250,14,IND,0,M,ANDHRA PRADESH,819201,814047,5154,1143505,560870,582635,0.8963668720294183,10250,1.2512191757578421
38,INDI REDDY THIMMA REDDY,GEN,CUDDAPAH,5240,3,RJD,2,M,ANDHRA PRADESH,819201,814047,5154,1143505,560870,582635,0.4584151359198254,5242,0.6398917970070838
64,VITTA SUBBA RAO,GEN,CUDDAPAH,3931,15,IND,1,M,ANDHRA PRADESH,819201,814047,5154,1143505,560870,582635,0.3438550771531388,3932,0.4799798828370571
34,KONDABOINA SREENIVASULU K,GEN,CUDDAPAH,1757,4,PPOI,2,M,ANDHRA PRADESH,819201,814047,5154,1143505,560870,582635,0.15382530028290214,1759,0.21472141757639457
39,C BALAVARADA REDDY,GEN,CUDDAPAH,1115,13,IND,0,M,ANDHRA PRADESH,819201,814047,5154,1143505,560870,582635,0.09750722559149283,1115,0.1361082322897555
42,B NARAYANA REDDY,GEN,CUDDAPAH,902,5,RPI,1,M,ANDHRA PRADESH,819201,814047,5154,1143505,560870,582635,0.07896773516512827,903,0.11022935763017867
35,PUTHA RAMAPRASADA REDDY,GEN,CUDDAPAH,825,7,ANC,0,M,ANDHRA PRADESH,819201,814047,5154,1143505,560870,582635,0.07214660189505075,825,0.10070788487807023
37,SIVANATHA REDDY CHADIPIRALLA,GEN,CUDDAPAH,759,10,NTRTDP(LP),0,M,ANDHRA PRADESH,819201,814047,5154,1143505,560870,582635,0.06637487374344668,759,0.09265125408782461
28,C GOPI NARASIMHA REDDY,GEN,CUDDAPAH,745,12,IND,1,M,ANDHRA PRADESH,819201,814047,5154,1143505,560870,582635,0.06523801819843376,746,0.09106434196247319
53,G RAVINDRANATHA REDDY,GEN,CUDDAPAH,731,9,JP,0,M,ANDHRA PRADESH,819201,814047,5154,1143505,560870,582635,0.06392626180034193,731,0.08923328951014464
53,O SUBBA REDDY,GEN,CUDDAPAH,649,11,ABJS,0,M,ANDHRA PRADESH,819201,814047,5154,1143505,560870,582635,0.05675532682410658,649,0.07922353610408191
36,PECHARA VENKATESHWAR RAO,GEN,CUDDAPAH,617,6,TRS,0,M,ANDHRA PRADESH,819201,814047,5154,1143505,560870,582635,0.05395691317484401,617,0.07531729087244766
48,N BHASKARA REDDY,GEN,CUDDAPAH,485,8,PP,0,M,ANDHRA PRADESH,819201,814047,5154,1143505,560870,582635,0.04241345687163589,485,0.05920402929195643
50,NIZAMODDIN,GEN,HINDUPUR,417870,1,INC,1874,M,ANDHRA PRADESH,868063,865406,2657,1179211,595681,583530,35.595326027318265,419744,48.354094115288866
45,B K PARDHASARATHI,GEN,HINDUPUR,417131,2,TDP,773,M,ANDHRA PRADESH,868063,865406,2657,1179211,595681,583530,35.439289491024084,417904,48.14212793311084
31,B SURENDER KUMAR,GEN,HINDUPUR,16905,3,TRS,2,M,ANDHRA PRADESH,868063,865406,2657,1179211,595681,583530,1.4337552821335622,16907,1.9476696967846805
40,SMT DESAI REDDY PRABHAVATHI,GEN,HINDUPUR,13500,4,IND,8,F,ANDHRA PRADESH,868063,865406,2657,1179211,595681,583530,1.1455117023162098,13508,1.5561082548156069
47,ANANTHA VENKATA RAMI REDDY,GEN,ANANTAPUR,456967,1,INC,1958,M,ANDHRA PRADESH,875135,872718,2417,1280923,642399,638524,35.82768050850832,458925,52.44048061156279
39,KALAVA SRINIVASULU,GEN,ANANTAPUR,385074,2,TDP,447,M,ANDHRA PRADESH,875135,872718,2417,1280923,642399,638524,30.097125276070457,385521,44.0527461477372
41,GADDALA NAGABHUSHANAM,SC,ANANTAPUR,9291,3,BSP,5,M,ANDHRA PRADESH,875135,872718,2417,1280923,642399,638524,0.7257266830246627,9296,1.062236112142698
32,YATHAM POTHALAIAH,GEN,ANANTAPUR,7102,7,IND,0,M,ANDHRA PRADESH,875135,872718,2417,1280923,642399,638524,0.5544439439373015,7102,0.8115319350728744
34,K VENKATESULU,GEN,ANANTAPUR,6227,5,PPOI,5,M,ANDHRA PRADESH,875135,872718,2417,1280923,642399,638524,0.4865241704614563,6232,0.7121187016860255
32,A JAGAN MOHAN RAO,GEN,ANANTAPUR,4419,4,TRS,0,M,ANDHRA PRADESH,875135,872718,2417,1280923,642399,638524,0.3449856080342066,4419,0.5049506647545807
42,B S AMARNATH,GEN,ANANTAPUR,3638,6,IND,2,M,ANDHRA PRADESH,875135,872718,2417,1280923,642399,638524,0.28417008672652455,3640,0.41593582704382753
52,KOTLA JAYASURYA PRAKASHA REDDY,GEN,KURNOOL,433121,2,INC,408,M,ANDHRA PRADESH,818809,818316,493,1310724,644392,666332,33.07553687885474,433529,52.946291503879415
65,KAMBALAPADU EDIGA KRISHNAMURTHI,GEN,KURNOOL,332350,1,TDP,81,M,ANDHRA PRADESH,818809,818316,493,1310724,644392,666332,25.362395134292193,332431,40.59933391059453
39,JAMES,SC,KURNOOL,17410,9,IND,0,M,ANDHRA PRADESH,818809,818316,493,1310724,644392,666332,1.3282735343214895,17410,2.126258993245067
47,REDDIPOGU DAVID,GEN,KURNOOL,12514,3,BSP,1,M,ANDHRA PRADESH,818809,818316,493,1310724,644392,666332,0.9548158117193246,12515,1.5284394773384269
34,T SESHAPHANI,GEN,KURNOOL,8899,10,IND,0,M,ANDHRA PRADESH,818809,818316,493,1310724,644392,666332,0.6789377473823627,8899,1.0868224457718467
36,DR PARAMESHWAR REDDY,GEN,KURNOOL,3721,4,PPOI,1,M,ANDHRA PRADESH,818809,818316,493,1310724,644392,666332,0.283965197860114,3722,0.4545626635759988
52,GIRI NIVARTHI RAO YADAV,GEN,KURNOOL,2873,8,IND,0,M,ANDHRA PRADESH,818809,818316,493,1310724,644392,666332,0.21919183596241465,2873,0.3508754788967879
35,V RAVINDER RAO,GEN,KURNOOL,2722,6,TRS,1,M,ANDHRA PRADESH,818809,818316,493,1310724,644392,666332,0.20774777909002964,2723,0.332556188317422
60,R V MOHANA REDDY,GEN,KURNOOL,2623,5,JP,1,M,ANDHRA PRADESH,818809,818316,493,1310724,644392,666332,0.2001947015542555,2624,0.32046545653504055
26,K V KRISHNA KUMAR,GEN,KURNOOL,2083,7,IND,0,M,ANDHRA PRADESH,818809,818316,493,1310724,644392,666332,0.1589198031011868,2083,0.2543938818454609
54,S P Y REDDY,GEN,NANDYAL,457676,2,INC,850,M,ANDHRA PRADESH,829976,828724,1252,1182240,584204,598036,38.7845107592367,458526,55.24569385138848
34,BHUMA SHOBHA NAGI REDDY,GEN,NANDYAL,346453,1,TDP,394,F,ANDHRA PRADESH,829976,828724,1252,1182240,584204,598036,29.338120855325485,346847,41.790003566368185
42,LAKU OBULESU,SC,NANDYAL,7662,9,IND,0,M,ANDHRA PRADESH,829976,828724,1252,1182240,584204,598036,0.6480917580186765,7662,0.9231592238811724
40,A C V SUBBAIAH,GEN,NANDYAL,7463,3,BSP,5,M,ANDHRA PRADESH,829976,828724,1252,1182240,584204,598036,0.6316822303424009,7468,0.8997850540256586
29,S VASUDEV PRASAD,GEN,NANDYAL,2682,4,TRS,0,M,ANDHRA PRADESH,829976,828724,1252,1182240,584204,598036,0.22685749086479903,2682,0.32314187398189825
40,RAMAKRISHNA REDDY S,GEN,NANDYAL,2020,8,IND,0,M,ANDHRA PRADESH,829976,828724,1252,1182240,584204,598036,0.17086209229936392,2020,0.24338053148524777
49,MALA GUNAM PALLE GOKARI,SC,NANDYAL,1798,7,IND,2,M,ANDHRA PRADESH,829976,828724,1252,1182240,584204,598036,0.1522533495736906,1800,0.2168737409274485
40,INJETI KRISHNA REDDY,GEN,NANDYAL,1552,5,IND,0,M,ANDHRA PRADESH,829976,828724,1252,1182240,584204,598036,0.13127622141020434,1552,0.18699335884411117
33,BUDDA REDDY SRINIVASA REDDY,GEN,NANDYAL,1418,6,IND,1,M,ANDHRA PRADESH,829976,828724,1252,1182240,584204,598036,0.12002639058059277,1419,0.17096879909780524
52,DR MANDA JAGANNATH,SC,NAGARKURNOOL (SC),404748,1,TDP,298,M,ANDHRA PRADESH,883350,882624,726,1296544,645210,651334,31.24043611323642,405046,45.85339899247184
46,K S RATNAM,SC,NAGARKURNOOL (SC),304989,4,IND,407,M,ANDHRA PRADESH,883350,882624,726,1296544,645210,651334,23.554619048794333,305396,34.572479764532744
28,P BHAGAVANTHU,SC,NAGARKURNOOL (SC),119812,3,IND,1,M,ANDHRA PRADESH,883350,882624,726,1296544,645210,651334,9.240951329071748,119813,13.563479934340862
60,P LALAIAH,SC,NAGARKURNOOL (SC),27230,2,BSP,17,M,ANDHRA PRADESH,883350,882624,726,1296544,645210,651334,2.1015098600587407,27247,3.084507839474727
47,DR G RAGHAVULU,SC,NAGARKURNOOL (SC),25845,5,IND,3,M,ANDHRA PRADESH,883350,882624,726,1296544,645210,651334,1.9936076214922132,25848,2.9261334691798266
53,D VITTAL RAO,GEN,MAHABUBNAGAR,428606,3,INC,158,M,ANDHRA PRADESH,866550,866243,307,1365922,672495,693427,31.390079374956986,428764,49.4794299232589
64,YELKOTI YELLA REDDY,GEN,MAHABUBNAGAR,380711,1,TDP,146,M,ANDHRA PRADESH,866550,866243,307,1365922,672495,693427,27.882778079568233,380857,43.950954936241416
56,SMT GUNDALA VIJAYA LAKSHMI,GEN,MAHABUBNAGAR,25842,4,PPOI,0,F,ANDHRA PRADESH,866550,866243,307,1365922,672495,693427,1.8919089084149754,25842,2.98217067682188
47,G RAMCHANDRAIAH YADAV,GEN,MAHABUBNAGAR,18301,2,BSP,3,M,ANDHRA PRADESH,866550,866243,307,1365922,672495,693427,1.3400472354936812,18304,2.1122843459696496
52,MOHD MAZHER HUSSAIN,GEN,MAHABUBNAGAR,12783,5,MUL,0,M,ANDHRA PRADESH,866550,866243,307,1365922,672495,693427,0.9358513882930358,12783,1.475160117708153
37,ASADUDDIN OWAISI,GEN,HYDERABAD,378822,4,AIMIM,32,M,ANDHRA PRADESH,986737,986389,348,1770725,897469,873256,21.39541713140098,378854,38.394627950507584
50,G SUBASH CHANDERJI,GEN,HYDERABAD,278477,3,BJP,232,M,ANDHRA PRADESH,986737,986389,348,1770725,897469,873256,15.739824083355689,278709,28.245520336219275
56,KONDA LAKSHMA REDDY,GEN,HYDERABAD,249433,1,INC,83,M,ANDHRA PRADESH,986737,986389,348,1770725,897469,873256,14.0911773426139,249516,25.28698123208109
36,MAJEEDULLAH KHAN @ FARHAT KHAN,GEN,HYDERABAD,47559,5,MBT,1,M,ANDHRA PRADESH,986737,986389,348,1770725,897469,873256,2.6859054906888424,47560,4.8199266876584135
41,SMT G SHOBHA RANI,GEN,HYDERABAD,11068,2,BSP,0,F,ANDHRA PRADESH,986737,986389,348,1770725,897469,873256,0.6250547092292705,11068,1.1216767993903138
50,SALAHUDDIN AHMED S K,GEN,HYDERABAD,6158,10,IND,0,M,ANDHRA PRADESH,986737,986389,348,1770725,897469,873256,0.34776715752022475,6158,0.6240771350420629
40,SYED GAFFAR,GEN,HYDERABAD,4523,9,IND,0,M,ANDHRA PRADESH,986737,986389,348,1770725,897469,873256,0.2554320970224061,4523,0.4583794871379101
48,SMT VARSHA DHAWAN,GEN,HYDERABAD,4199,6,PPOI,0,F,ANDHRA PRADESH,986737,986389,348,1770725,897469,873256,0.23713450705219616,4199,0.425543989938555
45,BHAGWAN DAS,GEN,HYDERABAD,3189,7,IND,0,M,ANDHRA PRADESH,986737,986389,348,1770725,897469,873256,0.1800957235030849,3189,0.3231864215084668
28,MOHSIN-BIN-HUSSAIN AL-KASARI,GEN,HYDERABAD,2961,8,IND,0,M,ANDHRA PRADESH,986737,986389,348,1770725,897469,873256,0.1672196416721964,2961,0.30007996051632807
39,M ANJAN KUMAR YADAV,GEN,SECUNDERABAD,485687,1,INC,23,M,ANDHRA PRADESH,973288,973226,62,1850694,957096,893598,26.244749267031718,485710,49.90403662636342
57,BANDARU DATTATRAYA,GEN,SECUNDERABAD,416916,3,BJP,36,M,ANDHRA PRADESH,973288,973226,62,1850694,957096,893598,22.529494341041794,416952,42.83952951233345
32,HUMERA AZIZ,GEN,SECUNDERABAD,38394,7,AIMIM,0,F,ANDHRA PRADESH,973288,973226,62,1850694,957096,893598,2.074573106088851,38394,3.9447727702386137
44,M D PAUL VEDANTH,GEN,SECUNDERABAD,7815,2,BSP,1,M,ANDHRA PRADESH,973288,973226,62,1850694,957096,893598,0.4223280563939798,7816,0.803051101010184
62,H K JAISWAL,GEN,SECUNDERABAD,4787,10,IND,1,M,ANDHRA PRADESH,973288,973226,62,1850694,957096,893598,0.2587137581901708,4788,0.49194072052670945
42,SYED NAWAZ AHMED,GEN,SECUNDERABAD,3830,13,IND,0,M,ANDHRA PRADESH,973288,973226,62,1850694,957096,893598,0.2069493930385034,3830,0.3935114786168123
37,ABDUS SATTAR MUJAHED,GEN,SECUNDERABAD,3530,4,MUL,0,M,ANDHRA PRADESH,973288,973226,62,1850694,957096,893598,0.19073925781355536,3530,0.3626881252003518
40,SEELAM NARAYANA,GEN,SECUNDERABAD,3398,12,IND,0,M,ANDHRA PRADESH,973288,973226,62,1850694,957096,893598,0.1836067983145782,3398,0.3491258496971092
36,N CHANDRA SHEKAR,GEN,SECUNDERABAD,2978,5,MCPI(S),0,M,ANDHRA PRADESH,973288,973226,62,1850694,957096,893598,0.16091260899965093,2978,0.30597315491406446
64,ACHANTA BAPIRAJU,GEN,SECUNDERABAD,1927,8,IND,0,M,ANDHRA PRADESH,973288,973226,62,1850694,957096,893598,0.10412310192824963,1927,0.19798867344506457
47,MEGHA MURALI,GEN,SECUNDERABAD,1883,6,PPOI,1,M,ANDHRA PRADESH,973288,973226,62,1850694,957096,893598,0.10179964921267373,1884,0.19357065945537189
34,PADM YADAGIRI,GEN,SECUNDERABAD,1253,11,IND,0,M,ANDHRA PRADESH,973288,973226,62,1850694,957096,893598,0.06770433145619968,1253,0.12873887276941667
61,KAILASH CHANDRA,GEN,SECUNDERABAD,828,9,IND,0,M,ANDHRA PRADESH,973288,973226,62,1850694,957096,893598,0.044739973220856606,828,0.08507245542943097
49,SARVEY SATHYANARAYANA,SC,SIDDIPET (SC),593155,3,INC,724,M,ANDHRA PRADESH,1119814,1118829,985,1727118,875287,851831,34.3855486423047,593879,53.03371809961297
60,DR K LINGAIAH,SC,SIDDIPET (SC),454651,2,TDP,256,M,ANDHRA PRADESH,1119814,1118829,985,1727118,875287,851831,26.339080479735603,454907,40.62344282175433
30,SMT PALADUGU GOURAMMA,SC,SIDDIPET (SC),31945,1,BSP,4,F,ANDHRA PRADESH,1119814,1118829,985,1727118,875287,851831,1.8498446545053666,31949,2.8530630979787714
60,B O V RAO,SC,SIDDIPET (SC),25068,4,IND,1,M,ANDHRA PRADESH,1119814,1118829,985,1727118,875287,851831,1.4514931811260146,25069,2.238675351442293
37,Y SAMAIAH,SC,SIDDIPET (SC),14010,5,IND,0,M,ANDHRA PRADESH,1119814,1118829,985,1727118,875287,851831,0.8111779276227797,14010,1.251100629211637
49,A NARENDRA,GEN,MEDAK,452671,3,TRS,1067,M,ANDHRA PRADESH,901015,899374,1641,1259126,621061,638065,36.03594874539959,453738,50.358540090897485
73,P RAMACHANDRA REDDY,GEN,MEDAK,329456,2,BJP,516,M,ANDHRA PRADESH,901015,899374,1641,1259126,621061,638065,26.206432080665476,329972,36.6222537915573
43,NALLA SURYAPRAKASH,GEN,MEDAK,52243,1,BSP,30,M,ANDHRA PRADESH,901015,899374,1641,1259126,621061,638065,4.151530506081203,52273,5.801568231383495
62,MD ULFATHALI,GEN,MEDAK,34454,4,IND,22,M,ANDHRA PRADESH,901015,899374,1641,1259126,621061,638065,2.7380897543216483,34476,3.826351392596128
45,K LAXMAIAH YADAV,GEN,MEDAK,18456,6,IND,1,M,ANDHRA PRADESH,901015,899374,1641,1259126,621061,638065,1.4658580634503615,18457,2.048467561583325
57,P JEEVULA NAIK,GEN,MEDAK,12094,5,IND,5,M,ANDHRA PRADESH,901015,899374,1641,1259126,621061,638065,0.9609046274955803,12099,1.3428189319822643
45,MADHU GOUD YASKHI,GEN,NIZAMABAD,441550,1,INC,592,M,ANDHRA PRADESH,782439,781638,801,1128312,527909,600403,39.18614709406618,442142,56.508175078185005
49,SYED YOUSUF ALI,GEN,NIZAMABAD,304065,3,TDP,206,M,ANDHRA PRADESH,782439,781638,801,1128312,527909,600403,26.96692049716745,304271,38.88750432941098
48,YEDLA RAMU,GEN,NIZAMABAD,21132,2,BSP,1,M,ANDHRA PRADESH,782439,781638,801,1128312,527909,600403,1.8729748509277575,21133,2.7009134258389476
48,BAISA RAMADASU,GEN,NIZAMABAD,14891,4,IND,2,M,ANDHRA PRADESH,782439,781638,801,1128312,527909,600403,1.3199363296676805,14893,1.9034071665650614
59,MADHUSUDHAN REDDY TAKKALA,GEN,ADILABAD,414950,2,TRS,479,M,ANDHRA PRADESH,831337,830601,736,1140834,558091,582743,36.414500269101374,415429,49.97119098512396
42,DR S VENUGOPALA CHARY,GEN,ADILABAD,374204,1,TDP,251,M,ANDHRA PRADESH,831337,830601,736,1140834,558091,582743,32.82291726929597,374455,45.04250382215636
32,MOTHE BARIK RAO,SC,ADILABAD,23279,3,PRBP,3,M,ANDHRA PRADESH,831337,830601,736,1140834,558091,582743,2.040787704433774,23282,2.800548995172836
30,NAINALA GOVERDHAN,GEN,ADILABAD,18168,4,IND,3,M,ANDHRA PRADESH,831337,830601,736,1140834,558091,582743,1.5927821225524486,18171,2.1857561975468434
76,G VENKAT SWAMY,SC,PEDDAPALLI (SC),571720,2,INC,487,M,ANDHRA PRADESH,939450,938802,648,1386543,700069,686474,41.268608330214064,572207,60.9087231891
48,DR MT C SUGUNA,SC,PEDDAPALLI (SC),308911,3,TDP,161,F,ANDHRA PRADESH,939450,938802,648,1386543,700069,686474,22.290834110445907,309072,32.899249560913304
39,KANNAM RAGHU,SC,PEDDAPALLI (SC),26554,1,BSP,0,M,ANDHRA PRADESH,939450,938802,648,1386543,700069,686474,1.9151227188770923,26554,2.8265474479748787
30,KAMPELLI SRINIVAS,SC,PEDDAPALLI (SC),14151,4,IND,0,M,ANDHRA PRADESH,939450,938802,648,1386543,700069,686474,1.0205958271759332,14151,1.506306881686093
27,MADDELA ODELU,SC,PEDDAPALLI (SC),8829,6,IND,0,M,ANDHRA PRADESH,939450,938802,648,1386543,700069,686474,0.6367635190542233,8829,0.9398052051732396
38,KAMILLA JAYA RAO,SC,PEDDAPALLI (SC),8637,5,IND,0,M,ANDHRA PRADESH,939450,938802,648,1386543,700069,686474,0.6229161302606555,8637,0.9193677151524828
51,K CHANDRA SHAKHER RAO,GEN,KARIMNAGAR,450600,3,TRS,599,M,ANDHRA PRADESH,874498,873722,776,1344786,667341,677445,33.55173239459661,451199,51.595200903832826
61,CHENNAMANENI VIDYASAGAR RAO,GEN,KARIMNAGAR,319857,2,BJP,174,M,ANDHRA PRADESH,874498,873722,776,1344786,667341,677445,23.797912827765906,320031,36.59596705767195
50,MAMIDIPALLI GANGARAJAM,GEN,KARIMNAGAR,59685,4,IND,1,M,ANDHRA PRADESH,874498,873722,776,1344786,667341,677445,4.438326990316675,59686,6.825172842019079
69,KOTHAPALLI SANDRI MENAYYA,GEN,KARIMNAGAR,43580,1,BSP,2,M,ANDHRA PRADESH,874498,873722,776,1344786,667341,677445,3.240813036423639,43582,4.98365919647615
45,B VINOD KUMAR,GEN,HANAMKONDA,495574,4,TRS,474,M,ANDHRA PRADESH,831926,831324,602,1207089,605032,602057,41.09456717773089,496048,59.62645716085325
45,CHADA SURESH REDDY,GEN,HANAMKONDA,278856,2,TDP,125,M,ANDHRA PRADESH,831926,831324,602,1207089,605032,602057,23.11188321656481,278981,33.534352815034026
69,PAKALA DEVADANAM,GEN,HANAMKONDA,16587,6,IND,0,M,ANDHRA PRADESH,831926,831324,602,1207089,605032,602057,1.3741323133588328,16587,1.993807141500566
58,DR KAITHA VENKATI,SC,HANAMKONDA,16094,1,BSP,0,M,ANDHRA PRADESH,831926,831324,602,1207089,605032,602057,1.3332902544882772,16094,1.9345470630801296
37,POLEPALLY NAROTHAM REDDY,GEN,HANAMKONDA,12582,3,JP,0,M,ANDHRA PRADESH,831926,831324,602,1207089,605032,602057,1.0423423624935693,12582,1.5123941312087854
52,DR DHARMAPUR SAMPATH RAJARAM YADAV,GEN,HANAMKONDA,11631,5,IND,3,M,ANDHRA PRADESH,831926,831324,602,1207089,605032,602057,0.9638063141988703,11634,1.3984416883232402
56,DHARAVATH RAVINDER NAIK,ST,WARANGAL,427141,5,TRS,460,M,ANDHRA PRADESH,921872,921262,610,1215167,602200,612967,35.18866131157281,427601,46.38398823263967
47,BODAKUNTI VENKATESHWARLU,GEN,WARANGAL,408190,1,TDP,149,M,ANDHRA PRADESH,921872,921262,610,1215167,602200,612967,33.60352939143344,408339,44.294544144957214
51,KONDAL RAO RAVULAPELLI,GEN,WARANGAL,19080,4,PPOI,0,M,ANDHRA PRADESH,921872,921262,610,1215167,602200,612967,1.5701545548883404,19080,2.069701650554524
58,NALLANI SWAMI RAO,GEN,WARANGAL,16424,8,IND,0,M,ANDHRA PRADESH,921872,921262,610,1215167,602200,612967,1.3515837740820809,16424,1.7815922384018608
59,MAMIDALA ELIA,GEN,WARANGAL,14376,2,BSP,0,M,ANDHRA PRADESH,921872,921262,610,1215167,602200,612967,1.1830472684001458,14376,1.5594355832479998
41,GADE JHANSI,GEN,WARANGAL,9619,7,IND,0,F,ANDHRA PRADESH,921872,921262,610,1215167,602200,612967,0.7915784414817058,9619,1.0434203446899353
32,UPENDAR REDDY VALLEPU,GEN,WARANGAL,7079,3,MCPI(S),1,M,ANDHRA PRADESH,921872,921262,610,1215167,602200,612967,0.582635966908252,7080,0.7680024992623705
27,MUMJALA BIKSHAPATHI,GEN,WARANGAL,6930,10,IND,0,M,ANDHRA PRADESH,921872,921262,610,1215167,602200,612967,0.5702919845585009,6930,0.7517312598712186
32,INDIRA KALLEPELLI,GEN,WARANGAL,6829,6,IND,0,F,ANDHRA PRADESH,921872,921262,610,1215167,602200,612967,0.5619803697763353,6829,0.7407752920145096
32,BELLAIAH TEJAVATH,ST,WARANGAL,5594,9,IND,0,M,ANDHRA PRADESH,921872,921262,610,1215167,602200,612967,0.4603482484300512,5594,0.6068087543606921
49,RENUKA CHOWDHURY,GEN,KHAMMAM,515783,2,INC,2264,F,ANDHRA PRADESH,1023177,1020191,2986,1298614,646316,652298,39.89230056044367,518047,50.631220209211115
45,NAMA NAGESWARA RAO,GEN,KHAMMAM,408470,1,TDP,689,M,ANDHRA PRADESH,1023177,1020191,2986,1298614,646316,652298,31.507360924801365,409159,39.98907324930095
45,ARUNA CHANDRA,GEN,KHAMMAM,50590,5,IND,29,F,ANDHRA PRADESH,1023177,1020191,2986,1298614,646316,652298,3.8979250185197447,50619,4.947237867934874
39,BURRA VENKANNA,SC,KHAMMAM,14552,9,IND,0,M,ANDHRA PRADESH,1023177,1020191,2986,1298614,646316,652298,1.1205793253422496,14552,1.4222368172857678
46,NALAJALA SAROJA,GEN,KHAMMAM,10252,3,PPOI,3,F,ANDHRA PRADESH,1023177,1020191,2986,1298614,646316,652298,0.789688082832928,10255,1.002270379416269
59,PADIGA YERRAIAH,ST,KHAMMAM,8316,7,IND,0,M,ANDHRA PRADESH,1023177,1020191,2986,1298614,646316,652298,0.6403750460105928,8316,0.8127626011921691
43,NAMA NAIK ISLAVATH,ST,KHAMMAM,5899,6,IND,0,M,ANDHRA PRADESH,1023177,1020191,2986,1298614,646316,652298,0.4542535349226175,5899,0.5765375883156091
49,PITTALA VENKATA NARASAIAH MUDIRA,GEN,KHAMMAM,3344,4,MRS,1,M,ANDHRA PRADESH,1023177,1020191,2986,1298614,646316,652298,0.257582314683193,3345,0.3269229077666914
58,BANOTH SOMLA NAIK,ST,KHAMMAM,2985,8,IND,0,M,ANDHRA PRADESH,1023177,1020191,2986,1298614,646316,652298,0.22986045121953097,2985,0.2917383795765542
62,SURAVARAM SUDHAKAR REDDY,GEN,NALGONDA,478848,3,CPI,663,M,ANDHRA PRADESH,1047866,1046908,958,1605163,821762,783401,29.87304093104563,479511,45.7607174963211
53,NALLU INDRASENA REDDY,GEN,NALGONDA,423090,1,BJP,270,M,ANDHRA PRADESH,1047866,1046908,958,1605163,821762,783401,26.3748915219202,423360,40.40211248384812
40,VATTIPALLY SRINIVAS GOUD,GEN,NALGONDA,86401,5,TRS,25,M,ANDHRA PRADESH,1047866,1046908,958,1605163,821762,783401,5.384250696035231,86426,8.247810311623814
54,A NAGESWARA RAO,GEN,NALGONDA,15736,4,PPOI,0,M,ANDHRA PRADESH,1047866,1046908,958,1605163,821762,783401,0.980336576409997,15736,1.5017187312118152
34,PUDARI NARSIMHA,SC,NALGONDA,14552,2,BSP,0,M,ANDHRA PRADESH,1047866,1046908,958,1605163,821762,783401,0.9065745970969926,14552,1.3887271845827616
40,GYARA PRATHAP,SC,NALGONDA,9528,7,IND,0,M,ANDHRA PRADESH,1047866,1046908,958,1605163,821762,783401,0.593584576768839,9528,0.9092765678054254
60,GUMMI BAKKA REDDY,GEN,NALGONDA,9441,6,IND,0,M,ANDHRA PRADESH,1047866,1046908,958,1605163,821762,783401,0.5881645664645896,9441,0.9009739794973783
39,NARASIMHA REDDY PADURI,GEN,NALGONDA,9312,8,IND,0,M,ANDHRA PRADESH,1047866,1046908,958,1605163,821762,783401,0.5801279994617369,9312,0.8886632451095846
62,JAIPAL REDDY SUDINI,GEN,MIRYALGUDA,570972,1,INC,1197,M,ANDHRA PRADESH,962599,961052,1547,1289342,640291,649051,44.376821665624796,572169,59.44001603990863
52,VANGALA SWAMY GOUD,GEN,MIRYALGUDA,354914,2,TDP,348,M,ANDHRA PRADESH,962599,961052,1547,1289342,640291,649051,27.553744468108537,355262,36.90654156091997
50,MARRY NEHEMIAH,GEN,MIRYALGUDA,9566,4,IND,0,M,ANDHRA PRADESH,962599,961052,1547,1289342,640291,649051,0.7419288288134568,9566,0.9937679137418594
40,SARASANI DAMODAR REDDY,GEN,MIRYALGUDA,9456,6,IND,0,M,ANDHRA PRADESH,962599,961052,1547,1289342,640291,649051,0.7333973453125703,9456,0.9823405177025948
36,YANALA NARSI REDDY,GEN,MIRYALGUDA,8166,5,IND,0,M,ANDHRA PRADESH,962599,961052,1547,1289342,640291,649051,0.6333463115294468,8166,0.8483283277875835
33,VARIKUPPALA VENKANNA,GEN,MIRYALGUDA,7978,3,MCPI(S),2,M,ANDHRA PRADESH,962599,961052,1547,1289342,640291,649051,0.6189203485188569,7980,0.8290056399393725
32,KHIREN RIJIJU,ST,ARUNACHAL WEST,123388,2,BJP,563,M,ARUNACHAL PRADESH,221554,220618,936,1018862,563419,455443,12.165631852007436,123951,55.9461801637524
51,KAMEN RINGU,ST,ARUNACHAL WEST,76182,1,AC,345,M,ARUNACHAL PRADESH,221554,220618,936,1018862,563419,455443,7.511027008564457,76527,34.541014831598616
51,TADAR TANIANG,ST,ARUNACHAL WEST,6231,5,AITC,10,M,ARUNACHAL PRADESH,221554,220618,936,1018862,563419,455443,0.6125461544350462,6241,2.816920479883008
54,KARDU TAIPODIA,ST,ARUNACHAL WEST,4895,3,SP,6,M,ARUNACHAL PRADESH,221554,220618,936,1018862,563419,455443,0.4810268711562508,4901,2.212101790082779
33,KIDO INGO,ST,ARUNACHAL WEST,4888,4,SAP,8,M,ARUNACHAL PRADESH,221554,220618,936,1018862,563419,455443,0.4805361275619269,4896,2.209845003926808
26,JODIK TALI,ST,ARUNACHAL WEST,3130,6,IND,3,M,ARUNACHAL PRADESH,221554,220618,936,1018862,563419,455443,0.30749993620333277,3133,1.4141022053314316
35,TUJO BAGRA,ST,ARUNACHAL WEST,1904,7,IND,1,M,ARUNACHAL PRADESH,221554,220618,936,1018862,563419,455443,0.18697330943739193,1905,0.8598355254249528
42,TAPIR GAO,ST,ARUNACHAL EAST,82776,1,BJP,559,M,ARUNACHAL PRADESH,163374,162651,723,241645,131502,110143,34.486540172567196,83335,51.008728439041704
37,WANGCHA RAJKUMAR,ST,ARUNACHAL EAST,38258,2,INC,83,M,ARUNACHAL PRADESH,163374,162651,723,241645,131502,110143,15.866663907798632,38341,23.468238520205173
36,TONY PERTIN,ST,ARUNACHAL EAST,16970,6,IND,39,M,ARUNACHAL PRADESH,163374,162651,723,241645,131502,110143,7.03883796478305,17009,10.411081322609473
39,MATWANG CHIMYANG,ST,ARUNACHAL EAST,16466,3,IND,10,M,ARUNACHAL PRADESH,163374,162651,723,241645,131502,110143,6.8182664652693,16476,10.084836020419406
47,OGONG TAMUK,ST,ARUNACHAL EAST,5223,4,IND,28,M,ARUNACHAL PRADESH,163374,162651,723,241645,131502,110143,2.1730224089056263,5251,3.2140977144466074
39,ONOM TAKNYO,ST,ARUNACHAL EAST,2958,5,IND,4,M,ARUNACHAL PRADESH,163374,162651,723,241645,131502,110143,1.2257650685923567,2962,1.813017983277633
62,LALIT MOHAN SUKLABAIDYA,SC,KARIMGANJ (SC),320845,3,INC,214,M,ASSAM,671491,670897,594,979105,509602,469503,32.79106939500871,321059,47.81285229437178
45,PARIMAL SUKLA BAIDYA,SC,KARIMGANJ (SC),228810,2,BJP,301,M,ASSAM,671491,670897,594,979105,509602,469503,23.400043917659495,229111,34.119742483518024
64,NEPAL CHANDRA DAS,SC,KARIMGANJ (SC),106474,1,AGP,72,M,ASSAM,671491,670897,594,979105,509602,469503,10.88197895016367,106546,15.867077890842914
32,BABUL RAM DAS,SC,KARIMGANJ (SC),3925,4,IND,1,M,ASSAM,671491,670897,594,979105,509602,469503,0.4009784445999152,3926,0.5846690424741359
32,SUSHIL KUMAR DAS,SC,KARIMGANJ (SC),3641,8,IND,0,M,ASSAM,671491,670897,594,979105,509602,469503,0.3718702284228964,3641,0.5422261802466452
62,RADHA KANTA TANTY,SC,KARIMGANJ (SC),2858,6,IND,4,M,ASSAM,671491,670897,594,979105,509602,469503,0.2923077708723783,2862,0.4262156901581704
27,LUKENDRA ROY,SC,KARIMGANJ (SC),2385,7,IND,1,M,ASSAM,671491,670897,594,979105,509602,469503,0.2436919431521645,2386,0.3553286641220806
29,BABUL ROY,SC,KARIMGANJ (SC),1959,5,IND,1,M,ASSAM,671491,670897,594,979105,509602,469503,0.20018282002441007,1960,0.2918877542662523
70,SONTOSH MOHAN DEV,GEN,SILCHAR,246085,3,INC,130,M,ASSAM,608233,607884,349,879243,458334,420909,28.003066274056206,246215,40.480375119403256
73,KABINDRA PURKYASTHA,GEN,SILCHAR,224709,1,BJP,186,M,ASSAM,608233,607884,349,879243,458334,420909,25.57825311091473,224895,36.975139461357735
42,ANWAR HUSSAIN LASKAR,GEN,SILCHAR,99805,5,SP,15,M,ASSAM,608233,607884,349,879243,458334,420909,11.35294793362017,99820,16.411473892406363
74,NOORUL HUDA,GEN,SILCHAR,20003,2,CPM,17,M,ASSAM,608233,607884,349,879243,458334,420909,2.276958701974312,20020,3.291501776457377
61,SAMARENDRA GHOSH,GEN,SILCHAR,4990,11,IND,0,M,ASSAM,608233,607884,349,879243,458334,420909,0.5675336624801107,4990,0.8204092839421735
33,ALOK SEN,GEN,SILCHAR,4517,4,SAP,0,M,ASSAM,608233,607884,349,879243,458334,420909,0.513737385455443,4517,0.742643033179719
51,BENU BHUSON NATH,GEN,SILCHAR,1720,9,IND,0,M,ASSAM,608233,607884,349,879243,458334,420909,0.19562282554424656,1720,0.2827863664089255
42,ASHUTOSH DAS,SC,SILCHAR,1672,6,IND,1,M,ASSAM,608233,607884,349,879243,458334,420909,0.19027731810204915,1673,0.2750590645361235
55,KANTIMOY DEB,GEN,SILCHAR,1530,7,IND,0,M,ASSAM,608233,607884,349,879243,458334,420909,0.1740133273736612,1530,0.25154833756142797
35,KSHITINDRA SARKAR,SC,SILCHAR,1434,8,IND,0,M,ASSAM,608233,607884,349,879243,458334,420909,0.16309484408747071,1434,0.23576491245953443
47,MANORANJAN DAS,SC,SILCHAR,1419,10,IND,0,M,ASSAM,608233,607884,349,879243,458334,420909,0.16138883107400342,1419,0.23329875228736358
62,BIREN SINGH ENGTI,ST,AUTONOMOUS DISTRICT (ST),125872,2,INC,65,M,ASSAM,401377,401010,367,579284,302576,276708,21.740113657549664,125937,31.37623730308413
47,ELWIN TERON,ST,AUTONOMOUS DISTRICT (ST),101751,5,ASDC,57,M,ASSAM,401377,401010,367,579284,302576,276708,17.574799234917588,101808,25.364682081932944
49,DR JAYANTA RONGPI,ST,AUTONOMOUS DISTRICT (ST),74365,1,CPI(ML)(L),34,M,ASSAM,401377,401010,367,579284,302576,276708,12.84326858673811,74399,18.535940026458917
45,RATAN TERON,ST,AUTONOMOUS DISTRICT (ST),57445,3,BJP,139,M,ASSAM,401377,401010,367,579284,302576,276708,9.940547296317522,57584,14.346611788916656
35,SANMONI KEMPRAI,ST,AUTONOMOUS DISTRICT (ST),26652,8,IND,61,M,ASSAM,401377,401010,367,579284,302576,276708,4.611382327148688,26713,6.6553389955079645
39,CHEMBER G MOMIN,ST,AUTONOMOUS DISTRICT (ST),8002,7,IND,1,M,ASSAM,401377,401010,367,579284,302576,276708,1.381533064956049,8003,1.9938860472822308
50,SAILENDRA HASNU,ST,AUTONOMOUS DISTRICT (ST),3746,4,AGP,9,M,ASSAM,401377,401010,367,579284,302576,276708,0.6482140021129532,3755,0.9355294399031334
63,HARSING TERON,ST,AUTONOMOUS DISTRICT (ST),3177,6,SAP,1,M,ASSAM,401377,401010,367,579284,302576,276708,0.54860828194806,3178,0.7917743169140234
58,ANWAR HUSSAIN,GEN,DHUBRI,376543,1,INC,45,M,ASSAM,863592,863463,129,1149939,592290,557649,32.74851970408865,376588,43.6071663470713
59,AFZALUR RAHMAN,GEN,DHUBRI,259934,2,AGP,32,M,ASSAM,863592,863463,129,1149939,592290,557649,22.60693828107404,259966,30.102872652826797
45,JABEEN BORBHUYAN,GEN,DHUBRI,90196,3,BJP,19,F,ASSAM,863592,863463,129,1149939,592290,557649,7.845198745324752,90215,10.446483987809058
54,DR MOTIUR RAHMAN MONDAL,GEN,DHUBRI,47214,7,IND,16,M,ASSAM,863592,863463,129,1149939,592290,557649,4.107174380554099,47230,5.469017776913172
58,LISTI RABHA,ST,DHUBRI,23828,10,IND,7,M,ASSAM,863592,863463,129,1149939,592290,557649,2.072718639858288,23835,2.75998388127727
43,DR JOYASREE GOSWAMI MAHANTA,GEN,DHUBRI,22308,6,IND,3,F,ASSAM,863592,863463,129,1149939,592290,557649,1.9401898709409802,22311,2.5835116582830784
34,SHAJAHAN SHEIKH,GEN,DHUBRI,15094,11,IND,0,M,ASSAM,863592,863463,129,1149939,592290,557649,1.3125913635418922,15094,1.747816098342736
63,RADHABALLAV ADHIKARY,GEN,DHUBRI,12570,9,IND,2,M,ASSAM,863592,863463,129,1149939,592290,557649,1.093275382433329,12572,1.4557800442801694
56,MINHAR ALI MANDAL,GEN,DHUBRI,7558,8,IND,4,M,ASSAM,863592,863463,129,1149939,592290,557649,0.6576000987878488,7562,0.875644980500051
32,GANDHI NATH,GEN,DHUBRI,4685,5,IND,1,M,ASSAM,863592,863463,129,1149939,592290,557649,0.4074998760803834,4686,0.5426173470805659
35,MOHOR UDDIN MONDAL,GEN,DHUBRI,3533,4,MUL,0,M,ASSAM,863592,863463,129,1149939,592290,557649,0.30723368804780077,3533,0.40910522561580004
42,SANSUMA KHUNGGUR BWISWMUTHIARY,ST,KOKRAJHAR (ST),689597,4,IND,23,M,ASSAM,966987,966915,72,1216553,628100,588453,56.68639179715146,689620,71.31636723141057
34,SABDA RAM RABHA,ST,KOKRAJHAR (ST),205474,3,IND,17,M,ASSAM,966987,966915,72,1216553,628100,588453,16.891249292057147,205491,21.25064763021633
51,DERHAGRA MOCHAHARY,ST,KOKRAJHAR (ST),61398,1,INC,27,M,ASSAM,966987,966915,72,1216553,628100,588453,5.049101847597268,61425,6.352205355397746
48,RAJENDRA MUSHAHARY,ST,KOKRAJHAR (ST),10446,2,IND,5,M,ASSAM,966987,966915,72,1216553,628100,588453,0.8590665593689711,10451,1.0807797829753658
73,A F GOLAM OSMANI,GEN,BARPETA,266960,2,INC,12,M,ASSAM,762681,762614,67,1075749,568311,507438,24.817313332385158,266972,35.00441206743055
49,KUMAR DEEPAK DAS,GEN,BARPETA,198835,1,AGP,12,M,ASSAM,762681,762614,67,1075749,568311,507438,18.48451636952486,198847,26.072106162340482
47,RANJIT THAKURIA,GEN,BARPETA,111028,4,BJP,30,M,ASSAM,762681,762614,67,1075749,568311,507438,10.32378370790956,111058,14.56152703423843
53,DR TARA PRASAD DAS,GEN,BARPETA,72576,9,IND,7,M,ASSAM,762681,762614,67,1075749,568311,507438,6.74720590026112,72583,9.516822891877469
35,ABDUS SAMAD AHMED,GEN,BARPETA,53070,5,UMFA,2,M,ASSAM,762681,762614,67,1075749,568311,507438,4.933492850097932,53072,6.958610480659673
47,MANORANJAN TALUKDAR,GEN,BARPETA,48605,3,CPM,2,M,ASSAM,762681,762614,67,1075749,568311,507438,4.51843320328441,48607,6.3731756789535865
39,ABDUS SALAM,GEN,BARPETA,5583,6,LJNSP,0,M,ASSAM,762681,762614,67,1075749,568311,507438,0.5189872358700774,5583,0.7320229558622805
60,SYED NURUR ROHMAN,GEN,BARPETA,3019,7,SP,2,M,ASSAM,762681,762614,67,1075749,568311,507438,0.28082759082276626,3021,0.3961026956224162
39,JILANE HOQUE LASKAR,GEN,BARPETA,2938,8,IND,0,M,ASSAM,762681,762614,67,1075749,568311,507438,0.27311203635792364,2938,0.38522003301511376
49,KIRIP CHALIHA,GEN,GAUHATI,353232,1,INC,18,M,ASSAM,881775,881696,79,1441360,752020,689340,24.50810345784537,353250,40.06124011227354
78,BHUPEN HAZARIKA,SC,GAUHATI,292051,2,BJP,48,M,ASSAM,881775,881696,79,1441360,752020,689340,20.265513126491648,292099,33.12625102775652
47,BHRIGU KUMAR PHUKAN,GEN,GAUHATI,180847,3,AGP,9,M,ASSAM,881775,881696,79,1441360,752020,689340,12.547593939057558,180856,20.51044767656148
60,DEVEN DUTTA,GEN,GAUHATI,14932,4,TNGP,1,M,ASSAM,881775,881696,79,1441360,752020,689340,1.0360354110007215,14933,1.6935159195940008
44,RAJAT CHANDRA RABHA,ST,GAUHATI,14488,11,IND,1,M,ASSAM,881775,881696,79,1441360,752020,689340,1.0052311705611368,14489,1.643162938391313
35,SUMITRA DAS,GEN,GAUHATI,11240,12,IND,0,F,ASSAM,881775,881696,79,1441360,752020,689340,0.7798190597768774,11240,1.2747015962121857
46,KAZI NEKIB AHMED,GEN,GAUHATI,3089,8,IND,0,M,ASSAM,881775,881696,79,1441360,752020,689340,0.21431148359882332,3089,0.3503161237277083
61,DHWAJEN BRAHMA,ST,GAUHATI,2586,9,IND,0,M,ASSAM,881775,881696,79,1441360,752020,689340,0.17941388688460896,2586,0.2932720932210598
32,BHABANI BORO,ST,GAUHATI,2553,10,IND,1,F,ASSAM,881775,881696,79,1441360,752020,689340,0.17719376144752177,2554,0.28964304953077596
80,BHUBANESWAR BARMAN,GEN,GAUHATI,2465,6,SP,1,M,ASSAM,881775,881696,79,1441360,752020,689340,0.171088416495532,2466,0.2796631793824955
33,NIPON DHOLUA,SC,GAUHATI,2299,5,SAP,0,M,ASSAM,881775,881696,79,1441360,752020,689340,0.1595021368707332,2299,0.2607241076238269
67,UMESH CHANDRA DAS,SC,GAUHATI,1914,7,IND,0,M,ASSAM,881775,881696,79,1441360,752020,689340,0.13279125270577788,1914,0.21706217572509995
61,NARAYAN CHANDRA BORKATAKY,GEN,MANGALDOI,345789,2,BJP,74,M,ASSAM,848938,848741,197,1209839,628045,581794,28.587522802620846,345863,40.74066657400187
57,MADHAB RAJBANGSHI,GEN,MANGALDOI,315927,3,INC,70,M,ASSAM,848938,848741,197,1209839,628045,581794,26.118929874140278,315997,37.22262403143692
40,APURBA BHATTACHARJEE,GEN,MANGALDOI,146054,1,AGP,44,M,ASSAM,848938,848741,197,1209839,628045,581794,12.075821658914947,146098,17.20950175395612
57,BHUPENDRA NATH KAKATI,GEN,MANGALDOI,15046,7,IND,0,M,ASSAM,848938,848741,197,1209839,628045,581794,1.2436365499872297,15046,1.7723320195349956
40,SHAHEDA BEGUM,GEN,MANGALDOI,10860,4,SAP,3,F,ASSAM,848938,848741,197,1209839,628045,581794,0.8978880660980512,10863,1.2795987457270142
55,AROON BARUAH,GEN,MANGALDOI,8206,5,IND,3,M,ASSAM,848938,848741,197,1209839,628045,581794,0.6785200344839272,8209,0.9669728531412187
37,TRIDIP PATI SINGHA,GEN,MANGALDOI,6859,6,IND,3,M,ASSAM,848938,848741,197,1209839,628045,581794,0.5671829061552818,6862,0.8083040222018569
54,MONI KUMAR SUBBA,GEN,TEZPUR,289759,3,INC,88,M,ASSAM,719768,719506,262,1006389,522608,483781,28.800692376407135,289847,40.26950350668549
41,PADMA HAZARIKA,GEN,TEZPUR,219290,2,AGP,112,M,ASSAM,719768,719506,262,1006389,522608,483781,21.800913960705056,219402,30.482322081559616
63,GHISA LAL AGARWALLA,GEN,TEZPUR,164612,1,BJP,50,M,ASSAM,719768,719506,262,1006389,522608,483781,16.361665320268802,164662,22.877093730201953
49,RUBUL SARMA,GEN,TEZPUR,24593,4,CPI(ML)(L),2,M,ASSAM,719768,719506,262,1006389,522608,483781,2.4438860122676225,24595,3.417073279167732
45,DIPEN TANTI,GEN,TEZPUR,21252,5,IND,10,M,ASSAM,719768,719506,262,1006389,522608,483781,2.1127019472589623,21262,2.954007402385213
51,RAJEN GOHAIN,GEN,NOWGONG,342594,3,BJP,110,M,ASSAM,786069,785885,184,1149244,598536,550708,29.81995120270369,342704,43.59719057741751
60,BISNU PRASAD,GEN,NOWGONG,311244,2,INC,48,M,ASSAM,786069,785885,184,1149244,598536,550708,27.08667611055616,311292,39.601103719902454
57,DHRUBA KUMAR SAIKIA,GEN,NOWGONG,104251,1,AGP,22,M,ASSAM,786069,785885,184,1149244,598536,550708,9.073182022268552,104273,13.26512049196699
59,HAJI ABDUR ROUF,GEN,NOWGONG,11585,6,UMFA,0,M,ASSAM,786069,785885,184,1149244,598536,550708,1.0080539902753463,11585,1.4737891966226884
50,BHUPEN CHANDRA MUDOI,GEN,NOWGONG,10598,5,RPI,1,M,ASSAM,786069,785885,184,1149244,598536,550708,0.9222584586040911,10599,1.3483549154081893
48,BIREN CHANDRA DAS,GEN,NOWGONG,5613,4,SAP,3,M,ASSAM,786069,785885,184,1149244,598536,550708,0.48866907288617567,5616,0.7144410986821768
54,DIP GOGOI,GEN,KALIABOR,301831,2,INC,62,M,ASSAM,763083,762931,152,1153483,607858,545625,26.172297294368445,301893,39.56227566332889
43,KESHAB MAHANTA,GEN,KALIABOR,234623,1,AGP,72,M,ASSAM,763083,762931,152,1153483,607858,545625,20.34663709824939,234695,30.75615627657804
72,RASHIDUL HAQUE,GEN,KALIABOR,125958,6,JD(U),8,M,ASSAM,763083,762931,152,1153483,607858,545625,10.920490375670903,125966,16.507509668017764
41,JITEN GOGOI,GEN,KALIABOR,30802,8,IND,8,M,ASSAM,763083,762931,152,1153483,607858,545625,2.6710406655321317,30810,4.037568652427062
32,BINOD GOGOI,GEN,KALIABOR,20280,11,IND,0,M,ASSAM,763083,762931,152,1153483,607858,545625,1.7581533494641879,20280,2.657640125648193
46,ANIL CHOUDHURY,GEN,KALIABOR,18965,3,LJNSP,1,M,ASSAM,763083,762931,152,1153483,607858,545625,1.6442374963480173,18966,2.4854439163236504
29,BIKASH TANTI,GEN,KALIABOR,10012,10,IND,0,M,ASSAM,763083,762931,152,1153483,607858,545625,0.8679798488577639,10012,1.312046002859453
55,ATAUR RAHMAN,GEN,KALIABOR,7591,4,SAP,1,M,ASSAM,763083,762931,152,1153483,607858,545625,0.6581804846712088,7592,0.9949114316529133
58,JUREN RAJKHOWA,GEN,KALIABOR,4947,9,IND,0,M,ASSAM,763083,762931,152,1153483,607858,545625,0.4288749812524329,4947,0.6482912081647737
36,JITU SARMAH,GEN,KALIABOR,4141,7,IND,0,M,ASSAM,763083,762931,152,1153483,607858,545625,0.35899965582501,4141,0.5426670493249096
49,DIMBESWAR BORA,GEN,KALIABOR,3781,5,SP,0,M,ASSAM,763083,762931,152,1153483,607858,545625,0.3277898330534564,3781,0.49549000567435
69,BIJOY KRISHNA HANDIQUE,GEN,JORHAT,223600,4,INC,24,M,ASSAM,666835,666703,132,1078149,559388,518761,20.741474508625434,223624,33.535132379074284
63,DRUPAD BORGOHAIN,GEN,JORHAT,172293,3,CPI,39,M,ASSAM,666835,666703,132,1078149,559388,518761,15.984061572194566,172332,25.843274573170273
54,DAYANANDA BORGOHAIN,GEN,JORHAT,149782,1,BJP,38,M,ASSAM,666835,666703,132,1078149,559388,518761,13.896038488186699,149820,22.467326999932517
69,DULAL CHANDRA BARUAH,GEN,JORHAT,93322,2,AGP,31,M,ASSAM,666835,666703,132,1078149,559388,518761,8.658636236735367,93353,13.999415147675212
39,RAJ KUMAR DOWARA,GEN,JORHAT,16691,6,RCPI(R),0,M,ASSAM,666835,666703,132,1078149,559388,518761,1.5481162622234959,16691,2.5030179879580405
36,JOYRAM MOUT,GEN,JORHAT,11015,5,SAP,0,M,ASSAM,666835,666703,132,1078149,559388,518761,1.0216584164155418,11015,1.651832912189672
42,SARBANANDA SONOWAL,ST,DIBRUGARH,220878,3,AGP,66,M,ASSAM,631240,631135,105,969905,511791,458114,22.779962986065648,220944,35.00158418351182
29,KAMAKHAYA TASA,GEN,DIBRUGARH,202361,1,BJP,29,M,ASSAM,631240,631135,105,969905,511791,458114,20.86699212809502,202390,32.06229009568469
57,PABAN SINGH GHATOWAR,GEN,DIBRUGARH,170581,2,INC,8,M,ASSAM,631240,631135,105,969905,511791,458114,17.58821740273532,170589,27.024428109752236
65,BADHRAM RAJGARH,GEN,DIBRUGARH,15894,7,IND,0,M,ASSAM,631240,631135,105,969905,511791,458114,1.638717193951985,15894,2.5179012736835436
52,SUBHAS SEN,GEN,DIBRUGARH,9842,4,CPI(ML)(L),1,M,ASSAM,631240,631135,105,969905,511791,458114,1.0148416597501817,9843,1.5593118306824663
46,AMRIT BORGOHAIN,GEN,DIBRUGARH,6250,6,IND,1,M,ASSAM,631240,631135,105,969905,511791,458114,0.6444961104438063,6251,0.9902731132374375
43,TITUS BHENGRA,GEN,DIBRUGARH,5329,5,SAP,0,M,ASSAM,631240,631135,105,969905,511791,458114,0.5494352539681722,5329,0.8442113934478169
47,DR ARUN KUMAR SARMAH,GEN,LAKHIMPUR,300727,1,AGP,138,M,ASSAM,800020,799716,304,1126632,582132,544500,26.704815769479296,300865,37.607184820379494
43,RANEE NARAH,GEN,LAKHIMPUR,272634,3,INC,83,F,ASSAM,800020,799716,304,1126632,582132,544500,24.206395699749343,272717,34.08877278068048
41,UDAY SHANKAR HAZARIKA,GEN,LAKHIMPUR,169062,2,BJP,61,M,ASSAM,800020,799716,304,1126632,582132,544500,15.011379048349415,169123,21.139846503837404
47,HEKJEL WOOD,GEN,LAKHIMPUR,19708,11,IND,2,M,ASSAM,800020,799716,304,1126632,582132,544500,1.7494621136271649,19710,2.4636884077898054
57,PUSPA GOGOI,GEN,LAKHIMPUR,11738,5,RSP,19,M,ASSAM,800020,799716,304,1126632,582132,544500,1.0435528193766908,11757,1.4695882602934927
46,PADMESWAR PHUKAN,GEN,LAKHIMPUR,7888,4,SAP,0,M,ASSAM,800020,799716,304,1126632,582132,544500,0.7001398859609881,7888,0.9859753506162345
51,RABIN DEKA,SC,LAKHIMPUR,4905,10,IND,0,M,ASSAM,800020,799716,304,1126632,582132,544500,0.43536842553735383,4905,0.6131096722581936
31,BIJU NARAH,ST,LAKHIMPUR,4456,9,IND,0,M,ASSAM,800020,799716,304,1126632,582132,544500,0.39551512827613633,4456,0.5569860753481163
34,SUNMONI DAS,SC,LAKHIMPUR,2948,6,LJNSP,0,M,ASSAM,800020,799716,304,1126632,582132,544500,0.26166485596006506,2948,0.36849078773030675
45,GHANASHYAM BHATTARAI,GEN,LAKHIMPUR,2885,8,IND,1,M,ASSAM,800020,799716,304,1126632,582132,544500,0.25616172805317083,2886,0.36074098147546313
38,ISAK KORKORIA,GEN,LAKHIMPUR,2765,7,IND,0,M,ASSAM,800020,799716,304,1126632,582132,544500,0.24542175262197416,2765,0.3456163595910102
55,KAILASH BAITHA,SC,BAGAHA (SC),237988,1,JD(U),1,M,BIHAR,570822,570814,8,1160275,627800,532475,20.511430479843142,237989,41.69233140979149
56,HIRALAL RAM,SC,BAGAHA (SC),172614,9,LJNSP,0,M,BIHAR,570822,570814,8,1160275,627800,532475,14.876990368662602,172614,30.23954928156238
51,PURNAMASI RAM,SC,BAGAHA (SC),88458,2,BSP,0,M,BIHAR,570822,570814,8,1160275,627800,532475,7.623882269289608,88458,15.49659964051841
32,NANDJI RAM,SC,BAGAHA (SC),23338,4,CPI(ML)(L),0,M,BIHAR,570822,570814,8,1160275,627800,532475,2.0114197065350887,23338,4.088489932062885
75,MAHENDRA BAITHA,SC,BAGAHA (SC),12882,5,SAP,7,M,BIHAR,570822,570814,8,1160275,627800,532475,1.1108573398547756,12889,2.257971837105087
47,RISHIJEE JANAPREMI,SC,BAGAHA (SC),9737,11,IND,0,M,BIHAR,570822,570814,8,1160275,627800,532475,0.8391976040162893,9737,1.7057856915115397
44,TARKESHWAR PRASAD CHAURASIA,SC,BAGAHA (SC),7696,3,ABDBM,0,M,BIHAR,570822,570814,8,1160275,627800,532475,0.6632910301437159,7696,1.3482311473629258
36,ASESAR MANJHI,SC,BAGAHA (SC),7224,10,IND,0,M,BIHAR,570822,570814,8,1160275,627800,532475,0.6226110189394756,7224,1.2655433742918107
60,SOHAN RAM,SC,BAGAHA (SC),4613,8,JP,0,M,BIHAR,570822,570814,8,1160275,627800,532475,0.397578160349917,4613,0.8081328330022319
32,SHAILENDRA PASWAN,SC,BAGAHA (SC),3514,6,AD,0,M,BIHAR,570822,570814,8,1160275,627800,532475,0.30285923595699293,3514,0.6156034630760553
40,SURENDRA KUMAR SWATANTRA,SC,BAGAHA (SC),2750,7,SP,0,M,BIHAR,570822,570814,8,1160275,627800,532475,0.23701277714334962,2750,0.4817613897151827
66,RAGHUNATH JHA,GEN,BETTIAH,211585,3,RJD,5,M,BIHAR,569909,569868,41,1278163,687560,590603,16.554226651843308,211590,37.12697992135587
66,MADAN PRASAD JAISWAL,GEN,BETTIAH,186894,2,BJP,25,M,BIHAR,569909,569868,41,1278163,687560,590603,14.624034649727774,186919,32.798043196369946
60,RAMCHANDRA SAHANI,GEN,BETTIAH,47838,4,CPI,3,M,BIHAR,569909,569868,41,1278163,687560,590603,3.7429498428604178,47841,8.39449806898996
31,RAJAN TIWARI,GEN,BETTIAH,32757,14,IND,2,M,BIHAR,569909,569868,41,1278163,687560,590603,2.562975144797651,32759,5.748110663281331
67,FAIYAZUL AZAM,GEN,BETTIAH,32289,1,BSP,0,M,BIHAR,569909,569868,41,1278163,687560,590603,2.5262036219167663,32289,5.6656413567780115
50,PRAKASH JHA,GEN,BETTIAH,25973,12,IND,5,M,BIHAR,569909,569868,41,1278163,687560,590603,2.0324481306374853,25978,4.5582715837089784
61,DHARMESH PRASAD VERMA,GEN,BETTIAH,7935,5,SJP(R),0,M,BIHAR,569909,569868,41,1278163,687560,590603,0.6208128384251461,7935,1.392327547029438
39,VIRENDRA PRASAD GUPTA,GEN,BETTIAH,6160,7,CPI(ML)(L),1,M,BIHAR,569909,569868,41,1278163,687560,590603,0.4820198988704883,6161,1.0810497816318043
28,AKBAR HUSAIN,GEN,BETTIAH,5714,8,IND,0,M,BIHAR,569909,569868,41,1278163,687560,590603,0.44704783349228544,5714,1.0026162071488607
63,NASIM AHMAD,GEN,BETTIAH,4151,6,SP,0,M,BIHAR,569909,569868,41,1278163,687560,590603,0.3247629605926631,4151,0.7283618963729297
33,RAHMAT ALI,GEN,BETTIAH,3537,13,IND,0,M,BIHAR,569909,569868,41,1278163,687560,590603,0.2767252689993373,3537,0.6206253980898705
35,NAFIS AHMAD,GEN,BETTIAH,2059,11,IND,0,M,BIHAR,569909,569868,41,1278163,687560,590603,0.16109056513136433,2059,0.36128574912836964
31,DIWAKAR MANI TRIPATHI,GEN,BETTIAH,1538,10,IND,0,M,BIHAR,569909,569868,41,1278163,687560,590603,0.1203289408314902,1538,0.26986764553639264
41,KRISHN NAND PRASAD,GEN,BETTIAH,1438,9,IND,0,M,BIHAR,569909,569868,41,1278163,687560,590603,0.11250521255896158,1438,0.2523209845782397
41,AKHILES PRASAD SINGH,GEN,MOTIHARI,348591,1,RJD,5,M,BIHAR,679090,679070,20,1221716,672008,549708,28.533308886844406,348596,51.33281302920084
56,RADHA MOHAN SINGH,GEN,MOTIHARI,251557,3,BJP,15,M,BIHAR,679090,679070,20,1221716,672008,549708,20.591692340936845,251572,37.04545789217924
56,RAJA RAM SINGH,GEN,MOTIHARI,55105,2,BSP,0,M,BIHAR,679090,679070,20,1221716,672008,549708,4.510459059224893,55105,8.114535628561752
57,KRISHNA MOHAN DAS,GEN,MOTIHARI,6195,4,SHS,0,M,BIHAR,679090,679070,20,1221716,672008,549708,0.5070736570528667,6195,0.9122502172024326
49,SHEKHAR PRASAD JAISWAL,GEN,MOTIHARI,5671,11,IND,0,M,BIHAR,679090,679070,20,1221716,672008,549708,0.46418316531829,5671,0.8350881326481026
29,KAMESHWAR PRASAD,GEN,MOTIHARI,3246,5,IND,0,M,BIHAR,679090,679070,20,1221716,672008,549708,0.26569186292067876,3246,0.477992607754495
39,SHATRUGHAN TIWARI,GEN,MOTIHARI,2172,10,IND,0,M,BIHAR,679090,679070,20,1221716,672008,549708,0.1777827252814893,2172,0.3198397855954292
33,RAJU KUMAR GUPTA,GEN,MOTIHARI,2113,9,IND,0,M,BIHAR,679090,679070,20,1221716,672008,549708,0.1729534523571763,2113,0.31115168828873935
48,BHAGWAN LAL SAH,GEN,MOTIHARI,1634,7,IND,0,M,BIHAR,679090,679070,20,1221716,672008,549708,0.13374630437843166,1634,0.2406161186293422
39,KHALID MUSTAFA,GEN,MOTIHARI,1494,6,IND,0,M,BIHAR,679090,679070,20,1221716,672008,549708,0.12228701269362112,1494,0.2200002945117731
36,BHOLA SAH,GEN,MOTIHARI,1292,8,IND,0,M,BIHAR,679090,679070,20,1221716,672008,549708,0.10575289183410874,1292,0.19025460542785197
44,ANIRUDH PRASAD ALIAS SADHU YADAV,GEN,GOPALGANJ,336015,1,RJD,1,M,BIHAR,694492,694487,5,1231178,683333,547845,27.29223556626256,336016,48.38299073279462
54,PRABHU DAYAL SINGH,GEN,GOPALGANJ,143096,3,JD(U),1,M,BIHAR,694492,694487,5,1231178,683333,547845,11.62277103716928,143097,20.604556999936644
58,KALI PRASAD PANDAY,GEN,GOPALGANJ,136423,8,IND,1,M,BIHAR,694492,694487,5,1231178,683333,547845,11.080769799330398,136424,19.643710798684506
71,CHHATHU SAH,GEN,GOPALGANJ,43425,2,BSP,0,M,BIHAR,694492,694487,5,1231178,683333,547845,3.5271098086548007,43425,6.252771810186439
54,RAM NARESH RAM,SC,GOPALGANJ,11023,7,CPI(ML)(L),0,M,BIHAR,694492,694487,5,1231178,683333,547845,0.895321391382887,11023,1.5872033083174464
26,SUSHMA DEVI,GEN,GOPALGANJ,7562,10,IND,1,F,BIHAR,694492,694487,5,1231178,683333,547845,0.6142897290237479,7563,1.0889974254563048
60,PARAS NATH PATHAK,GEN,GOPALGANJ,4694,4,SP,0,M,BIHAR,694492,694487,5,1231178,683333,547845,0.38126087373231166,4694,0.6758897150723119
25,MONIKA TIWARI,GEN,GOPALGANJ,4312,6,BED,0,F,BIHAR,694492,694487,5,1231178,683333,547845,0.35023367863948185,4312,0.6208854817622089
58,PRAMOD KUMAR PATEL,GEN,GOPALGANJ,4293,5,SAP,1,M,BIHAR,694492,694487,5,1231178,683333,547845,0.3487716642110239,4294,0.6182936592502145
29,DINA NATH MANJHI,SC,GOPALGANJ,3644,9,IND,0,M,BIHAR,694492,694487,5,1231178,683333,547845,0.29597669873893134,3644,0.5247000685393064
38,MOHAMMAD SHAHABUDDIN,GEN,SIWAN,317510,2,RJD,1,M,BIHAR,637549,637544,5,1054441,550118,504323,30.111784348294503,317511,49.80181915429245
44,OM PRAKASH YADAV,GEN,SIWAN,213929,1,JD(U),4,M,BIHAR,637549,637544,5,1054441,550118,504323,20.28875963662263,213933,33.55553847625829
44,AMAR NATH YADAV,GEN,SIWAN,72225,4,CPI(ML)(L),0,M,BIHAR,637549,637544,5,1054441,550118,504323,6.849600878569782,72225,11.328541021944979
62,RAMPRIT GOD,GEN,SIWAN,8999,5,GGP,0,M,BIHAR,637549,637544,5,1054441,550118,504323,0.8534379827795011,8999,1.4114993514224006
56,SHANKAR PRASAD YADAV,GEN,SIWAN,8043,3,BSP,0,M,BIHAR,637549,637544,5,1054441,550118,504323,0.7627738299250503,8043,1.2615500926203318
44,PREM CHAND TIWARI,GEN,SIWAN,7542,8,IND,0,M,BIHAR,637549,637544,5,1054441,550118,504323,0.7152605029584396,7542,1.182967897369457
29,ASHOK RAM,SC,SIWAN,6085,6,IND,0,M,BIHAR,637549,637544,5,1054441,550118,504323,0.577083023137378,6085,0.9544364433165137
52,NASIR KHAN,GEN,SIWAN,3211,7,IND,0,M,BIHAR,637549,637544,5,1054441,550118,504323,0.3045215426941858,3211,0.5036475627755671
49,PRABHUNATH SINGH,GEN,MAHARAJGANJ,283463,3,JD(U),43,M,BIHAR,664434,664381,53,1114665,568850,545815,25.434188747291785,283506,42.668797803845074
44,JITENDRA SWAMI,GEN,MAHARAJGANJ,237038,2,RJD,3,M,BIHAR,664434,664381,53,1114665,568850,545815,21.265671748911107,237041,35.675627677090574
55,DR MAHACHANDRA PRASAD SINGH,GEN,MAHARAJGANJ,99801,8,IND,6,M,BIHAR,664434,664381,53,1114665,568850,545815,8.953990660871202,99807,15.021356522995513
54,KANHAIYA YADAV,GEN,MAHARAJGANJ,12435,1,BSP,0,M,BIHAR,664434,664381,53,1114665,568850,545815,1.1155818115756753,12435,1.8715177128202352
65,RAMBAHADUR SINGH,GEN,MAHARAJGANJ,9616,4,SJP(R),0,M,BIHAR,664434,664381,53,1114665,568850,545815,0.8626807157307353,9616,1.447246829632439
29,SURENDRA RAM,SC,MAHARAJGANJ,6646,11,IND,0,M,BIHAR,664434,664381,53,1114665,568850,545815,0.5962329489129021,6646,1.0002498367031187
60,GIRJA DEVI,GEN,MAHARAJGANJ,4679,5,IND,1,F,BIHAR,664434,664381,53,1114665,568850,545815,0.41985708710688857,4680,0.704358897949232
49,VISHUNDEO RAM,SC,MAHARAJGANJ,4284,9,IND,0,M,BIHAR,664434,664381,53,1114665,568850,545815,0.3843307181978442,4284,0.6447592988919892
37,SAWALIYA RAM,SC,MAHARAJGANJ,2527,10,IND,0,M,BIHAR,664434,664381,53,1114665,568850,545815,0.22670488442715972,2527,0.38032370408498056
27,DINESH RAI,GEN,MAHARAJGANJ,1948,6,IND,0,M,BIHAR,664434,664381,53,1114665,568850,545815,0.17476102685560235,1948,0.29318186606946667
41,BRAJESH SINGH,GEN,MAHARAJGANJ,1944,7,IND,0,M,BIHAR,664434,664381,53,1114665,568850,545815,0.1744021746443999,1944,0.2925798499173733
55,LALU PRASAD,GEN,CHAPRA,228862,3,RJD,20,M,BIHAR,446101,446031,70,1164917,622400,542517,19.64792341428617,228882,51.3072151822121
42,RAJEEV PRATAP RUDY,GEN,CHAPRA,168410,2,BJP,49,M,BIHAR,446101,446031,70,1164917,622400,542517,14.46103027082616,168459,37.76252463007256
52,ABHAY RAJ KISHOR RAI,GEN,CHAPRA,12322,1,BSP,0,M,BIHAR,446101,446031,70,1164917,622400,542517,1.057757762999424,12322,2.762154758675726
37,BRAJESH KUMAR,GEN,CHAPRA,10753,9,IND,0,M,BIHAR,446101,446031,70,1164917,622400,542517,0.9230700556348649,10753,2.410440684956994
34,BACHCHU PRASAD,GEN,CHAPRA,8909,4,SP,1,M,BIHAR,446101,446031,70,1164917,622400,542517,0.7648613592213007,8910,1.9973055429151694
42,NARENDRA KUMAR SINGH,GEN,CHAPRA,5775,7,IND,0,M,BIHAR,446101,446031,70,1164917,622400,542517,0.49574347356936155,5775,1.2945498889264988
36,MANORANJAN KUMAR SRIVASTAVA,GEN,CHAPRA,5264,8,IND,0,M,BIHAR,446101,446031,70,1164917,622400,542517,0.45187768742322415,5264,1.18000183814876
59,KAMALA SARAN,GEN,CHAPRA,3187,6,IND,0,M,BIHAR,446101,446031,70,1164917,622400,542517,0.27358172298970657,3187,0.7144122071010826
34,RAJESHWAR SINGH,GEN,CHAPRA,2549,5,AD,0,M,BIHAR,446101,446031,70,1164917,622400,542517,0.21881387257632945,2549,0.5713952669911074
57,RAM VILAS PASWAN,SC,HAJIPUR (SC),477472,5,LJNSP,23,M,BIHAR,773597,773565,32,1208834,708069,500765,39.50046077459767,477495,61.72399841261018
48,CHHEDI PASWAN,SC,HAJIPUR (SC),239687,2,JD(U),7,M,BIHAR,773597,773565,32,1208834,708069,500765,19.828528979165046,239694,30.98434973248345
56,CHANDESHWAR DAS,SC,HAJIPUR (SC),16146,1,BSP,0,M,BIHAR,773597,773565,32,1208834,708069,500765,1.3356672628334412,16146,2.0871332231122923
67,RAM SUNDAR DAS,SC,HAJIPUR (SC),14801,6,SJP(R),0,M,BIHAR,773597,773565,32,1208834,708069,500765,1.2244030197694638,14801,1.913270087655459
29,LALAN RAM,SC,HAJIPUR (SC),8322,8,IND,0,M,BIHAR,773597,773565,32,1208834,708069,500765,0.6884319931438063,8322,1.0757539132132106
29,JITENDRA KUMAR,SC,HAJIPUR (SC),8065,4,JP,0,M,BIHAR,773597,773565,32,1208834,708069,500765,0.6671718366624367,8065,1.0425324813824253
49,LAXMAN PASWAN,SC,HAJIPUR (SC),4753,7,AD,0,M,BIHAR,773597,773565,32,1208834,708069,500765,0.3931888083889103,4753,0.614402589461955
25,UTTAM CHOUDHARY UNNAT,SC,HAJIPUR (SC),4319,3,JD(S),2,M,BIHAR,773597,773565,32,1208834,708069,500765,0.3574518916575808,4321,0.558559560081024
57,RAGHUBANSH PRASAD SINGH,GEN,VAISHALI,361469,2,RJD,34,M,BIHAR,748759,748681,78,1197345,652751,544594,30.19204991042682,361503,48.28028778285135
36,VIJAY KUMAR SHUKLA,GEN,VAISHALI,255559,13,IND,9,M,BIHAR,748759,748681,78,1197345,652751,544594,21.344558168280656,255568,34.132210764745395
48,DR HARENDRA KUMAR,GEN,VAISHALI,73259,3,JD(U),28,M,BIHAR,748759,748681,78,1197345,652751,544594,6.120792252859451,73287,9.787795539018562
35,JITENDER KUMAR SINGH,GEN,VAISHALI,14472,1,BSP,2,M,BIHAR,748759,748681,78,1197345,652751,544594,1.2088412278833587,14474,1.933065245292544
31,SHIVCHARAN RAM,SC,VAISHALI,7930,16,IND,0,M,BIHAR,748759,748681,78,1197345,652751,544594,0.662298669138803,7930,1.0590857672495422
69,SHIVCHANDAR SINGH,GEN,VAISHALI,7762,15,IND,0,M,BIHAR,748759,748681,78,1197345,652751,544594,0.6482676254546518,7762,1.036648641285113
48,ASHOK KUMAR SINGH,GEN,VAISHALI,4082,7,IND,0,M,BIHAR,748759,748681,78,1197345,652751,544594,0.3409209542780068,4082,0.5451687392071415
58,SAMBHU PRASAD SINGH,GEN,VAISHALI,3972,14,IND,0,M,BIHAR,748759,748681,78,1197345,652751,544594,0.33173396138957445,3972,0.5304777638732889
39,NITYA NAND SINGH,GEN,VAISHALI,3925,6,SP,0,M,BIHAR,748759,748681,78,1197345,652751,544594,0.32780860988269883,3925,0.5242007107760975
50,RAM UDAR PRASAD THAKUR,GEN,VAISHALI,3239,12,IND,0,M,BIHAR,748759,748681,78,1197345,652751,544594,0.27051518150574816,3239,0.43258244642134525
34,UPENDRA PD SINGH,GEN,VAISHALI,2832,4,AD,0,M,BIHAR,748759,748681,78,1197345,652751,544594,0.23652330781854855,2832,0.37822583768609125
54,PANNA LAL SAHANI,GEN,VAISHALI,2814,10,IND,2,M,BIHAR,748759,748681,78,1197345,652751,544594,0.23518701794386748,2816,0.37608896854662177
51,UMESH SAHANI,GEN,VAISHALI,2338,9,IND,3,M,BIHAR,748759,748681,78,1197345,652751,544594,0.19551591228927334,2341,0.31265066596862273
36,UPENDRA CHAUDHARY,SC,VAISHALI,2217,8,IND,0,M,BIHAR,748759,748681,78,1197345,652751,544594,0.1851596657604951,2217,0.29608993013773455
41,BRAJ KISHORE SINGH,GEN,VAISHALI,1573,11,IND,0,M,BIHAR,748759,748681,78,1197345,652751,544594,0.1313739983045822,1573,0.21008094727408955
35,JAINENDRA KUMAR,GEN,VAISHALI,1238,5,JD(S),0,M,BIHAR,748759,748681,78,1197345,652751,544594,0.10339542905344742,1238,0.16534024966644809
72,GEORGE FERNANDES,GEN,MUZAFFARPUR,370014,1,JD(U),113,M,BIHAR,784096,783974,122,1237345,665225,572120,29.912999203940693,370127,47.20429641268416
57,BHAGWAN LAL SAHANI,GEN,MUZAFFARPUR,360429,2,RJD,5,M,BIHAR,784096,783974,122,1237345,665225,572120,29.129628357491242,360434,45.96809574337836
56,MAHESHWAR PRASAD YADAV,GEN,MUZAFFARPUR,14892,7,SP,3,M,BIHAR,784096,783974,122,1237345,665225,572120,1.2037871410156422,14895,1.8996398400195895
39,SHYAM KALYAN PASWAN,SC,MUZAFFARPUR,7684,14,IND,0,M,BIHAR,784096,783974,122,1237345,665225,572120,0.6210070756337158,7684,0.979982043015141
31,JITENDRA YADAV,GEN,MUZAFFARPUR,7027,6,CPI(ML)(L),0,M,BIHAR,784096,783974,122,1237345,665225,572120,0.5679095159393701,7027,0.8961912827000775
62,RAMESHWAR RAI,GEN,MUZAFFARPUR,5823,3,BSP,1,M,BIHAR,784096,783974,122,1237345,665225,572120,0.47068521713830824,5824,0.74276619189487
37,SHIVNATH PRASAD GUPTA,GEN,MUZAFFARPUR,3342,13,IND,0,M,BIHAR,784096,783974,122,1237345,665225,572120,0.2700944360707806,3342,0.42622331959351917
25,ANURODH PRAGAT,GEN,MUZAFFARPUR,2707,8,IND,0,M,BIHAR,784096,783974,122,1237345,665225,572120,0.21877487685326244,2707,0.34523833816267396
36,DINESH PRASAD CHAUDHARY,SC,MUZAFFARPUR,2638,9,IND,0,M,BIHAR,784096,783974,122,1237345,665225,572120,0.21319842081230375,2638,0.3364383952985349
65,ANANT PD TULSYAN,GEN,MUZAFFARPUR,2584,4,ABHM,0,M,BIHAR,784096,783974,122,1237345,665225,572120,0.20883423782372743,2584,0.32955148349181734
37,ARVIND CHOUDHARY,GEN,MUZAFFARPUR,2476,5,RLSM,0,M,BIHAR,784096,783974,122,1237345,665225,572120,0.20010587184657475,2476,0.31577765987838224
49,DEVENDRA RAKESH,GEN,MUZAFFARPUR,1711,10,IND,0,M,BIHAR,784096,783974,122,1237345,665225,572120,0.13827994617507647,1711,0.2182130759498837
34,BHIKHARI RAM,SC,MUZAFFARPUR,1361,12,IND,0,M,BIHAR,784096,783974,122,1237345,665225,572120,0.10999357495282237,1361,0.17357568461004774
33,PARMANAND SINGH,GEN,MUZAFFARPUR,1286,11,IND,0,M,BIHAR,784096,783974,122,1237345,665225,572120,0.10393220969091077,1286,0.16401052932294005
56,SITARAM YADAV,GEN,SITAMARHI,326156,3,RJD,9,M,BIHAR,690851,690791,60,1265132,674804,590328,25.781104264219067,326165,47.212061645709426
46,NAVAL KISHORE RAI,GEN,SITAMARHI,228134,2,JD(U),26,M,BIHAR,690851,690791,60,1265132,674804,590328,18.034481777395563,228160,33.025934680560646
66,RAJNI RANJAN SAHU,GEN,SITAMARHI,87286,5,SP,3,M,BIHAR,690851,690791,60,1265132,674804,590328,6.899596247664275,87289,12.634996547736051
58,NAWAL KISHOR SAHI,GEN,SITAMARHI,11392,4,SAP,19,M,BIHAR,690851,690791,60,1265132,674804,590328,0.9019612182760376,11411,1.6517309810653815
41,NAJMUJJAMA,GEN,SITAMARHI,10664,1,BSP,1,M,BIHAR,690851,690791,60,1265132,674804,590328,0.8429950392528209,10665,1.5437482177777841
39,SITARAM RAI,GEN,SITAMARHI,7326,12,IND,0,M,BIHAR,690851,690791,60,1265132,674804,590328,0.5790700100859041,7326,1.0604312652076933
56,SONE LAL SAH,GEN,SITAMARHI,6249,13,IND,2,M,BIHAR,690851,690791,60,1265132,674804,590328,0.49409863950955313,6251,0.9048260768240909
66,MOHAMMAD SAGIR,GEN,SITAMARHI,3313,9,IND,0,M,BIHAR,690851,690791,60,1265132,674804,590328,0.2618699076460006,3313,0.47955347824639466
34,AWADH KISHORE YADAV,GEN,SITAMARHI,3029,6,IND,0,M,BIHAR,690851,690791,60,1265132,674804,590328,0.23942165718675995,3029,0.4384447587106337
62,RAMASHRAYA RAI,GEN,SITAMARHI,2352,11,IND,0,M,BIHAR,690851,690791,60,1265132,674804,590328,0.18590945450751384,2352,0.34044967728207676
62,KAMLA KANT MISHRA,GEN,SITAMARHI,1745,8,IND,0,M,BIHAR,690851,690791,60,1265132,674804,590328,0.13793027130765803,1745,0.25258702672501016
37,UTTAM LAL DAS,GEN,SITAMARHI,1649,7,IND,0,M,BIHAR,690851,690791,60,1265132,674804,590328,0.1303421303073513,1649,0.23869112152982336
36,RATNESHWAR MISHRA,GEN,SITAMARHI,1496,10,IND,0,M,BIHAR,690851,690791,60,1265132,674804,590328,0.11824853058811254,1496,0.21654452262499438
55,SITARAM SINGH,GEN,SHEOHAR,303240,3,RJD,3,M,BIHAR,666398,666384,14,1214428,645338,569090,24.97002704153725,303243,45.50478842973719
55,MOHAMMAD ANWARUL HAQ,GEN,SHEOHAR,229353,1,BJP,7,M,BIHAR,666398,666384,14,1214428,645338,569090,18.886257563231414,229360,34.417870401771914
44,ANAND MOHAN SINGH,GEN,SHEOHAR,86415,4,BPSP,3,M,BIHAR,666398,666384,14,1214428,645338,569090,7.115942649543654,86418,12.967926074207906
34,RAM EKBAL RAI,GEN,SHEOHAR,27481,2,BSP,0,M,BIHAR,666398,666384,14,1214428,645338,569090,2.2628760206451104,27481,4.123811896194166
29,RAM SWARTH SAH,GEN,SHEOHAR,5342,7,IND,1,M,BIHAR,666398,666384,14,1214428,645338,569090,0.4399602117210737,5343,0.8017731145651698
39,SUNIL SINGH,GEN,SHEOHAR,5107,9,IND,0,M,BIHAR,666398,666384,14,1214428,645338,569090,0.4205271946957745,5107,0.7663588426135732
59,RAJENDRA SINGH VISMIL,GEN,SHEOHAR,3812,5,SP,0,M,BIHAR,666398,666384,14,1214428,645338,569090,0.3138926309340694,3812,0.572030528302906
33,AJAY KUMAR PANDEY,GEN,SHEOHAR,2878,6,IND,0,M,BIHAR,666398,666384,14,1214428,645338,569090,0.23698399575767357,2878,0.4318740452402319
40,SITARAM SINGH,GEN,SHEOHAR,2756,8,IND,0,M,BIHAR,666398,666384,14,1214428,645338,569090,0.22693811407510367,2756,0.41356666736694886
47,DR SHAKEEL AHMAD,GEN,MADHUBANI,328182,3,INC,0,M,BIHAR,695146,695136,10,1257633,675680,581953,26.095212196244848,328182,47.21051405028584
66,HUKUM DEO NARAYAN YADAV,GEN,MADHUBANI,241093,4,BJP,10,M,BIHAR,695146,695136,10,1257633,675680,581953,19.1711731482873,241103,34.68379304491431
79,CHATURANAN MISHRA,GEN,MADHUBANI,92168,1,CPI,0,M,BIHAR,695146,695136,10,1257633,675680,581953,7.328688098992313,92168,13.258797432481808
60,RAM CHANDRA YADAV,GEN,MADHUBANI,6948,7,KSVP,0,M,BIHAR,695146,695136,10,1257633,675680,581953,0.5524664190586602,6948,0.9995022628339946
42,AJAY KUMAR PURBE,GEN,MADHUBANI,6175,5,SP,0,M,BIHAR,695146,695136,10,1257633,675680,581953,0.49100174693253124,6175,0.8883026011801838
27,RAJENDRA YADAV,GEN,MADHUBANI,5928,10,IND,0,M,BIHAR,695146,695136,10,1257633,675680,581953,0.4713616770552299,5928,0.8527704971329764
45,MISHRI DAS,SC,MADHUBANI,5337,2,BSP,0,M,BIHAR,695146,695136,10,1257633,675680,581953,0.42436863536500713,5337,0.7677523858297394
30,IRFANUR RAHMAN,GEN,MADHUBANI,3697,6,RLD,0,M,BIHAR,695146,695136,10,1257633,675680,581953,0.2939649325359624,3697,0.531830723330063
36,PARIKSHAN PASWAN,SC,MADHUBANI,2961,8,IND,0,M,BIHAR,695146,695136,10,1257633,675680,581953,0.23544229516878137,2961,0.4259536845497205
35,PASHUPATI CHAUDHARY,GEN,MADHUBANI,2647,9,IND,0,M,BIHAR,695146,695136,10,1257633,675680,581953,0.21047475694419593,2647,0.38078331746136784
53,DEVENDRA PRASAD YADAV,GEN,JHANJHARPUR,323400,2,RJD,0,M,BIHAR,704243,704243,0,1163817,609549,554268,27.787873866767715,323400,45.92164920347096
67,JAGANNATH MISHRA,GEN,JHANJHARPUR,310565,1,JD(U),0,M,BIHAR,704243,704243,0,1163817,609549,554268,26.68503725242027,310565,44.099124875930606
49,DEO NATH YADAV,GEN,JHANJHARPUR,42859,4,SP,0,M,BIHAR,704243,704243,0,1163817,609549,554268,3.6826236427204617,42859,6.08582548921324
30,SANJAY KUMAR,GEN,JHANJHARPUR,8194,7,IND,0,M,BIHAR,704243,704243,0,1163817,609549,554268,0.7040625802853885,8194,1.163518842217814
30,RAGHU NATH PRASAD KUSHWAHA,GEN,JHANJHARPUR,7836,3,BSP,0,M,BIHAR,704243,704243,0,1163817,609549,554268,0.6733017304266907,7836,1.1126841161360497
38,UPENDAR PASWAN,SC,JHANJHARPUR,7102,5,IND,0,M,BIHAR,704243,704243,0,1163817,609549,554268,0.6102333958001989,7102,1.0084587280242756
54,JANAK ROY,GEN,JHANJHARPUR,4287,6,IND,0,M,BIHAR,704243,704243,0,1163817,609549,554268,0.3683568808498243,4287,0.6087387450070502
48,MD ALI ASHRAF FATMI,GEN,DARBHANGA,427671,1,RJD,1,M,BIHAR,762657,762655,2,1202456,645171,557285,35.566540480483276,427672,56.07658488678396
43,KIRTI AZAD,GEN,DARBHANGA,284208,3,BJP,1,M,BIHAR,762657,762655,2,1202456,645171,557285,23.635708915752428,284209,37.26563841936808
58,SAFI AHMAD,GEN,DARBHANGA,13546,8,IND,0,M,BIHAR,762657,762655,2,1202456,645171,557285,1.1265277066271033,13546,1.7761588761396014
37,BAIDYA NATH YADAV,GEN,DARBHANGA,13443,4,CPI(ML)(L),0,M,BIHAR,762657,762655,2,1202456,645171,557285,1.1179619046351799,13443,1.7626534602055706
68,KAMAL NARAYAN SAHU,GEN,DARBHANGA,7583,2,BSP,0,M,BIHAR,762657,762655,2,1202456,645171,557285,0.6306259854830447,7583,0.994287077939362
32,MD SAFI ALAM,GEN,DARBHANGA,7534,9,IND,0,M,BIHAR,762657,762655,2,1202456,645171,557285,0.6265509923024211,7534,0.9878621713299687
45,MITHILESH KUMAR YADAV,GEN,DARBHANGA,3620,5,SP,0,M,BIHAR,762657,762655,2,1202456,645171,557285,0.30105051660933957,3620,0.4746563658368047
30,RAM SWARATH SAFI,SC,DARBHANGA,3105,7,IND,0,M,BIHAR,762657,762655,2,1202456,645171,557285,0.2582215066497236,3105,0.40712928616665156
79,JHARI LAL DAS,GEN,DARBHANGA,1945,6,IND,0,M,BIHAR,762657,762655,2,1202456,645171,557285,0.16175228033291864,1945,0.2550294562299959
43,RAM CHANDRA PASWAN,SC,ROSERA (SC),394234,5,LJNSP,6,M,BIHAR,713798,713782,16,1245733,660747,584986,31.647230987699608,394240,55.23131193979249
50,DASHAI CHAUDHARY,SC,ROSERA (SC),255824,1,JD(U),5,M,BIHAR,713798,713782,16,1245733,660747,584986,20.536423134010256,255829,35.84053191519169
33,LAL BAHADUR SADA,SC,ROSERA (SC),18829,6,CPI(ML)(L),0,M,BIHAR,713798,713782,16,1245733,660747,584986,1.5114795867172177,18829,2.6378611315806433
33,HALCHAL RAM,SC,ROSERA (SC),16820,10,IND,0,M,BIHAR,713798,713782,16,1245733,660747,584986,1.3502090736939616,16820,2.356408956035181
35,SATRUDHAN KUMAR PASWAN,SC,ROSERA (SC),6584,7,SP,0,M,BIHAR,713798,713782,16,1245733,660747,584986,0.5285241701070775,6584,0.9223898077607391
30,SANATAN KUMAR SATHI,SC,ROSERA (SC),5128,2,BSP,0,M,BIHAR,713798,713782,16,1245733,660747,584986,0.41164519202750505,5128,0.718410530710369
62,GULAB PASWAN,SC,ROSERA (SC),4960,4,AD,0,M,BIHAR,713798,713782,16,1245733,660747,584986,0.3981591560952467,4960,0.6948744602814803
41,NANDJEE RAM,SC,ROSERA (SC),4959,9,IND,0,M,BIHAR,713798,713782,16,1245733,660747,584986,0.39807888207184045,4959,0.6947343646241654
29,KRIPANATH RAM,SC,ROSERA (SC),3406,8,IND,0,M,BIHAR,713798,713782,16,1245733,660747,584986,0.2734133237218569,3406,0.4771658088142584
69,KEDAR PASWAN,SC,ROSERA (SC),3038,3,SHS,5,M,BIHAR,713798,713782,16,1245733,660747,584986,0.2442738532253701,3043,0.4263110852089807
35,ALOK KUMAR MEHTA,GEN,SAMASTIPUR,437445,1,RJD,12,M,BIHAR,864746,864688,58,1433793,762349,671444,30.510471176801673,437457,50.58791830202164
54,RAM CHANDRA SINGH,GEN,SAMASTIPUR,310641,2,JD(U),33,M,BIHAR,864746,864688,58,1433793,762349,671444,21.667981361326216,310674,35.92661891468708
38,SHEEL KUMAR ROY,GEN,SAMASTIPUR,60184,12,IND,7,M,BIHAR,864746,864688,58,1433793,762349,671444,4.198025795913357,60191,6.960541014355661
61,RAMCHANDRA MAHTO,GEN,SAMASTIPUR,17647,3,CPI,0,M,BIHAR,864746,864688,58,1433793,762349,671444,1.2307913345929293,17647,2.040714845746612
55,SHYAM NARAYAN ROY,GEN,SAMASTIPUR,11344,13,IND,0,M,BIHAR,864746,864688,58,1433793,762349,671444,0.7911881282723517,11344,1.3118302946761247
69,SURENDRA PRASAD,GEN,SAMASTIPUR,7133,6,CPI(ML)(L),1,M,BIHAR,864746,864688,58,1433793,762349,671444,0.49756136346041585,7134,0.8249821334819705
34,BIRESH CHAUDHARY,GEN,SAMASTIPUR,4731,11,IND,0,M,BIHAR,864746,864688,58,1433793,762349,671444,0.32996394877084767,4731,0.5470970666530981
62,RAMPRIT THAKUR,GEN,SAMASTIPUR,4233,10,IND,0,M,BIHAR,864746,864688,58,1433793,762349,671444,0.2952309015318111,4233,0.4895079017422457
33,SAIYDUL ZAFAR ANSARI,GEN,SAMASTIPUR,3883,4,BSP,1,M,BIHAR,864746,864688,58,1433793,762349,671444,0.2708898704345746,3884,0.4491492299472909
55,DEWAKI SAH,GEN,SAMASTIPUR,1900,8,IND,1,M,BIHAR,864746,864688,58,1433793,762349,671444,0.13258538715142282,1901,0.21983333834443872
67,RAJENDRA PRASAD YADAV,GEN,SAMASTIPUR,1892,5,SP,2,M,BIHAR,864746,864688,58,1433793,762349,671444,0.13209717162798257,1894,0.2190238520906717
36,RAMA SHANKAR RAM,SC,SAMASTIPUR,1840,9,IND,0,M,BIHAR,864746,864688,58,1433793,762349,671444,0.12833093759001474,1840,0.21277924384732627
49,ARUN KUMAR THAKUR,GEN,SAMASTIPUR,1815,7,IND,1,M,BIHAR,864746,864688,58,1433793,762349,671444,0.12665705579536238,1816,0.21000386240583943
53,VIJAY KRISHNA,GEN,BARH,426849,3,RJD,7,M,BIHAR,864102,864069,33,1242851,657091,585760,34.34490538286569,426856,49.398797827108375
52,NITISH KUMAR,GEN,BARH,389143,2,JD(U),25,M,BIHAR,864102,864069,33,1242851,657091,585760,31.312522579134587,389168,45.03727569199006
73,ANANDI MAHTO,GEN,BARH,16240,1,BSP,0,M,BIHAR,864102,864069,33,1242851,657091,585760,1.3066731249361347,16240,1.8794077551029857
33,MITHILESH YADAV,GEN,BARH,12940,5,CPI(ML)(L),0,M,BIHAR,864102,864069,33,1242851,657091,585760,1.0411545712237429,12940,1.4975083959995463
50,SATENDRA KUMAR SINGH,GEN,BARH,7983,7,IND,0,M,BIHAR,864102,864069,33,1242851,657091,585760,0.6423135194806135,7983,0.9238492677947743
49,SARBIND KUMAR,GEN,BARH,4809,8,IND,1,M,BIHAR,864102,864069,33,1242851,657091,585760,0.3870134070777591,4810,0.5566472476628916
45,INDRA KUMAR SINGH CHANDAPURI,GEN,BARH,4563,4,SP,0,M,BIHAR,864102,864069,33,1242851,657091,585760,0.36713974563322554,4563,0.5280626592693918
33,SANJAY KUMAR,GEN,BARH,1542,6,RLD,0,M,BIHAR,864102,864069,33,1242851,657091,585760,0.12406957873469948,1542,0.17845115507197068
39,SURAJ SINGH,GEN,BALIA,233868,8,LJNSP,1,M,BIHAR,632343,632330,13,1181597,630146,551451,19.79261964950825,233869,36.9845163147216
72,SHATRUGHNA PRASAD SINGH,GEN,BALIA,157640,3,CPI,2,M,BIHAR,632343,632330,13,1181597,630146,551451,13.341435362479762,157642,24.929824478170868
73,RAMJIVAN SINGH,GEN,BALIA,118700,2,JD(U),6,M,BIHAR,632343,632330,13,1181597,630146,551451,10.046234037493324,118706,18.772406747603753
48,RAJVANSHI MAHTO,GEN,BALIA,46925,7,SP,0,M,BIHAR,632343,632330,13,1181597,630146,551451,3.9713201709212194,46925,7.420814336523057
41,GANESH YADAV,GEN,BALIA,17730,1,BSP,0,M,BIHAR,632343,632330,13,1181597,630146,551451,1.5005115957471118,17730,2.8038580327448868
44,SHAHID AKHTAR,GEN,BALIA,17612,11,IND,0,M,BIHAR,632343,632330,13,1181597,630146,551451,1.4905251113535325,17612,2.7851972742641258
37,CHHATRAPATI YADAV,GEN,BALIA,10801,10,IND,0,M,BIHAR,632343,632330,13,1181597,630146,551451,0.9141018469071942,10801,1.7080919690737464
47,AUNKUSHA BAHA,GEN,BALIA,10627,9,IND,0,M,BIHAR,632343,632330,13,1181597,630146,551451,0.8993760139878487,10627,1.6805752574156747
43,UPENDAR DAS,GEN,BALIA,9104,4,AD,0,M,BIHAR,632343,632330,13,1181597,630146,551451,0.7704826603317375,9104,1.4397249593970363
79,KULDIP NARAYAN SINGH PATEL,GEN,BALIA,5034,5,SAP,4,M,BIHAR,632343,632330,13,1181597,630146,551451,0.42637210487162713,5038,0.7967195019158905
42,MAHBOOB ALAM,GEN,BALIA,4289,6,KVSP,0,M,BIHAR,632343,632330,13,1181597,630146,551451,0.36298331833950154,4289,0.6782711281693637
31,RANJEET RANJAN,GEN,SAHARSA,350426,6,LJNSP,0,F,BIHAR,738280,738272,8,1287666,671387,616279,27.214044635798412,350426,47.46518935905077
51,DINESH CHANDRA YADAV,GEN,SAHARSA,319634,1,JD(U),5,M,BIHAR,738280,738272,8,1287666,671387,616279,24.82312960037774,319639,43.29509129327626
35,SURESH KUMAR AZAD,GEN,SAHARSA,15415,10,IND,0,M,BIHAR,738280,738272,8,1287666,671387,616279,1.1971272053467281,15415,2.087961207130086
44,SHIV SHANKAR THAKUR,GEN,SAHARSA,12768,7,SP,2,M,BIHAR,738280,738272,8,1287666,671387,616279,0.9917167961257033,12770,1.7296960502790268
40,DEVENDRA MUKHIA,GEN,SAHARSA,8964,8,IND,0,M,BIHAR,738280,738272,8,1287666,671387,616279,0.6961432545396089,8964,1.2141734843148941
41,SURESH PRASAD MEHTA,GEN,SAHARSA,8950,2,BSP,0,M,BIHAR,738280,738272,8,1287666,671387,616279,0.6950560160787036,8950,1.212277184807932
45,MOHAN KAMAT,GEN,SAHARSA,7301,5,AD,0,M,BIHAR,738280,738272,8,1287666,671387,616279,0.56699485736208,7301,0.9889201928807498
47,RAMDEO SHARMA,GEN,SAHARSA,7283,9,IND,0,M,BIHAR,738280,738272,8,1287666,671387,616279,0.565596979340916,7283,0.9864820935146558
62,MOHD KAMAL UDDIN,GEN,SAHARSA,4220,3,JHP,0,M,BIHAR,738280,738272,8,1287666,671387,616279,0.3277247360728636,4220,0.5715988513842987
66,DEONARAYAN DAS,GEN,SAHARSA,3311,4,SHS,1,M,BIHAR,738280,738272,8,1287666,671387,616279,0.2572095558941527,3312,0.4486102833613263
55,LALU PRASAD,GEN,MADHEPURA,344293,2,RJD,8,M,BIHAR,695674,695657,17,1187490,620337,567153,28.99401258115858,344301,49.49171594741215
55,SHARAD YADAV,GEN,MADHEPURA,274307,3,JD(U),7,M,BIHAR,695674,695657,17,1187490,620337,567153,23.100320844807115,274314,39.43140033981434
30,ARVIND SAH,GEN,MADHEPURA,21152,1,BSP,0,M,BIHAR,695674,695657,17,1187490,620337,567153,1.7812360525141262,21152,3.0405046041680444
39,SATTO MANDAL,GEN,MADHEPURA,11673,12,IND,0,M,BIHAR,695674,695657,17,1187490,620337,567153,0.9829977515600132,11673,1.6779411045978434
66,N K SINGH,GEN,MADHEPURA,9683,6,SAP,2,M,BIHAR,695674,695657,17,1187490,620337,567153,0.8155858154594986,9685,1.3921750705071627
36,ANANT LAL SADA,SC,MADHEPURA,8493,4,SP,0,M,BIHAR,695674,695657,17,1187490,620337,567153,0.7152060227875603,8493,1.2208304464447428
56,PRASANNA KUMAR,GEN,MADHEPURA,6475,7,IND,0,M,BIHAR,695674,695657,17,1187490,620337,567153,0.5452677496231547,6475,0.9307520476545048
54,SHASHISHEKHAR PRASAD SINGH,GEN,MADHEPURA,4712,11,IND,0,M,BIHAR,695674,695657,17,1187490,620337,567153,0.39680334150182317,4712,0.6773287488105061
33,DR BIJENDRA KUMAR,GEN,MADHEPURA,4594,8,IND,0,M,BIHAR,695674,695657,17,1187490,620337,567153,0.386866415717185,4594,0.6603667809922464
62,MD KAMALUDDIN,GEN,MADHEPURA,3592,5,JHP,0,M,BIHAR,695674,695657,17,1187490,620337,567153,0.3024867577832234,3592,0.5163338000270241
44,RAM NARESH CHAUPAL,SC,MADHEPURA,3524,10,IND,0,M,BIHAR,695674,695657,17,1187490,620337,567153,0.296760393771737,3524,0.5065591067080271
63,RADHESHYAM AGARWAL,GEN,MADHEPURA,3159,9,IND,0,M,BIHAR,695674,695657,17,1187490,620337,567153,0.2660232928277291,3159,0.45409200286341017
51,SUKDEO PASWAN,SC,ARARIA (SC),216677,2,BJP,0,M,BIHAR,652439,652439,0,1184962,622535,562427,18.285565275510944,216677,33.21030778356291
46,RAMJI DAS RISHIDEO,SC,ARARIA (SC),188933,7,SP,0,M,BIHAR,652439,652439,0,1184962,622535,562427,15.944224371752005,188933,28.957956222727336
59,RAM SEWAK HAZARI,SC,ARARIA (SC),173502,8,LJNSP,0,M,BIHAR,652439,652439,0,1184962,622535,562427,14.64198851946307,173502,26.592830900666577
43,NARAYAN KUMAR RAM,SC,ARARIA (SC),17316,1,BSP,0,M,BIHAR,652439,652439,0,1184962,622535,562427,1.4613126834447012,17316,2.6540412207118216
30,SATYA NARAYAN WRITER,SC,ARARIA (SC),11946,13,IND,0,M,BIHAR,652439,652439,0,1184962,622535,562427,1.0081335941574499,11946,1.8309757693822717
42,NAND LAL PASWAN,SC,ARARIA (SC),8033,10,IND,0,M,BIHAR,652439,652439,0,1184962,622535,562427,0.6779120343099609,8033,1.2312262142514474
36,ARUN KUMAR RAJAK,SC,ARARIA (SC),7905,3,IJP,0,M,BIHAR,652439,652439,0,1184962,622535,562427,0.6671100001519036,7905,1.211607521929253
37,DAYA CHAND KATARIA,SC,ARARIA (SC),6260,9,IND,0,M,BIHAR,652439,652439,0,1184962,622535,562427,0.5282869830424942,6260,0.9594766713823055
36,PUSHPA NAND RISHIDEO,SC,ARARIA (SC),6094,11,IND,0,M,BIHAR,652439,652439,0,1184962,622535,562427,0.5142780949937635,6094,0.93403367977696
39,RAJDHAR PASWAN,SC,ARARIA (SC),4807,6,SHS,0,M,BIHAR,652439,652439,0,1184962,622535,562427,0.40566701717017084,4807,0.7367738593186489
64,LALU PASWAN,SC,ARARIA (SC),4661,12,IND,0,M,BIHAR,652439,652439,0,1184962,622535,562427,0.39334594695863667,4661,0.7143962883886463
25,OM PRAKASH PASWAN,SC,ARARIA (SC),3367,4,AD,0,M,BIHAR,652439,652439,0,1184962,622535,562427,0.2841441328920252,3367,0.5160635706939652
47,JAGDEO RAM,SC,ARARIA (SC),2938,5,SAP,0,M,BIHAR,652439,652439,0,1184962,622535,562427,0.247940440284161,2938,0.4503102972078616
62,TASLIMUDDIN,GEN,KISHANGANJ,420331,1,RJD,0,M,BIHAR,813315,813315,0,1278476,669530,608946,32.87750415338262,420331,51.68120592882217
35,SYED SHAHNAWAZ HUSSAIN,GEN,KISHANGANJ,259834,3,BJP,0,M,BIHAR,813315,813315,0,1278476,669530,608946,20.323729190066924,259834,31.947523407289918
48,ABDUL JALIL MASTAN,GEN,KISHANGANJ,77356,4,SP,0,M,BIHAR,813315,813315,0,1278476,669530,608946,6.050641545089622,77356,9.511197998315536
71,VISHWANATH KEJARIWAL,GEN,KISHANGANJ,15234,2,BSP,0,M,BIHAR,813315,813315,0,1278476,669530,608946,1.191574968947403,15234,1.8730750078382916
35,SYAM SUNDER THAKUR,GEN,KISHANGANJ,12261,10,IND,0,M,BIHAR,813315,813315,0,1278476,669530,608946,0.9590324730382112,12261,1.5075339812987587
27,CHHOTELAL MAHTO,GEN,KISHANGANJ,11479,5,IND,0,M,BIHAR,813315,813315,0,1278476,669530,608946,0.8978658965831193,11479,1.4113842730061539
42,LAL CHAND JALAN,GEN,KISHANGANJ,6822,9,IND,0,M,BIHAR,813315,813315,0,1278476,669530,608946,0.5336040723486402,6822,0.8387893989413695
40,NEVI LAL DAS,SC,KISHANGANJ,3634,8,IND,0,M,BIHAR,813315,813315,0,1278476,669530,608946,0.2842446788207209,3634,0.4468133503009289
29,DILIP KUMAR PANJIAR,GEN,KISHANGANJ,3278,6,IND,0,M,BIHAR,813315,813315,0,1278476,669530,608946,0.2563990250892469,3278,0.4030418718454719
29,DEV KUMAR SAH,GEN,KISHANGANJ,3086,7,IND,0,M,BIHAR,813315,813315,0,1278476,669530,608946,0.2413811444250811,3086,0.3794347823414052
44,UDAY SINGH,GEN,PURNEA,244426,1,BJP,0,M,BIHAR,709015,709015,0,1179491,614568,564923,20.723006788521488,244426,34.47402382178092
37,RAJESH RANJAN ALIAS PAPPU YADAV,GEN,PURNEA,231543,9,LJNSP,0,M,BIHAR,709015,709015,0,1179491,614568,564923,19.63075597863824,231543,32.65699597328688
42,JEEVACHHA PASWAN,SC,PURNEA,57021,11,IND,0,M,BIHAR,709015,709015,0,1179491,614568,564923,4.834373471268539,57021,8.042284013737367
36,DR IRSHAD AHMAD KHAN,GEN,PURNEA,47301,3,SP,0,M,BIHAR,709015,709015,0,1179491,614568,564923,4.0102891840632955,47301,6.671368024653922
27,RAJ KUMAR HEMBRAM,ST,PURNEA,25609,8,JDP,0,M,BIHAR,709015,709015,0,1179491,614568,564923,2.1711907933167782,25609,3.6119123008681058
34,AWADESH KU MANDAL,GEN,PURNEA,21619,10,IND,0,M,BIHAR,709015,709015,0,1179491,614568,564923,1.8329092803590703,21619,3.049159749793728
38,SATYA NARAYAN RAM,SC,PURNEA,18378,15,IND,0,M,BIHAR,709015,709015,0,1179491,614568,564923,1.5581297356232477,18378,2.5920467126929614
41,NEELAM DEVI,GEN,PURNEA,16569,12,IND,0,F,BIHAR,709015,709015,0,1179491,614568,564923,1.4047584932822716,16569,2.336904014724653
50,JAI KRISHNA MANDAL,GEN,PURNEA,14160,5,SAP,0,M,BIHAR,709015,709015,0,1179491,614568,564923,1.2005178504965277,14160,1.997136872985762
44,SYED SAHID RAJA,GEN,PURNEA,7976,2,BSP,0,M,BIHAR,709015,709015,0,1179491,614568,564923,0.6762238965791175,7976,1.1249409391902851
47,MADHAVI SARKAR,GEN,PURNEA,7595,7,CPI(ML)(L),0,F,BIHAR,709015,709015,0,1179491,614568,564923,0.6439218272966898,7595,1.0712044173959647
60,LALIT MOHAN SINGH,GEN,PURNEA,6740,14,IND,0,M,BIHAR,709015,709015,0,1179491,614568,564923,0.5714329316628953,6740,0.950614585022884
61,MD RIAUZUDDIN,GEN,PURNEA,4056,13,IND,0,M,BIHAR,709015,709015,0,1179491,614568,564923,0.3438771470066325,4056,0.572061239889142
32,PRAKASH KUMAR SINGH,GEN,PURNEA,3302,6,AD,0,M,BIHAR,709015,709015,0,1179491,614568,564923,0.2799512671143739,3302,0.46571652221744253
54,UPENDRA NATH SAGAR,GEN,PURNEA,2720,4,RLD,0,M,BIHAR,709015,709015,0,1179491,614568,564923,0.23060794868294882,2720,0.3836308117599769
61,NIKHIL KUMAR CHOUDHARY,GEN,KATIHAR,288908,1,BJP,14,M,BIHAR,704449,704422,27,1158042,615925,542117,24.94918146319391,288922,41.01389880601719
54,SHAH TARIQ ANWAR,GEN,KATIHAR,286350,2,NCP,7,M,BIHAR,704449,704422,27,1158042,615925,542117,24.727686906001683,286357,40.64978444145708
54,MUBARAK HUSSAIN,GEN,KATIHAR,37583,6,SP,1,M,BIHAR,704449,704422,27,1158042,615925,542117,3.2454781432797772,37584,5.3352336365017194
50,RADHA URAON,ST,KATIHAR,23602,7,JDP,0,M,BIHAR,704449,704422,27,1158042,615925,542117,2.0380953367839854,23602,3.3504199736247764
43,QUDDUS ALI,GEN,KATIHAR,19568,4,CPI(ML)(L),1,M,BIHAR,704449,704422,27,1158042,615925,542117,1.6898350837016276,19569,2.7779157895035693
60,SHIV NANDAN MANDAL,GEN,KATIHAR,14662,3,BSP,1,M,BIHAR,704449,704422,27,1158042,615925,542117,1.266188963785424,14663,2.0814849620057663
56,SOVRAN RAJAK,SC,KATIHAR,13780,14,IND,0,M,BIHAR,704449,704422,27,1158042,615925,542117,1.1899395704128175,13780,1.9561387694495982
43,PRADEEP KUMAR SHARMA,GEN,KATIHAR,5265,8,IND,0,M,BIHAR,704449,704422,27,1158042,615925,542117,0.45464672265772743,5265,0.747392643044422
31,SUSHIL KUMAR PASWAN,SC,KATIHAR,3594,13,IND,0,M,BIHAR,704449,704422,27,1158042,615925,542117,0.310351438030745,3594,0.5101859751380157
25,PREM KUMAR,GEN,KATIHAR,3540,5,SHS,0,M,BIHAR,704449,704422,27,1158042,615925,542117,0.305688394721435,3540,0.5025204095683293
36,BINOD KUMAR THAKUR,GEN,KATIHAR,1997,11,IND,0,M,BIHAR,704449,704422,27,1158042,615925,542117,0.1724462497905948,1997,0.2834839711604389
37,SUNIL KUMAR CHOUDHARY,GEN,KATIHAR,1905,12,IND,0,M,BIHAR,704449,704422,27,1158042,615925,542117,0.16450180563399253,1905,0.27042411870838057
39,PRADEEP KUMAR SAH,GEN,KATIHAR,1851,9,IND,0,M,BIHAR,704449,704422,27,1158042,615925,542117,0.15983876232468253,1851,0.26275855313869423
29,MAHMAD IQBAL QURESHI,GEN,KATIHAR,1817,10,IND,3,M,BIHAR,704449,704422,27,1158042,615925,542117,0.15716183005452308,1820,0.25835795068202244
40,GIRIDHARI YADAV,GEN,BANKA,339880,1,RJD,0,M,BIHAR,713888,713888,0,1213614,649519,564095,28.005609691384574,339880,47.609709086019095
48,DIGVIJAY SINGH,GEN,BANKA,335211,2,JD(U),0,M,BIHAR,713888,713888,0,1213614,649519,564095,27.62089099169917,335211,46.95568492536644
53,RAJENDRA PANDIT NETAJEE,GEN,BANKA,14506,3,BSP,0,M,BIHAR,713888,713888,0,1213614,649519,564095,1.195272961584161,14506,2.0319714016764534
37,MITHAN YADAV,GEN,BANKA,8929,11,IND,0,M,BIHAR,713888,713888,0,1213614,649519,564095,0.7357364038318609,8929,1.2507564211753104
47,FANI LAL SAH,GEN,BANKA,3447,10,IND,0,M,BIHAR,713888,713888,0,1213614,649519,564095,0.28402770567907093,3447,0.4828488502398135
44,MAHBOOB ALAM ANSARI,GEN,BANKA,3143,4,IND,0,M,BIHAR,713888,713888,0,1213614,649519,564095,0.25897855496063826,3143,0.4402651396297458
35,RANVIR YADAV,GEN,BANKA,3081,5,SP,0,M,BIHAR,713888,713888,0,1213614,649519,564095,0.25386984659043155,3081,0.4315803039132189
54,UMAKANT YADAV,GEN,BANKA,2016,7,IND,0,M,BIHAR,713888,713888,0,1213614,649519,564095,0.16611542055381695,2016,0.2823972387825541
30,PRAVIN KUMAR JHA,GEN,BANKA,1332,9,IND,0,M,BIHAR,713888,713888,0,1213614,649519,564095,0.10975483143734334,1332,0.18658388990990185
43,UDAY KUMAR SINGH,GEN,BANKA,1196,6,IND,0,M,BIHAR,713888,713888,0,1213614,649519,564095,0.0985486324317287,1196,0.16753328253171365
39,AMP YADAV,GEN,BANKA,1147,8,IND,0,M,BIHAR,713888,713888,0,1213614,649519,564095,0.09451110484882344,1147,0.16066946075574878
51,SUSHIL KUMAR MODI,GEN,BHAGALPUR,345137,3,BJP,14,M,BIHAR,757287,757266,21,1388037,742323,645714,24.86612388574656,345151,45.57730424528613
62,SUBODH RAY,GEN,BHAGALPUR,227297,2,CPM,1,M,BIHAR,757287,757266,21,1388037,742323,645714,16.37550007672706,227298,30.01477643218489
33,PRAWEZ KHAN,GEN,BHAGALPUR,130064,1,BSP,0,M,BIHAR,757287,757266,21,1388037,742323,645714,9.370355401188874,130064,17.17499442087346
69,CHUNCHUN PRA YADAV,GEN,BHAGALPUR,13239,5,SP,0,M,BIHAR,757287,757266,21,1388037,742323,645714,0.9537930184858184,13239,1.7482143493814102
32,SUNIL CHOUDHARY,GEN,BHAGALPUR,12200,10,IND,2,M,BIHAR,757287,757266,21,1388037,742323,645714,0.8790831944681591,12202,1.6112781547814765
31,ASHOK RAY,GEN,BHAGALPUR,8721,4,PTSS,4,M,BIHAR,757287,757266,21,1388037,742323,645714,0.6285855492324772,8725,1.1521391493581694
40,DIWAKAR LAL VANSHI,GEN,BHAGALPUR,7001,8,IND,0,M,BIHAR,757287,757266,21,1388037,742323,645714,0.5043813673554811,7001,0.9244843764649334
53,NARESH PRASAD YADAV,GEN,BHAGALPUR,6399,9,IND,0,M,BIHAR,757287,757266,21,1388037,742323,645714,0.4610107655631658,6399,0.8449900764175273
63,"NAGARMAL BAJORIA ""DHARTIPAKAR""",GEN,BHAGALPUR,3838,6,ABHM,0,M,BIHAR,757287,757266,21,1388037,742323,645714,0.2765055974732662,3838,0.5068091753852899
40,AKHIL BHARATIYA SHARMA,GEN,BHAGALPUR,3370,7,IND,0,M,BIHAR,757287,757266,21,1388037,742323,645714,0.24278891701013736,3370,0.44500961986670845
58,RABINDRA KU RANA,GEN,KHAGARIA,322432,1,RJD,8,M,BIHAR,676017,675969,48,1196971,638246,558725,26.937995991548668,322440,47.69702537066375
41,RENU KUMARI,GEN,KHAGARIA,255294,2,JD(U),23,F,BIHAR,676017,675969,48,1196971,638246,558725,21.330257792377594,255317,37.76783719936037
59,LAKSHMAN SAHANI,GEN,KHAGARIA,38362,3,BSP,0,M,BIHAR,676017,675969,48,1196971,638246,558725,3.2049230933748603,38362,5.674709363817774
50,BHARAT KUMAR YADAV,GEN,KHAGARIA,20968,4,KVSP,1,M,BIHAR,676017,675969,48,1196971,638246,558725,1.7518385992643097,20969,3.101845071943457
64,BISHWESHWAR PRASAD CHAURASIA,GEN,KHAGARIA,16137,7,SP,1,M,BIHAR,676017,675969,48,1196971,638246,558725,1.348236506983043,16138,2.3872180729182846
45,RAMBILAS PASWAN,SC,KHAGARIA,10928,9,IND,7,M,BIHAR,676017,675969,48,1196971,638246,558725,0.9135559675213518,10935,1.617562871939611
34,DEEPAK KUMAR SINGH,GEN,KHAGARIA,4709,8,IND,1,M,BIHAR,676017,675969,48,1196971,638246,558725,0.3934932425263436,4710,0.6967280408628777
66,RAMGULAM SAHANI,GEN,KHAGARIA,4561,6,SAP,7,M,BIHAR,676017,675969,48,1196971,638246,558725,0.3816299643015578,4568,0.6757226519451434
47,MADHULATA DEVI,GEN,KHAGARIA,2578,5,AD,0,F,BIHAR,676017,675969,48,1196971,638246,558725,0.21537698072885644,2578,0.3813513565487258
54,JAY PRAKASH NARAYAN YADAV,GEN,MONGHYR,453284,2,RJD,2,M,BIHAR,838216,838209,7,1310042,715744,594298,34.60087539178133,453286,54.07746929192475
46,DR MONAZIR HASSAN,GEN,MONGHYR,337358,3,JD(U),1,M,BIHAR,838216,838209,7,1310042,715744,594298,25.751769790586863,337359,40.247263235252014
57,ARJUN KUMAR BIND,GEN,MONGHYR,14907,1,BSP,3,M,BIHAR,838216,838209,7,1310042,715744,594298,1.138131449220712,14910,1.7787777852009505
55,BRAHMA NAND MANDAL,GEN,MONGHYR,14339,5,SAP,1,M,BIHAR,838216,838209,7,1310042,715744,594298,1.0946213938179081,14340,1.7107762199719403
59,RAM DEO SINGH YADAV,GEN,MONGHYR,4567,6,RLD,0,M,BIHAR,838216,838209,7,1310042,715744,594298,0.3486147772361497,4567,0.5448476287734904
39,SUJAY KUMAR BHANU,SC,MONGHYR,4458,9,IND,0,M,BIHAR,838216,838209,7,1310042,715744,594298,0.34029443330824505,4458,0.5318438206858375
56,ANAND MOHAN,GEN,MONGHYR,3759,4,SPVD,0,M,BIHAR,838216,838209,7,1310042,715744,594298,0.2869373653669119,3759,0.4484524275365777
64,JANG BAHADUR RAM,SC,MONGHYR,3318,8,IND,0,M,BIHAR,838216,838209,7,1310042,715744,594298,0.2532743225026373,3318,0.39584069022781715
71,SHIV NANDAN PRASAD SINGH,GEN,MONGHYR,2219,7,SP,0,M,BIHAR,838216,838209,7,1310042,715744,594298,0.1693838823488102,2219,0.26472890042662034
50,RAJIV RANJAN SINGH,GEN,BEGUSARAI,301556,3,JD(U),6,M,BIHAR,678667,678647,20,1280963,680576,600387,23.541819709078247,301562,44.434457546926545
73,KRISHNA SAHI,GEN,BEGUSARAI,281059,1,INC,12,F,BIHAR,678667,678647,20,1280963,680576,600387,21.942163825184647,281071,41.41515647585635
27,KUMAR SUMAN SINGH,GEN,BEGUSARAI,61352,8,IND,0,M,BIHAR,678667,678647,20,1280963,680576,600387,4.789521633333671,61352,9.040074145346686
38,RAJENDRA MAHTO,GEN,BEGUSARAI,10276,9,IND,0,M,BIHAR,678667,678647,20,1280963,680576,600387,0.8022089631004173,10276,1.5141446394181535
27,MANOJ KUMAR MAHTO,GEN,BEGUSARAI,9480,2,BSP,0,M,BIHAR,678667,678647,20,1280963,680576,600387,0.7400682143043944,9480,1.3968558954538823
59,D P OJHA,GEN,BEGUSARAI,5779,7,IND,1,M,BIHAR,678667,678647,20,1280963,680576,600387,0.45122302517715185,5780,0.8516695227556371
59,RAM KISHUN SAH,GEN,BEGUSARAI,4338,4,AD,0,M,BIHAR,678667,678647,20,1280963,680576,600387,0.33865146768485893,4338,0.6391941850716183
46,SHANKAR LAL CHOKHANI,GEN,BEGUSARAI,2645,5,LSD,1,M,BIHAR,678667,678647,20,1280963,680576,600387,0.20656334335964424,2646,0.38988193031339374
54,SREE NARAYAN GOSWAMI,GEN,BEGUSARAI,2162,6,IJP,0,M,BIHAR,678667,678647,20,1280963,680576,600387,0.16877926997110768,2162,0.31856565885773136
52,NITISH KUMAR,GEN,NALANDA,471285,1,JD(U),25,M,BIHAR,895116,895089,27,1311971,683838,628133,35.92381234036423,471310,52.65351082988127
41,DR KUMAR PUSHPANJAY,GEN,NALANDA,368914,3,LJNSP,0,M,BIHAR,895116,895089,27,1311971,683838,628133,28.119066656198953,368914,41.21409962507653
44,PERMANAND PRASAD,GEN,NALANDA,19124,5,CPI(ML)(L),0,M,BIHAR,895116,895089,27,1311971,683838,628133,1.457654170709566,19124,2.136482869259403
48,RAM PRAWESH PRASAD,GEN,NALANDA,16487,2,BSP,2,M,BIHAR,895116,895089,27,1311971,683838,628133,1.2568113167135555,16489,1.8421076151024
66,JAGESHWAR YADAV,GEN,NALANDA,4479,4,SP,0,M,BIHAR,895116,895089,27,1311971,683838,628133,0.3413947411947368,4479,0.500382073384902
32,RAJESH KUMAR,GEN,NALANDA,3440,13,IND,0,M,BIHAR,895116,895089,27,1311971,683838,628133,0.262200917550769,3440,0.3843077321821976
44,JYOTESHWAR KUMAR SHARMA,GEN,NALANDA,2366,10,IND,0,M,BIHAR,895116,895089,27,1311971,683838,628133,0.18033935201311613,2366,0.2643232832392673
49,NAWAL KISHORE SINGH,GEN,NALANDA,2105,11,IND,0,M,BIHAR,895116,895089,27,1311971,683838,628133,0.16044561960592116,2105,0.2351650512335831
71,ARUN KUMAR MEHTA,GEN,NALANDA,1826,8,IND,0,M,BIHAR,895116,895089,27,1311971,683838,628133,0.1391799056534024,1826,0.2039959066757828
44,BAJANG PRASAD KESARI,GEN,NALANDA,1782,6,RSMD,0,M,BIHAR,895116,895089,27,1311971,683838,628133,0.13582617298705535,1782,0.19908034265949887
43,MOHAN SAW,GEN,NALANDA,1344,12,IND,0,M,BIHAR,895116,895089,27,1311971,683838,628133,0.10244128871750977,1344,0.15014813722467257
40,CHANDRA BHUSHAN KUMAR,GEN,NALANDA,1051,9,IND,0,M,BIHAR,895116,895089,27,1311971,683838,628133,0.08010847800751694,1051,0.1174149495707819
59,SHIV SHANKAR PRASAD,GEN,NALANDA,886,7,SHS,0,M,BIHAR,895116,895089,27,1311971,683838,628133,0.0675319805087155,886,0.09898158450971717
47,RAM KRIPAL YADAV,GEN,PATNA,433840,3,RJD,13,M,BIHAR,901616,901556,60,1741220,954178,787042,24.916610192853287,433853,48.11948767546272
68,C P THAKUR,GEN,PATNA,395248,1,BJP,43,M,BIHAR,901616,901556,60,1741220,954178,787042,22.701956099746155,395291,43.842500576742204
55,RANJAN PRASAD YADAV,GEN,PATNA,18035,7,SPVD,0,M,BIHAR,901616,901556,60,1741220,954178,787042,1.035768024718301,18035,2.0002972440595554
39,VIDYA NAND VAKAL,SC,PATNA,12680,9,CPI(ML)(L),0,M,BIHAR,901616,901556,60,1741220,954178,787042,0.7282250376173028,12680,1.4063636847615837
43,MANOJ KUMAR SINGH,GEN,PATNA,12649,2,BSP,2,M,BIHAR,901616,901556,60,1741220,954178,787042,0.7265595387142348,12651,1.4031472378484855
42,JITENDRA THAKUR,GEN,PATNA,4474,4,AD,1,M,BIHAR,901616,901556,60,1741220,954178,787042,0.2570037100423841,4475,0.49633103227981756
36,MANOJ KUMAR,GEN,PATNA,3541,16,IND,0,M,BIHAR,901616,901556,60,1741220,954178,787042,0.20336315916426412,3541,0.3927392592855495
30,RAVI SHANKAR KUSHWAHA,GEN,PATNA,3213,17,IND,0,M,BIHAR,901616,901556,60,1741220,954178,787042,0.1845257922605989,3213,0.356360135578783
74,KAMESHWAR PRASAD SINGHA,GEN,PATNA,2601,14,IND,0,M,BIHAR,901616,901556,60,1741220,954178,787042,0.14937802230619912,2601,0.2884820145161576
45,MD SHAHABUDDIN,GEN,PATNA,1925,10,SP,0,M,BIHAR,901616,901556,60,1741220,954178,787042,0.1105546685657183,1925,0.21350552785221202
26,SUNIL KUMAR CHOUDHARY NISHAD,GEN,PATNA,1802,23,IND,0,M,BIHAR,901616,901556,60,1741220,954178,787042,0.10349065597684382,1802,0.19986335646217457
65,RAM NAGINA CHOUDHARY,GEN,PATNA,1376,19,IND,0,M,BIHAR,901616,901556,60,1741220,954178,787042,0.07902505140074201,1376,0.15261486042838635
34,AMIT KUMAR ALBELA,GEN,PATNA,1358,12,IND,1,M,BIHAR,901616,901556,60,1741220,954178,787042,0.07804872445756424,1359,0.15072935706553567
39,RADHEY SHYAM GUPTA ALIAS RADHE,GEN,PATNA,1310,8,JHSP,0,M,BIHAR,901616,901556,60,1741220,954178,787042,0.07523460562134596,1310,0.1452946709020248
54,DWARIKA SINGH,GEN,PATNA,1304,5,VJP,0,M,BIHAR,901616,901556,60,1741220,954178,787042,0.07489001964140085,1304,0.14462919912690103
70,N M BAJORIYA,GEN,PATNA,1270,6,ABHM,0,M,BIHAR,901616,901556,60,1741220,954178,787042,0.07293736575504532,1270,0.14085819240119962
52,OM PRAKASH SINHA,GEN,PATNA,1177,13,IND,0,M,BIHAR,901616,901556,60,1741220,954178,787042,0.06759628306589632,1177,0.13054337988678105
46,SUNIL KUMAR SINGH,GEN,PATNA,1039,11,RLD,0,M,BIHAR,901616,901556,60,1741220,954178,787042,0.059670805527159115,1039,0.11523752905893418
25,KUNJ BIHARI,GEN,PATNA,912,15,IND,0,M,BIHAR,901616,901556,60,1741220,954178,787042,0.05237706895165459,912,0.10115170981881423
39,SHATRUDHAN SHARMA,GEN,PATNA,535,21,IND,0,M,BIHAR,901616,901556,60,1741220,954178,787042,0.030725583211771056,535,0.059337899948536846
69,RAMA NAND SINHA,GEN,PATNA,462,20,IND,0,M,BIHAR,901616,901556,60,1741220,954178,787042,0.02653312045577239,462,0.05124132668453089
42,RAM KUMAR SINGH,GEN,PATNA,454,18,IND,0,M,BIHAR,901616,901556,60,1741220,954178,787042,0.026073672482512262,454,0.05035403098436585
39,SHAJAD ALAM,GEN,PATNA,351,22,IND,0,M,BIHAR,901616,901556,60,1741220,954178,787042,0.020158279826788115,351,0.038930098844741
47,KANTI SINGH,GEN,ARRAH,299389,2,RJD,33,F,BIHAR,787399,787298,101,1360794,736947,623847,22.003477381587512,299422,38.026718347369
79,RAM NARESH RAM,SC,ARRAH,149675,6,CPI(ML)(L),4,M,BIHAR,787399,787298,101,1360794,736947,623847,10.999387122518177,149679,19.009295160395173
58,BRAHMESHWAR NATH SIGH,GEN,ARRAH,148957,9,IND,16,M,BIHAR,787399,787298,101,1360794,736947,623847,10.947505647438186,148973,18.919632867199475
35,ASHOK KUMAR VERMA,GEN,ARRAH,147502,1,JD(U),23,M,BIHAR,787399,787298,101,1360794,736947,623847,10.841097182968179,147525,18.73573626585759
60,HARIDWAR PRASAD SINGH,GEN,ARRAH,11761,8,SAP,15,M,BIHAR,787399,787298,101,1360794,736947,623847,0.8653771254135454,11776,1.4955568904710317
45,NARENDRA KUMAR SINGH,GEN,ARRAH,7696,5,SP,3,M,BIHAR,787399,787298,101,1360794,736947,623847,0.5657726298028944,7699,0.9777761973281652
67,RAM KUNDAL SHARMA,GEN,ARRAH,7049,3,BSP,1,M,BIHAR,787399,787298,101,1360794,736947,623847,0.5180798857137817,7050,0.8953529278040739
37,RAMESHWAR PRASAD GUPTA,GEN,ARRAH,5604,11,IND,0,M,BIHAR,787399,787298,101,1360794,736947,623847,0.41181839426099764,5604,0.7117103272927703
34,RAMESHWAR KUMAR BHARTI,GEN,ARRAH,4534,7,JP,5,M,BIHAR,787399,787298,101,1360794,736947,623847,0.3335552625893412,4539,0.5764548850074739
37,RANA SINGH,GEN,ARRAH,2880,10,IND,1,M,BIHAR,787399,787298,101,1360794,736947,623847,0.21171463131083762,2881,0.3658881964544024
34,JITENDRA TIWARY,GEN,ARRAH,2251,4,ABJS,0,M,BIHAR,787399,787298,101,1360794,736947,623847,0.16541813088535076,2251,0.2858779348208469
66,LALMUNI CHAUBEY,GEN,BUXAR,205963,2,BJP,17,M,BIHAR,649158,649116,42,1222441,678823,543618,16.849892960069237,205980,31.730333755418556
40,DADAN SINGH,GEN,BUXAR,151104,8,IND,10,M,BIHAR,649158,649116,42,1222441,678823,543618,12.361659990134493,151114,23.27846225418157
60,SHIVANAND TIWARY,GEN,BUXAR,133459,4,RJD,8,M,BIHAR,649158,649116,42,1222441,678823,543618,10.918072937671429,133467,20.5600177460649
44,SHIV KUMAR SINGH KUSHWAHA,GEN,BUXAR,75303,3,BSP,6,M,BIHAR,649158,649116,42,1222441,678823,543618,6.16054271739904,75309,11.601027792925606
35,SHUSHILA DEVI,GEN,BUXAR,32807,7,CPI(ML)(L),0,F,BIHAR,649158,649116,42,1222441,678823,543618,2.6837287034711697,32807,5.0537773546655815
33,RAM EKBAL CHAUDHARI,GEN,BUXAR,16639,6,SBSP,0,M,BIHAR,649158,649116,42,1222441,678823,543618,1.3611290851664826,16639,2.5631664402194843
59,TEJ NARAYAN SINGH,GEN,BUXAR,11668,1,CPI,1,M,BIHAR,649158,649116,42,1222441,678823,543618,0.9545654964125059,11669,1.7975592998930923
56,RANJIT SINGH,GEN,BUXAR,10378,5,SP,0,M,BIHAR,649158,649116,42,1222441,678823,543618,0.8489571275832535,10378,1.598686298250965
47,SATENDRA SINGH,GEN,BUXAR,6831,11,IND,0,M,BIHAR,649158,649116,42,1222441,678823,543618,0.5587999748045099,6831,1.052286192267522
39,BISHESHWAR PANDEY,GEN,BUXAR,2973,9,IND,0,M,BIHAR,649158,649116,42,1222441,678823,543618,0.24320192140152366,2973,0.45797787287532465
37,LALSA DEVI,GEN,BUXAR,1991,10,IND,0,F,BIHAR,649158,649116,42,1222441,678823,543618,0.1628708461185448,1991,0.3067049932373937
57,MIRA KUMAR,SC,SASARAM (SC),416671,2,INC,2,F,BIHAR,697268,697265,3,1291800,686829,604971,32.25522526706921,416673,59.75794099255953
60,MUNI LALL,SC,SASARAM (SC),158410,3,BJP,1,M,BIHAR,697268,697265,3,1291800,686829,604971,12.262811580740053,158411,22.71881113144444
37,MADAN RAM,SC,SASARAM (SC),96580,1,BSP,0,M,BIHAR,697268,697265,3,1291800,686829,604971,7.476389533983589,96580,13.85120212027513
34,DUKHI RAM,SC,SASARAM (SC),9936,5,CPI(ML)(L),0,M,BIHAR,697268,697265,3,1291800,686829,604971,0.7691593125870878,9936,1.4249901042353872
42,ASHOK KUMAR,SC,SASARAM (SC),3587,4,SAP,0,M,BIHAR,697268,697265,3,1291800,686829,604971,0.27767456262579343,3587,0.5144363429843332
41,SUDARSHAN RAM,SC,SASARAM (SC),3403,11,IND,0,M,BIHAR,697268,697265,3,1291800,686829,604971,0.2634308716519585,3403,0.4880476373503445
53,SHIV KUMAR MUSHEHAR,SC,SASARAM (SC),2142,7,AD,0,M,BIHAR,697268,697265,3,1291800,686829,604971,0.1658151416627961,2142,0.30719895363045485
33,VASHISHTH PASWAN,SC,SASARAM (SC),2131,10,IND,0,M,BIHAR,697268,697265,3,1291800,686829,604971,0.16496361665892553,2131,0.30562136796755335
54,RAM BACHAN RAM,SC,SASARAM (SC),1896,6,SP,0,M,BIHAR,697268,697265,3,1291800,686829,604971,0.14677194612169067,1896,0.2719184015328396
44,TENGAR PASWAN,SC,SASARAM (SC),1386,8,IND,0,M,BIHAR,697268,697265,3,1291800,686829,604971,0.1072921504876916,1386,0.19877579352558847
40,PHEKHU RAM,SC,SASARAM (SC),1123,9,IND,0,M,BIHAR,697268,697265,3,1291800,686829,604971,0.08693296175878619,1123,0.16105715449439814
42,AJIT KUMAR SINGH,GEN,BIKRAMGANJ,305363,1,JD(U),29,M,BIHAR,733986,733925,61,1298849,708383,590466,23.512509922246544,305392,41.607333109895826
66,RAM PRASAD SINGH,GEN,BIKRAMGANJ,246575,3,RJD,16,M,BIHAR,733986,733925,61,1298849,708383,590466,18.985347796395118,246591,33.596144885597276
44,ARUN SINGH,GEN,BIKRAMGANJ,85973,4,CPI(ML)(L),0,M,BIHAR,733986,733925,61,1298849,708383,590466,6.619168202000386,85973,11.71316619118076
47,ARUN KUMAR SINGH,GEN,BIKRAMGANJ,52750,2,BSP,4,M,BIHAR,733986,733925,61,1298849,708383,590466,4.061596074678427,52754,7.187330548539073
45,GIRIJA PRASAD SINGH,GEN,BIKRAMGANJ,12438,10,IND,0,M,BIHAR,733986,733925,61,1298849,708383,590466,0.9576170902083305,12438,1.6945827304607988
65,RAM AWADESH SINGH,GEN,BIKRAMGANJ,8236,8,RLD,0,M,BIHAR,733986,733925,61,1298849,708383,590466,0.6340998838202131,8236,1.122092246991087
43,BABAN SINGH KUSHWAHA,GEN,BIKRAMGANJ,5480,5,RSMD,2,M,BIHAR,733986,733925,61,1298849,708383,590466,0.4220659984339981,5482,0.7468807306951358
37,SIPAHI PRASAD,GEN,BIKRAMGANJ,3727,16,IND,0,M,BIHAR,733986,733925,61,1298849,708383,590466,0.28694636558984143,3727,0.5077753526634022
33,VIRENDRA SINGH,GEN,BIKRAMGANJ,2389,14,IND,0,M,BIHAR,733986,733925,61,1298849,708383,590466,0.1839320814043819,2389,0.32548304736057637
35,BASUDEO HAJARIKA,GEN,BIKRAMGANJ,2023,6,SAP,5,M,BIHAR,733986,733925,61,1298849,708383,590466,0.1561382423976921,2028,0.276299547947781
40,RAMESHWAR PRASAD,GEN,BIKRAMGANJ,1887,13,IND,0,M,BIHAR,733986,733925,61,1298849,708383,590466,0.14528247702388808,1887,0.2570893722768554
25,MD JAMIL ANSARI,GEN,BIKRAMGANJ,1671,11,IND,0,M,BIHAR,733986,733925,61,1298849,708383,590466,0.12865236836614571,1671,0.22766101805756514
52,BAIJNATH BHAGAT,GEN,BIKRAMGANJ,1640,7,SSD,0,M,BIHAR,733986,733925,61,1298849,708383,590466,0.12626563980878455,1640,0.2234375042575744
42,SHRI NIWAS SINGH,GEN,BIKRAMGANJ,1526,15,IND,0,M,BIHAR,733986,733925,61,1298849,708383,590466,0.1174886380171983,1526,0.2079058728640601
40,RAM JANAM SINGH,GEN,BIKRAMGANJ,1336,9,SHS,5,M,BIHAR,733986,733925,61,1298849,708383,590466,0.10324525791681712,1341,0.18270103244476052
28,JYOTI SHANKER,GEN,BIKRAMGANJ,911,12,IND,0,M,BIHAR,733986,733925,61,1298849,708383,590466,0.07013902308890409,911,0.1241168087674697
63,NIKHIL KUMAR,GEN,AURANGABAD,289980,2,INC,29,M,BIHAR,767238,767159,79,1401973,752359,649614,20.685776402255964,290009,37.79909232858644
39,SUSHIL KUMAR SINGH,GEN,AURANGABAD,282516,3,JD(U),33,M,BIHAR,767238,767159,79,1401973,752359,649614,20.15366915054712,282549,36.826773439271776
48,RAJA RAM SINGH,GEN,AURANGABAD,106881,6,CPI(ML)(L),7,M,BIHAR,767238,767159,79,1401973,752359,649614,7.624112589900091,106888,13.931531024271479
41,JITENDRA YADAV,GEN,AURANGABAD,56416,1,BSP,2,M,BIHAR,767238,767159,79,1401973,752359,649614,4.0241859151353125,56418,7.353389691334371
49,RAJIV RANJAN SINGH,GEN,AURANGABAD,6055,7,SP,1,M,BIHAR,767238,767159,79,1401973,752359,649614,0.4319626697518426,6056,0.7893248248913637
25,SARJOON PASWAN,SC,AURANGABAD,5152,13,IND,0,M,BIHAR,767238,767159,79,1401973,752359,649614,0.3674821127083046,5152,0.6714995868296408
44,AASHUTOSH KUMAR SINGH,GEN,AURANGABAD,4297,8,IND,0,M,BIHAR,767238,767159,79,1401973,752359,649614,0.3064966301062859,4297,0.5600608937513523
31,ANN KUMAR,GEN,AURANGABAD,4009,4,AD,0,M,BIHAR,767238,767159,79,1401973,752359,649614,0.28595415175613226,4009,0.5225236497670865
37,RAJ BALABH SINGH,GEN,AURANGABAD,3385,5,SSD,6,M,BIHAR,767238,767159,79,1401973,752359,649614,0.24187341696309417,3391,0.4419749803841832
51,RAMESHWAR SINGH,GEN,AURANGABAD,2482,12,IND,0,M,BIHAR,767238,767159,79,1401973,752359,649614,0.17703621967042163,2482,0.32349805405884485
39,KAMTA PASWAN,SC,AURANGABAD,2168,11,IND,0,M,BIHAR,767238,767159,79,1401973,752359,649614,0.15463921202476796,2168,0.28257203110377743
52,UCHIT NARAIN SINGH,GEN,AURANGABAD,2150,10,IND,0,M,BIHAR,767238,767159,79,1401973,752359,649614,0.15335530712788337,2150,0.28022595335476086
54,INDRADEO RAM,SC,AURANGABAD,1668,9,IND,1,M,BIHAR,767238,767159,79,1401973,752359,649614,0.11904651516113363,1669,0.21753354239492828
57,GANESH PRASAD SINGH,GEN,JAHANABAD,400049,2,RJD,14,M,BIHAR,863843,863788,55,1246756,658975,587781,32.08831559663639,400063,46.3120034543314
44,ARUN KUMAR,GEN,JAHANABAD,353594,1,JD(U),31,M,BIHAR,863843,863788,55,1246756,658975,587781,28.363609238696263,353625,40.93625809319518
38,MAHANAND PRASAD,GEN,JAHANABAD,77743,4,CPI(ML)(L),0,M,BIHAR,863843,863788,55,1246756,658975,587781,6.235622687999897,77743,8.999667763702432
51,NAUSHAD AHMAD,GEN,JAHANABAD,15670,3,BSP,2,M,BIHAR,863843,863788,55,1246756,658975,587781,1.257022224075922,15672,1.814218555918147
79,RAMASHRAY PRASAD SINGH,GEN,JAHANABAD,5339,6,SPVD,2,M,BIHAR,863843,863788,55,1246756,658975,587781,0.428391762301525,5341,0.6182836464496442
56,TAPSI SINGH,GEN,JAHANABAD,2014,12,IND,0,M,BIHAR,863843,863788,55,1246756,658975,587781,0.16153922660087458,2014,0.233144217178353
59,SADHU SINHA,GEN,JAHANABAD,1932,14,IND,0,M,BIHAR,863843,863788,55,1246756,658975,587781,0.15496215779190156,1932,0.2236517515335541
49,RAM SINGHASAN SINGH,GEN,JAHANABAD,1596,5,AD,0,M,BIHAR,863843,863788,55,1246756,658975,587781,0.12801221730635345,1596,0.18475579474510992
47,AJAY KUMAR BHADANI,GEN,JAHANABAD,1575,8,IND,1,M,BIHAR,863843,863788,55,1246756,658975,587781,0.12640805418221368,1576,0.18244055922198826
30,JAGYA NAND SINGH,GEN,JAHANABAD,1143,11,IND,1,M,BIHAR,863843,863788,55,1246756,658975,587781,0.09175813070079471,1144,0.13243147192256002
43,SATYENDRA PRASAD YADAV,GEN,JAHANABAD,1079,13,IND,0,M,BIHAR,863843,863788,55,1246756,658975,587781,0.08654460054734046,1079,0.12490695647241455
41,CHANDRASHEKHAR SINGH ALIAS,GEN,JAHANABAD,813,10,IND,0,M,BIHAR,863843,863788,55,1246756,658975,587781,0.06520923099628155,813,0.09411432401489622
65,SHEO PUJAN SINGH,GEN,JAHANABAD,723,7,JP,2,M,BIHAR,863843,863788,55,1246756,658975,587781,0.05815091325006657,725,0.08392728771316084
29,ATENDRA SINGH,GEN,JAHANABAD,518,9,IND,2,M,BIHAR,863843,863788,55,1246756,658975,587781,0.04170824122763396,520,0.06019612360116364
41,VIRCHANDRA PASWAN,SC,NAWADA (SC),489976,2,RJD,16,M,BIHAR,1010037,1009961,76,1505472,792534,712938,32.54740041661353,489992,48.51228222332449
43,SANJAY PASWAN,SC,NAWADA (SC),433930,3,BJP,56,M,BIHAR,1010037,1009961,76,1505472,792534,712938,28.827238234919015,433986,42.96733684013556
54,BANBARI RAM,SC,NAWADA (SC),52384,10,IND,0,M,BIHAR,1010037,1009961,76,1505472,792534,712938,3.479573183692556,52384,5.186344658661019
44,BHOLA RAM,SC,NAWADA (SC),16356,1,BSP,3,M,BIHAR,1010037,1009961,76,1505472,792534,712938,1.0866359520469329,16359,1.619643636817265
61,DALIT PASWAN,SC,NAWADA (SC),3752,4,IJP,0,M,BIHAR,1010037,1009961,76,1505472,792534,712938,0.2492241635845768,3752,0.3714715401514994
37,MEWALAL RAJWANSHI,SC,NAWADA (SC),3622,6,CPI(ML)(L),1,M,BIHAR,1010037,1009961,76,1505472,792534,712938,0.24065542235259108,3623,0.3586997308019409
34,HARI CHOUDHARY,SC,NAWADA (SC),2219,14,IND,0,M,BIHAR,1010037,1009961,76,1505472,792534,712938,0.14739563406028142,2219,0.2196949220672114
33,PRAMOD KUMAR AKELA,SC,NAWADA (SC),1529,8,IND,0,M,BIHAR,1010037,1009961,76,1505472,792534,712938,0.10156283212175317,1529,0.15138059298817766
34,VIJAY RAVIDAS,SC,NAWADA (SC),1467,12,IND,0,M,BIHAR,1010037,1009961,76,1505472,792534,712938,0.09744452238234919,1467,0.14524220399846738
39,SHIVLAL RAJAK,SC,NAWADA (SC),1466,13,IND,0,M,BIHAR,1010037,1009961,76,1505472,792534,712938,0.09737809803171364,1466,0.14514319772443982
46,MAHENDRA PASWAN,SC,NAWADA (SC),1112,5,JP,0,M,BIHAR,1010037,1009961,76,1505472,792534,712938,0.07386387790672959,1112,0.11009497671867466
39,RAGHUNANDAN MOCHI,SC,NAWADA (SC),871,11,IND,0,M,BIHAR,1010037,1009961,76,1505472,792534,712938,0.05785560940356247,871,0.08623446467802665
29,NAGANDRA KUMAR VIKAL,SC,NAWADA (SC),659,7,IND,0,M,BIHAR,1010037,1009961,76,1505472,792534,712938,0.043773647068826256,659,0.06524513458417859
47,POLISH KUMAR DAS,SC,NAWADA (SC),618,9,IND,0,M,BIHAR,1010037,1009961,76,1505472,792534,712938,0.041050248692768784,618,0.0611858773490476
32,RAJESH KUMAR MANJHI,SC,GAYA (SC),464822,3,RJD,7,M,BIHAR,883403,883374,29,1436323,760863,675460,32.362428228191014,464829,52.618001070858945
60,BALBIR CHAND,SC,GAYA (SC),361873,2,BJP,22,M,BIHAR,883403,883374,29,1436323,760863,675460,25.19593434067407,361895,40.966014378488644
25,SHAKTI RAJ,SC,GAYA (SC),18184,4,BSP,0,M,BIHAR,883403,883374,29,1436323,760863,675460,1.2660105004236513,18184,2.0584036957085274
49,JANKI PASWAN,SC,GAYA (SC),16959,1,CPI,0,M,BIHAR,883403,883374,29,1436323,760863,675460,1.1807232774243677,16959,1.9197353869072213
32,NIRANJAN KUMAR,SC,GAYA (SC),8046,5,CPI(ML)(L),0,M,BIHAR,883403,883374,29,1436323,760863,675460,0.5601804051038659,8046,0.9107960919308628
27,SURBALA KRISHNA,SC,GAYA (SC),4014,12,IND,0,F,BIHAR,883403,883374,29,1436323,760863,675460,0.27946360254622393,4014,0.45437925839056464
31,VISHWANATH CHAUDAHARY,SC,GAYA (SC),1919,8,AD,0,M,BIHAR,883403,883374,29,1436323,760863,675460,0.13360504566173487,1919,0.21722815068547424
43,AJAY KUMAR CHOUDHARY,SC,GAYA (SC),1702,9,IND,0,M,BIHAR,883403,883374,29,1436323,760863,675460,0.11849702330186176,1702,0.1926640502692429
27,MANOJ KUMAR,SC,GAYA (SC),1607,6,SP,0,M,BIHAR,883403,883374,29,1436323,760863,675460,0.11188291213048876,1607,0.18191018142342735
34,RAMADHAR RAJWAR,SC,GAYA (SC),1460,7,IJP,0,M,BIHAR,883403,883374,29,1436323,760863,675460,0.10164844537057473,1460,0.16526998436727067
35,LALDEV MANJHI,SC,GAYA (SC),1423,11,IND,0,M,BIHAR,883403,883374,29,1436323,760863,675460,0.09907242312488208,1423,0.16108163544837406
25,RAJU MANJHI,SC,GAYA (SC),1365,10,IND,0,M,BIHAR,883403,883374,29,1436323,760863,675460,0.09503433419920171,1365,0.1545161155214551
50,SHRIPAD YESSO NAIK,GEN,PANAJI,144142,4,BJP,700,M,GOA,254819,253904,915,425663,214333,211330,34.02738786316875,144842,56.841130370969196
76,D'SOUZA WILFRED,GEN,PANAJI,88436,2,NCP,193,M,GOA,254819,253904,915,425663,214333,211330,20.821400967431984,88629,34.781158390857826
50,CHRISTOPHER OSWALD FONSECA,GEN,PANAJI,7974,1,CPI,3,M,GOA,254819,253904,915,425663,214333,211330,1.8740177088447902,7977,3.1304573049890316
47,PARESH ATMARAM RAIKAR,GEN,PANAJI,5369,3,MAG,8,M,GOA,254819,253904,915,425663,214333,211330,1.2632058694319215,5377,2.110125226140908
37,SAMEER ANANT BANDODKAR,GEN,PANAJI,4017,5,SHS,10,M,GOA,254819,253904,915,425663,214333,211330,0.9460535681983165,4027,1.5803374159697667
49,ADV RAMESH SAKHARAM NAIK,GEN,PANAJI,2541,7,IND,0,M,GOA,254819,253904,915,425663,214333,211330,0.5969511092108076,2541,0.99717838936657
60,BHONSLE DHUMA RAJARAM,GEN,PANAJI,1425,6,IND,1,M,GOA,254819,253904,915,425663,214333,211330,0.3350068011549042,1426,0.5596129017067016
55,ALEMAO CHURCHIL BRAZ,GEN,MORMUGAO,164034,2,INC,398,M,GOA,297678,296751,927,515504,261514,253990,31.897327663800862,164432,55.23821041528094
54,ANGLE RAMAKANT SOIRU,GEN,MORMUGAO,113397,1,BJP,511,M,GOA,297678,296751,927,515504,261514,253990,22.096433781309166,113908,38.265508368102445
58,AUDA VIEGAS,GEN,MORMUGAO,5879,3,UGDP,2,F,GOA,297678,296751,927,515504,261514,253990,1.1408252894254944,5881,1.97562466826571
48,RAJU MANGESHKAR,GEN,MORMUGAO,4033,5,CPI,5,M,GOA,297678,296751,927,515504,261514,253990,0.7833110897296627,4038,1.3564993046177414
28,FERNANDES EDWIN,GEN,MORMUGAO,2774,9,IND,0,M,GOA,297678,296751,927,515504,261514,253990,0.5381141562432105,2774,0.9318794133258084
49,PRABHU VISHNU GOPAL,GEN,MORMUGAO,2212,6,SHS,5,M,GOA,297678,296751,927,515504,261514,253990,0.430064558179956,2217,0.7447644770523855
48,DIAS JAWAHAR EMERCIANO,GEN,MORMUGAO,2202,4,MAG,5,M,GOA,297678,296751,927,515504,261514,253990,0.4281247090226264,2207,0.7414051424693796
39,COELHO MIGEL PIEDADE,GEN,MORMUGAO,1397,8,IND,0,M,GOA,297678,296751,927,515504,261514,253990,0.2709969272789348,1397,0.46929904124591
29,ALEXY FERNANDES,GEN,MORMUGAO,823,7,IND,1,M,GOA,297678,296751,927,515504,261514,253990,0.15984357056395296,824,0.2768091696396778
63,GADHAVI PUSHPADAN SHAMBHUDAN,GEN,KUTCH,221024,1,BJP,33,M,GUJARAT,459043,458980,63,1006563,512531,494032,21.96156624076188,221057,48.1560550972349
46,SHAILENDRASINH JADEJA,GEN,KUTCH,192038,2,INC,29,M,GUJARAT,459043,458980,63,1006563,512531,494032,19.08146832339357,192067,41.84074258838496
43,SHEDA DHANRAJ JAKHU,GEN,KUTCH,20334,8,IND,0,M,GUJARAT,459043,458980,63,1006563,512531,494032,2.0201418093055277,20334,4.429650381336825
40,PATEL TARABEN SHAMBHULAL,GEN,KUTCH,9244,7,IND,0,F,GUJARAT,459043,458980,63,1006563,512531,494032,0.9183727198396922,9244,2.0137547027184817
41,LIKHESH DAMJI MOMAYA,GEN,KUTCH,7062,3,JD(U),0,M,GUJARAT,459043,458980,63,1006563,512531,494032,0.7015954291981724,7062,1.5384179695584075
33,ENGINEER ANIL KANAYALAL BELANI,GEN,KUTCH,3209,4,IND,0,M,GUJARAT,459043,458980,63,1006563,512531,494032,0.3188076652926841,3209,0.6990630507381661
34,JAT UMAR HUSHEN,GEN,KUTCH,3082,6,IND,0,M,GUJARAT,459043,458980,63,1006563,512531,494032,0.30619047193270565,3082,0.6713967972499308
42,KOLI GANGARAM LAKHA,GEN,KUTCH,2987,5,IND,1,M,GUJARAT,459043,458980,63,1006563,512531,494032,0.29685176188673734,2988,0.6509194127783235
63,KOLI PATEL SOMABHAI GANDABHAI,GEN,SURENDRANAGAR,219859,1,BJP,13,M,GUJARAT,455554,455525,29,1109656,573510,536146,19.814428976187216,219872,48.26475017231766
72,SAVSHIBHAI KANJIBHAI MAKWANA,GEN,SURENDRANAGAR,185915,3,INC,13,M,GUJARAT,455554,455525,29,1109656,573510,536146,16.75546295428493,185928,40.813602778155825
51,JINJARIYA RATILAL SAVSI,GEN,SURENDRANAGAR,15498,2,BSP,1,M,GUJARAT,455554,455525,29,1109656,573510,536146,1.3967391696165299,15499,3.4022311295697105
69,VAGHELA SATUBHA KANUBHA,GEN,SURENDRANAGAR,14738,9,IND,2,M,GUJARAT,455554,455525,29,1109656,573510,536146,1.328339593531689,14740,3.235620804558845
39,BHATT SUNIL SANATBHAI,GEN,SURENDRANAGAR,6821,4,SP,0,M,GUJARAT,455554,455525,29,1109656,573510,536146,0.6146950045779953,6821,1.4972977956510096
52,PATEL AMRUTLAL HIRJIBHAI,GEN,SURENDRANAGAR,4015,8,IND,0,M,GUJARAT,455554,455525,29,1109656,573510,536146,0.361823844506766,4015,0.8813444728835659
47,DEVJIBHAI GOVINDBHAI FATEPARA,GEN,SURENDRANAGAR,3764,7,IND,0,M,GUJARAT,455554,455525,29,1109656,573510,536146,0.33920422184893334,3764,0.8262467237693006
50,KANJIBHAI SHIVABHAI PATEL,GEN,SURENDRANAGAR,2885,5,IND,0,M,GUJARAT,455554,455525,29,1109656,573510,536146,0.25999048353724036,2885,0.6332948453970331
36,DUDHATRA MUKUNDBHAI GOVINDBHAI,GEN,SURENDRANAGAR,2030,6,IND,0,M,GUJARAT,455554,455525,29,1109656,573510,536146,0.1829395776709178,2030,0.44561127769704584
48,AHIR VIKRAMBHAI ARJANBHAI MADAM,GEN,JAMNAGAR,204454,1,INC,14,M,GUJARAT,433441,433393,48,1072175,550481,521694,19.07039429197659,204468,47.173202350492915
55,KORADIA CHANDRESHBHAI VALJIBHAI,GEN,JAMNAGAR,198841,2,BJP,34,M,GUJARAT,433441,433393,48,1072175,550481,521694,18.548744374752253,198875,45.88283065053837
27,HIGLA KALABHAI ANANDBHAI,SC,JAMNAGAR,11808,10,IND,0,M,GUJARAT,433441,433393,48,1072175,550481,521694,1.1013127521160258,11808,2.724246206519457
42,KUNGDA JUSAB SIDIK,GEN,JAMNAGAR,5306,3,BSP,0,M,GUJARAT,433441,433393,48,1072175,550481,521694,0.4948818989437358,5306,1.2241573824349796
46,VYAS RAJESH SHIVSHANKER,GEN,JAMNAGAR,3774,9,IND,0,M,GUJARAT,433441,433393,48,1072175,550481,521694,0.35199477697204284,3774,0.8707067397869606
43,BHOKAL KASAM ABUBHAI,GEN,JAMNAGAR,3739,8,IND,0,M,GUJARAT,433441,433393,48,1072175,550481,521694,0.3487303844987992,3739,0.8626318230162813
42,CHAVDA DEVAYAT JIVABHAI,GEN,JAMNAGAR,1725,4,IND,0,M,GUJARAT,433441,433393,48,1072175,550481,521694,0.16088791475272227,1725,0.3979780408406219
30,PARMAR NARSHIBHAI BHOJABHAI,SC,JAMNAGAR,1306,7,IND,0,M,GUJARAT,433441,433393,48,1072175,550481,521694,0.12180847343017696,1306,0.30130975150020417
30,TRIVEDI PIYUSH NAVNITRAI,GEN,JAMNAGAR,1235,6,IND,0,M,GUJARAT,433441,433393,48,1072175,550481,521694,0.1151864201273113,1235,0.28492920605111194
40,JOGEL MANILAL DEVJIBHAI,SC,JAMNAGAR,1205,5,IND,0,M,GUJARAT,433441,433393,48,1072175,550481,521694,0.1123883694359596,1205,0.2780078488191011
49,DR KATHIRIA VALLABHBHAI RAMJIBHAI,GEN,RAJKOT,320541,1,BJP,63,M,GUJARAT,538626,538380,246,1650135,851198,798937,19.428955812706235,320604,59.52256296576846
61,BALVANTBHAI BACHUBHAI MANVAR,GEN,RAJKOT,176453,3,NCP,181,M,GUJARAT,538626,538380,246,1650135,851198,798937,10.704215109672845,176634,32.793441088993106
52,KARANABHAI MALDHARI,GEN,RAJKOT,22664,2,BSP,2,M,GUJARAT,538626,538380,246,1650135,851198,798937,1.3735845855036102,22666,4.208114721532195
47,MULTANI SUBHANBHAI POPATBHAI,GEN,RAJKOT,12819,5,IND,0,M,GUJARAT,538626,538380,246,1650135,851198,798937,0.7768455308202057,12819,2.3799445255149214
61,DALABHAI RAGHAVJIBHAI LORIYA,GEN,RAJKOT,5903,4,IND,0,M,GUJARAT,538626,538380,246,1650135,851198,798937,0.35772830707790576,5903,1.0959366981913239
51,PATEL HARILAL MADHAVJIBHAI (HARIBHAI,GEN,PORBANDAR,229003,1,BJP,110,M,GUJARAT,490480,490331,149,995027,512684,482343,23.02580733990133,229113,46.711996411678356
44,RADADIYA VITHALBHAI HANSRAJBHAI,GEN,PORBANDAR,223374,3,INC,36,M,GUJARAT,490480,490331,149,995027,512684,482343,22.45265706357717,223410,45.54925786984179
26,MAVANI AJAYBHAI VRUJLAL,GEN,PORBANDAR,14064,7,IND,0,M,GUJARAT,490480,490331,149,995027,512684,482343,1.4134289823291228,14064,2.867395204697439
46,TUKADIYA GORDHAN RAJABHAI,GEN,PORBANDAR,8907,4,IND,0,M,GUJARAT,490480,490331,149,995027,512684,482343,0.8951515888513579,8907,1.8159761865927253
68,BHUTIYA KESHAVBHAI AEBHABHAI,GEN,PORBANDAR,7297,2,BSP,3,M,GUJARAT,490480,490331,149,995027,512684,482343,0.7336484336605941,7300,1.4883379546566629
43,BANDIYA MADHUBHAI MEGHABHAI,GEN,PORBANDAR,4277,5,IND,0,M,GUJARAT,490480,490331,149,995027,512684,482343,0.4298375822967618,4277,0.872002935899527
49,MANSUKHBHAI SUNDARJI DHOKAI,GEN,PORBANDAR,3409,6,IND,0,M,GUJARAT,490480,490331,149,995027,512684,482343,0.34260376854095415,3409,0.6950334366335018
49,BARAD JASUBHAI DHANABHAI,GEN,JUNAGADH,329369,2,INC,343,M,GUJARAT,658706,657979,727,1239398,638826,600572,26.602592548963287,329712,50.05450079398093
49,CHIKHALIYA BHAVNABEN DEVARAJBHAI,GEN,JUNAGADH,288413,1,BJP,378,F,GUJARAT,658706,657979,727,1239398,638826,600572,23.300908989686928,288791,43.842169344138355
44,PARMAR UMARBHAI HABIBBHAI,GEN,JUNAGADH,14759,7,IND,0,M,GUJARAT,658706,657979,727,1239398,638826,600572,1.1908200594159422,14759,2.240605065082146
35,MANVAR MADHUKAR BHOJABHAI,SC,JUNAGADH,11752,3,BSP,5,M,GUJARAT,658706,657979,727,1239398,638826,600572,0.9486056940546944,11757,1.7848630496761835
36,CHAVDA KHIMJIBHAI ANANDBHAI,SC,JUNAGADH,7740,6,IND,0,M,GUJARAT,658706,657979,727,1239398,638826,600572,0.6244967314777012,7740,1.1750310457169055
48,DANGAR NITABEN RAMBHAI,GEN,JUNAGADH,3262,5,SP,1,F,GUJARAT,658706,657979,727,1239398,638826,600572,0.2632729760738681,3263,0.4953651553196722
49,GORASIYA PRAVINBHAI MOHANBHAI,GEN,JUNAGADH,2684,4,JMP,0,M,GUJARAT,658706,657979,727,1239398,638826,600572,0.2165567477113889,2684,0.4074655460858107
43,VIRJIBHAI THUMMAR,GEN,AMRELI,220608,2,INC,41,M,GUJARAT,475646,475548,98,1025515,526194,499321,21.515921268825906,220649,46.38933156170766
49,DILEEP SANGHANI,GEN,AMRELI,218562,1,BJP,57,M,GUJARAT,475646,475548,98,1025515,526194,499321,21.317971945802842,218619,45.96254357232059
33,HITESH RATHOD,GEN,AMRELI,16915,6,IND,0,M,GUJARAT,475646,475548,98,1025515,526194,499321,1.6494151718892458,16915,3.5562161775774417
37,SOLANKI GAUTAMBHAI DAYABHAI,GEN,AMRELI,9583,3,SP,0,M,GUJARAT,475646,475548,98,1025515,526194,499321,0.9344573214433725,9583,2.014733646451352
60,SHIROYA VALJIBHAI LALLUBHAI,GEN,AMRELI,6622,5,IND,0,M,GUJARAT,475646,475548,98,1025515,526194,499321,0.6457243433786927,6622,1.392211855035047
62,VALODARA VAJUBHAI JIVABHAI,SC,AMRELI,3258,4,IND,0,M,GUJARAT,475646,475548,98,1025515,526194,499321,0.31769403665475393,3258,0.6849631869079105
48,RANA RAJENDRASINH GHANASHYAMSINH,GEN,BHAVNAGAR,247314,3,BJP,22,M,GUJARAT,444831,444803,28,1236416,642149,594267,20.00427040737098,247336,55.60223995180193
73,GIGABHAI BHAVUBHAI GOHIL (GIGABHAI,GEN,BHAVNAGAR,166904,1,INC,6,M,GUJARAT,444831,444803,28,1236416,642149,594267,13.49950178580672,166910,37.522115140356675
28,KHERALA DILIPKUMAR MANAJIBHAI,GEN,BHAVNAGAR,12544,5,IND,0,M,GUJARAT,444831,444803,28,1236416,642149,594267,1.0145452663181322,12544,2.819947350791649
59,MAKWANA MEGHJIBHAI MAVJIBHAI,GEN,BHAVNAGAR,10093,4,SP,0,M,GUJARAT,444831,444803,28,1236416,642149,594267,0.8163110150628915,10093,2.268951579363848
47,GOSWAMI DHIRAJGIRI BALDEVGIRI,GEN,BHAVNAGAR,7948,2,BSP,0,M,GUJARAT,444831,444803,28,1236416,642149,594267,0.6428257156167503,7948,1.7867459776859076
55,VARMA RATILAL KALIDAS,SC,DHANDHUKA (SC),249307,3,BJP,15,M,GUJARAT,516553,516531,22,1156178,595408,560770,21.56432660022938,249322,48.26648959545293
70,YOGENDRAKUMAR MAVJIBHAI MAKWANA,SC,DHANDHUKA (SC),226521,2,INC,7,M,GUJARAT,516553,516531,22,1156178,595408,560770,19.592830861683925,226528,43.85377686316796
37,CHAVDA MANILAL RAMJIBHAI,SC,DHANDHUKA (SC),11638,1,BSP,0,M,GUJARAT,516553,516531,22,1156178,595408,560770,1.0065924105111843,11638,2.253011791626416
28,SOYANTAR DINESHKUMAR KALIDAS,SC,DHANDHUKA (SC),11627,7,IND,0,M,GUJARAT,516553,516531,22,1156178,595408,560770,1.005640999915238,11627,2.2508822908781867
64,PARMAR CHHABILDAS KESHAVLAL,SC,DHANDHUKA (SC),7142,4,LJNSP,0,M,GUJARAT,516553,516531,22,1156178,595408,560770,0.6177249523862243,7142,1.3826267585320384
55,JAYABEN MAGANBHAI RANVA,SC,DHANDHUKA (SC),5681,6,IND,0,F,GUJARAT,516553,516531,22,1156178,595408,560770,0.491360326870084,5681,1.099790340971788
38,CHAUHAN JITENDRAKUMAR NARANBHAI,SC,DHANDHUKA (SC),4615,5,IND,0,M,GUJARAT,516553,516531,22,1156178,595408,560770,0.39915999093565174,4615,0.8934223593706745
56,HARIN PATHAK,GEN,AHMEDABAD,301787,3,BJP,66,M,GUJARAT,548559,548391,168,1382793,734567,648226,21.82922534320032,301853,55.02653315322509
54,GUPTA RAJKUMAR GIGRAJ,GEN,AHMEDABAD,224151,1,INC,97,M,GUJARAT,548559,548391,168,1382793,734567,648226,16.217033207428734,224248,40.87946784210996
61,DR RATHOD MANGALAM VIRAMBHAI,SC,AHMEDABAD,7888,2,BSP,1,M,GUJARAT,548559,548391,168,1382793,734567,648226,0.5705119999884293,7889,1.438131541001059
40,SHAIKH SAMSUDDIN NASHIRUDDIN (JUGNU),GEN,AHMEDABAD,5408,10,IND,3,M,GUJARAT,548559,548391,168,1382793,734567,648226,0.3913094729290646,5411,0.9864025565162544
55,AMBALAL MAFATLAL CHAUHAN,GEN,AHMEDABAD,2725,4,JD(U),0,M,GUJARAT,548559,548391,168,1382793,734567,648226,0.19706492584211807,2725,0.4967560462958405
28,NAYAK SANJUDE KALADE PAVAIYA,GEN,AHMEDABAD,1850,7,IND,0,M,GUJARAT,548559,548391,168,1382793,734567,648226,0.13378719736070402,1850,0.33724722409075414
65,DR PRAVINCHANDRA JAYANTILAL SHUKLA,GEN,AHMEDABAD,1292,8,IND,0,M,GUJARAT,548559,548391,168,1382793,734567,648226,0.09343408594055654,1292,0.23552616947311047
54,FARMER JAYANAND DAVIDBHAI,GEN,AHMEDABAD,1237,9,IND,0,M,GUJARAT,548559,548391,168,1382793,734567,648226,0.0894566287217248,1237,0.22549990064879075
33,MINAXI CHANDUBHAI KHETANI (NITA C,GEN,AHMEDABAD,1188,5,SP,0,F,GUJARAT,548559,548391,168,1382793,734567,648226,0.0859130759267656,1188,0.2165674066053059
63,UJAINWALA NOORMOHAMMAD DAUDJI,GEN,AHMEDABAD,865,6,IND,1,M,GUJARAT,548559,548391,168,1382793,734567,648226,0.06262687184560524,866,0.1578681600338341
76,L K ADVANI,GEN,GANDHINAGAR,516020,1,BJP,100,M,GUJARAT,845576,845212,364,2126829,1101787,1025042,24.26711315296152,516120,61.03768318873761
71,GABHAJI MANGAJI THAKOR,GEN,GANDHINAGAR,298723,2,INC,259,M,GUJARAT,845576,845212,364,2126829,1101787,1025042,14.057641681583238,298982,35.35838292477554
58,SUNIL SHAH,GEN,GANDHINAGAR,8412,13,IND,0,M,GUJARAT,845576,845212,364,2126829,1101787,1025042,0.3955183985172292,8412,0.9948248294653586
76,VITTHALBHAI PANDYA,GEN,GANDHINAGAR,8391,12,IND,4,M,GUJARAT,845576,845212,364,2126829,1101787,1025042,0.394719086489793,8395,0.9928143655922117
52,L N MEDIPALLY (ADVOCATE),GEN,GANDHINAGAR,6659,3,BSP,1,M,GUJARAT,845576,845212,364,2126829,1101787,1025042,0.31314224133675067,6660,0.7876287879504621
33,BRAHMBHATT SANJAYBHAI AMARKUMAR,GEN,GANDHINAGAR,1234,11,IND,0,M,GUJARAT,845576,845212,364,2126829,1101787,1025042,0.058020649520953496,1234,0.14593602467430486
57,NIZAMI MAHAMMAD ASLAM MAHAMMAD,GEN,GANDHINAGAR,1091,4,SP,0,M,GUJARAT,845576,845212,364,2126829,1101787,1025042,0.05129702481957882,1091,0.12902447562371686
39,PATEL DIPAKKUMAR GOPALDAS (CAPTAIN),GEN,GANDHINAGAR,975,5,ABJS,0,M,GUJARAT,845576,845212,364,2126829,1101787,1025042,0.045842895691190974,975,0.1153060162540091
32,ARUNBHAI SWARUPJI MARU,GEN,GANDHINAGAR,793,6,IND,0,M,GUJARAT,845576,845212,364,2126829,1101787,1025042,0.03728555516216865,793,0.09378222655326074
30,PARMAR JIVRAJ MANSUKHBHAI(AMIN,SC,GANDHINAGAR,767,10,IND,0,M,GUJARAT,845576,845212,364,2126829,1101787,1025042,0.03606307794373689,767,0.09070739945315383
28,IMRAN GULAMNABI AJMERI (NAIK,GEN,GANDHINAGAR,767,7,IND,0,M,GUJARAT,845576,845212,364,2126829,1101787,1025042,0.03606307794373689,767,0.09070739945315383
35,KHODABHAI LALJIBHAI DESAI,GEN,GANDHINAGAR,695,8,IND,0,M,GUJARAT,845576,845212,364,2126829,1101787,1025042,0.03267775641577202,695,0.08219249363747316
36,DUDHATRA MUKUNDBHAI GOVINDBHAI,GEN,GANDHINAGAR,685,9,IND,0,M,GUJARAT,845576,845212,364,2126829,1101787,1025042,0.03220757287022135,685,0.08100986782973973
70,JIVABHAI AMBALAL PATEL,GEN,MEHSANA,339619,1,INC,24,M,GUJARAT,695407,695357,50,1236066,619862,616204,27.477739861787313,339643,48.8408946127951
48,NITINBHAI RATILAL PATEL,GEN,MEHSANA,325106,3,BJP,26,M,GUJARAT,695407,695357,50,1236066,619862,616204,26.303773423102,325132,46.754202934396695
51,THAKOR LAXMANJI SHIVAJI,GEN,MEHSANA,20410,4,IND,0,M,GUJARAT,695407,695357,50,1236066,619862,616204,1.651206327170232,20410,2.9349718941569467
44,THAKOR MANSANGJI PUNJAJI,GEN,MEHSANA,10222,2,BSP,0,M,GUJARAT,695407,695357,50,1236066,619862,616204,0.8269784946758507,10222,1.4699305586512648
67,KANODIA MAHESHKUMAR MITHABHAI,SC,PATAN (SC),273899,1,BJP,71,M,GUJARAT,538157,538059,98,1132998,565308,567690,24.180978254154024,273970,50.90893549651867
64,RASTRAPAL PRAVIN SOMABHAI,SC,PATAN (SC),250320,3,INC,26,M,GUJARAT,538157,538059,98,1132998,565308,567690,22.095890725314607,250346,46.51913846702728
65,KARBATIYA ISHWARBHAI LALLUBHAI,SC,PATAN (SC),13840,2,BSP,1,M,GUJARAT,538157,538059,98,1132998,565308,567690,1.2216261635060255,13841,2.571926036454046
73,CHAVDA HARISINHAJI PRATAPSINHAJI,GEN,BANASKANTHA,301116,1,INC,32,M,GUJARAT,642355,642238,117,1311847,671444,640403,22.95603069565277,301148,46.88186438962879
49,CHAUDHARY HARIBHAI PARATHIBHAI,GEN,BANASKANTHA,294135,2,BJP,85,M,GUJARAT,642355,642238,117,1311847,671444,640403,22.427920329123747,294220,45.803333047925214
35,SHRIMALI ASHOKBHAI BALCHANDBHAI,SC,BANASKANTHA,23972,6,IND,0,M,GUJARAT,642355,642238,117,1311847,671444,640403,1.827347244000253,23972,3.731892800709888
65,MAJIRANA BHOPAJI ASHAJI,ST,BANASKANTHA,9270,5,IND,0,M,GUJARAT,642355,642238,117,1311847,671444,640403,0.706637283158783,9270,1.443127242724039
65,BABULAL GANDALAL VIDAJA,SC,BANASKANTHA,8258,3,BSP,0,M,GUJARAT,642355,642238,117,1311847,671444,640403,0.6294941407039083,8258,1.2855819601310803
34,YADAV SURESH MAHAVIRBHAI,GEN,BANASKANTHA,5487,4,SP,0,M,GUJARAT,642355,642238,117,1311847,671444,640403,0.4182652397726259,5487,0.8542005588809927
59,MADHUSUDAN MISTRY,GEN,SABARKANTHA,316445,3,INC,38,M,GUJARAT,654471,654380,91,1272262,639446,632816,24.875615242772323,316483,48.3570700611639
50,BARA RAMILABEN BAHECHARBHAI,ST,SABARKANTHA,276502,2,BJP,53,F,GUJARAT,654471,654380,91,1272262,639446,632816,21.737267952670123,276555,42.256264983475205
41,BAGA RASHIDAHMAD ISMAILBHAI,GEN,SABARKANTHA,23341,1,BSP,0,M,GUJARAT,654471,654380,91,1272262,639446,632816,1.8346063939660227,23341,3.566391788177016
39,PATHAN AYUBKHAN AZABKHAN,GEN,SABARKANTHA,21961,5,IND,0,M,GUJARAT,654471,654380,91,1272262,639446,632816,1.7261381696537348,21961,3.3555344698237204
46,RATHOD SABIRMIYA AMIRMIYA,GEN,SABARKANTHA,16131,4,LSWP,0,M,GUJARAT,654471,654380,91,1272262,639446,632816,1.2678992220155911,16131,2.464738697360158
64,VAGHELA SHANKERSINH LAXMANSINH,GEN,KAPADVANJ,320330,2,INC,8,M,GUJARAT,595314,595296,18,1265350,647112,618238,25.316157584857947,320338,53.80992215872632
69,VAGHELA LILADHARBHAI KHODAJI,GEN,KAPADVANJ,240893,1,BJP,10,M,GUJARAT,595314,595296,18,1265350,647112,618238,19.038447860275813,240903,40.46654370634657
44,JADAV RASHMIKABEN CHANDRAKANT,GEN,KAPADVANJ,20018,4,IND,0,F,GUJARAT,595314,595296,18,1265350,647112,618238,1.5820128818113566,20018,3.362595201859859
40,VYAS BHUPENDRA MANUBHAI,GEN,KAPADVANJ,14055,3,IND,0,M,GUJARAT,595314,595296,18,1265350,647112,618238,1.110759868811001,14055,2.3609389330672554
40,KATARA BABUBHAI KHIMABHAI,ST,DOHAD (ST),228133,1,BJP,21,M,GUJARAT,517845,517810,35,1212453,612602,599851,18.817554164986188,228154,44.0583572304454
52,TAVIYAD DR PRABHABAHEN KISHORSINH,ST,DOHAD (ST),227783,3,INC,10,F,GUJARAT,517845,517810,35,1212453,612602,599851,18.787779814970147,227793,43.98864525099209
62,SOMJIBHAI DAMOR,ST,DOHAD (ST),45594,4,BNP,3,M,GUJARAT,517845,517810,35,1212453,612602,599851,3.7607230960705276,45597,8.805144396489297
57,KATARA SIGJIBHAI JALJIBHAI,ST,DOHAD (ST),16300,2,CPM,1,M,GUJARAT,517845,517810,35,1212453,612602,599851,1.344464486458444,16301,3.1478531220732076
50,SOLANKI BHUPENDRASINH PRABHATSINH,GEN,GODHRA,295440,2,BJP,110,M,GUJARAT,537381,536812,569,1143516,590826,552690,25.845724939572335,295550,54.998222862363946
48,PATEL RAJENDRASINH BALVANTSINH,GEN,GODHRA,241372,1,INC,459,M,GUJARAT,537381,536812,569,1143516,590826,552690,21.148020666086,241831,45.001777137636054
67,DINSHA PATEL,GEN,KAIRA,243957,2,INC,80,M,GUJARAT,450929,450808,121,1146245,587059,559186,21.290125583972014,244037,54.11871935493171
57,GAEKWAD SHUBHANGINIRAJE RANJITSINH,GEN,KAIRA,187249,1,BJP,39,F,GUJARAT,450929,450808,121,1146245,587059,559186,16.33926429341022,187288,41.533811309540965
69,DESAI NALINKUMAR MANMOHANDAS,GEN,KAIRA,11459,4,BRP,0,M,GUJARAT,450929,450808,121,1146245,587059,559186,0.9996990172258113,11459,2.5411982817694136
50,DABHI DILIPSINH AMBALAL,GEN,KAIRA,8143,3,SP,2,M,GUJARAT,450929,450808,121,1146245,587059,559186,0.710581071236952,8145,1.8062710537579088
50,SOLANKI BHARATSINH MADHAVSINH,GEN,ANAND,307696,3,INC,66,M,GUJARAT,591240,591123,117,1145550,591736,553814,26.865872288420412,307762,52.05364995602463
48,JAYPRAKASH VAGHAJIBHAI PATEL,GEN,ANAND,246630,1,BJP,47,M,GUJARAT,591240,591123,117,1145550,591736,553814,21.533499192527607,246677,41.72197415601109
29,SOLANKI BHARATBHAI RAVABHAI,GEN,ANAND,15339,7,IND,1,M,GUJARAT,591240,591123,117,1145550,591736,553814,1.3390947579765178,15340,2.594547053649956
36,VIJAY DANIAL MACWAN (ADVOCATE),GEN,ANAND,6684,2,BSP,2,M,GUJARAT,591240,591123,117,1145550,591736,553814,0.5836497752171446,6686,1.1308436506325688
43,JAYANTBHAI RAMANBHAI PATEL (BOSKEY),GEN,ANAND,6040,4,IND,1,M,GUJARAT,591240,591123,117,1145550,591736,553814,0.5273449434769325,6041,1.0217508964210813
33,PATEL NILESHKUMAR PRAVINBHAI,GEN,ANAND,5404,5,IND,0,M,GUJARAT,591240,591123,117,1145550,591736,553814,0.47173846623892457,5404,0.9140112306339219
59,PUROHIT LALJIBHAI GANESHJI,GEN,ANAND,3330,6,IND,0,M,GUJARAT,591240,591123,117,1145550,591736,553814,0.2906900615424905,3330,0.5632230566267505
51,NARANBHAI RATHWA,ST,CHHOTA UDAIPUR (ST),246843,2,INC,12,M,GUJARAT,556516,556493,23,1065416,546611,518805,23.16982286731192,246855,44.35721524628223
52,RAMSINH RATHWA,ST,CHHOTA UDAIPUR (ST),210607,3,BJP,9,M,GUJARAT,556516,556493,23,1065416,546611,518805,19.76842848239561,210616,37.845452781231806
36,TADVI DINESHBHAI BALUBHAI,ST,CHHOTA UDAIPUR (ST),32632,4,BNP,2,M,GUJARAT,556516,556493,23,1065416,546611,518805,3.0630289013868763,32634,5.863982347317957
58,RATHWA RAYSINGBHAI BHANGDABHAI,ST,CHHOTA UDAIPUR (ST),23113,7,IND,0,M,GUJARAT,556516,556493,23,1065416,546611,518805,2.1693873566757023,23113,4.1531600169626754
55,KANUBHAI TADVI,ST,CHHOTA UDAIPUR (ST),22728,1,BSP,0,M,GUJARAT,556516,556493,23,1065416,546611,518805,2.133251237075471,22728,4.08397961603979
37,NARANBHAI RATHWA,ST,CHHOTA UDAIPUR (ST),12186,6,IND,0,M,GUJARAT,556516,556493,23,1065416,546611,518805,1.143778580385502,12186,2.1896944562240797
38,TADVI RAMDAS KANTIBHAI,ST,CHHOTA UDAIPUR (ST),8384,5,SP,0,M,GUJARAT,556516,556493,23,1065416,546611,518805,0.7869226668268545,8384,1.5065155359414644
52,JAYABEN THAKKAR,GEN,BARODA,315971,3,BJP,118,F,GUJARAT,652409,651977,432,1656867,851734,805133,19.077511954791785,316089,48.44951556462281
42,GAEKWAD SATYAJITSINH DULEEPSINH,GEN,BARODA,309177,2,INC,309,M,GUJARAT,652409,651977,432,1656867,851734,805133,18.678988717863295,309486,47.43742039119632
28,KALODIA SHARDABEN SURENDRASINH,GEN,BARODA,8765,1,BSP,1,F,GUJARAT,652409,651977,432,1656867,851734,805133,0.5290708306701745,8766,1.3436356641309364
53,PREM JAYPRAKASH BIHARILAL,GEN,BARODA,7957,6,IND,2,M,GUJARAT,652409,651977,432,1656867,851734,805133,0.48036444687473406,7959,1.2199402522037555
39,TAPANBHAI DASGUPTA,GEN,BARODA,5234,5,IND,0,M,GUJARAT,652409,651977,432,1656867,851734,805133,0.31589741361255913,5234,0.8022574795871915
60,DR HASHMUKH SHIVABHAI PATEL,GEN,BARODA,4873,4,ABHM,2,M,GUJARAT,652409,651977,432,1656867,851734,805133,0.2942300136341662,4875,0.7472306482589909
47,VASAVA MANSUKHBHAI DHANJIBHAI,ST,BROACH,299389,2,BJP,241,M,GUJARAT,680795,680519,276,1239670,635322,604348,24.17014205393371,299630,44.011780345037785
66,PATEL MUHAMMAD FANSIWALA,GEN,BROACH,227403,1,INC,25,M,GUJARAT,680795,680519,276,1239670,635322,604348,18.34585010526995,227428,33.406238294934596
55,VASAVA CHHOTUBHAI AMARSINH,ST,BROACH,111592,4,JD(U),8,M,GUJARAT,680795,680519,276,1239670,635322,604348,9.002395798881961,111600,16.3925998281421
32,VASAVA SURESHBHAI GORDHANBHAI,ST,BROACH,22365,6,IND,0,M,GUJARAT,680795,680519,276,1239670,635322,604348,1.804109158082393,22365,3.2851298849139607
31,PATEL JINESHBHAI RAMANBHAI,ST,BROACH,9984,5,IND,2,M,GUJARAT,680795,680519,276,1239670,635322,604348,0.8055369574160867,9986,1.4668145330092026
31,SAIYAD FAIMUDDIN HAMIDUDDIN,GEN,BROACH,9786,3,BSP,0,M,GUJARAT,680795,680519,276,1239670,635322,604348,0.7894036316116386,9786,1.4374371139623527
65,KASHIRAM RANA,GEN,SURAT,508052,1,BJP,24,M,GUJARAT,896276,896233,43,2377198,1302228,1074970,21.3728936335972,508076,56.687448955455686
46,CHANDRAVADAN CHHOTUBHAI PITHAWALA,GEN,SURAT,357495,2,INC,18,M,GUJARAT,896276,896233,43,2377198,1302228,1074970,15.039260507538707,357513,39.88871731475572
57,SANDIS MAVJIBHAI LAXMANBHAI,SC,SURAT,14026,6,IND,0,M,GUJARAT,896276,896233,43,2377198,1302228,1074970,0.590022370875291,14026,1.5649197345460548
47,PATEL ARJUNBHAI BHIKHABHAI,GEN,SURAT,7959,3,BSP,0,M,GUJARAT,896276,896233,43,2377198,1302228,1074970,0.33480593539116216,7959,0.8880077119101706
45,NAGMAL PRABHAKAR SOMABHAI,GEN,SURAT,5705,5,IND,0,M,GUJARAT,896276,896233,43,2377198,1302228,1074970,0.23998842334546805,5705,0.6365226782821363
47,GOVINDBHAI LAXMANBHAI RATHOD,SC,SURAT,2996,4,IND,1,M,GUJARAT,896276,896233,43,2377198,1302228,1074970,0.1260727966286359,2997,0.33438360505023007
36,CHAUDHARY TUSHARBHAI AMARSINHBHAI,ST,MANDVI (ST),386536,1,INC,56,M,GUJARAT,644812,644719,93,1149161,572013,577148,33.641239130113185,386592,59.95421921428261
53,MANSINH PATEL,ST,MANDVI (ST),213178,2,BJP,32,M,GUJARAT,644812,644719,93,1149161,572013,577148,18.553536014535823,213210,33.06545163551547
42,DR JYOTISHKUMAR ASHOKBHAI PATEL,ST,MANDVI (ST),25055,6,IND,1,M,GUJARAT,644812,644719,93,1149161,572013,577148,2.180373333240512,25056,3.8857837633294667
42,VASAVA HEMANTBHAI FATIYABHAI,ST,MANDVI (ST),9016,5,JD(U),0,M,GUJARAT,644812,644719,93,1149161,572013,577148,0.7845723967311804,9016,1.3982370055147857
58,DR MOHAN GAMIT,ST,MANDVI (ST),6742,3,BSP,2,M,GUJARAT,644812,644719,93,1149161,572013,577148,0.5868629373951952,6744,1.0458862428118583
56,CHAUDHARY MADANBHAI UDESINGBHAI,ST,MANDVI (ST),4192,4,SP,2,M,GUJARAT,644812,644719,93,1149161,572013,577148,0.36496191569327535,4194,0.6504221385458087
39,KISHANBHAI VESTABHAI PATEL,ST,BULSAR (ST),321761,1,INC,8,M,GUJARAT,689982,689966,16,1319778,669122,650656,24.380539757444055,321769,46.63440495549159
57,CHAUDHARI MANIBHAI RAMJIBHAI,ST,BULSAR (ST),277275,2,BJP,8,M,GUJARAT,689982,689966,16,1319778,669122,650656,21.009821348741987,277283,40.18699038525643
39,DELKAR NARESHBHAI SANJIBHAI,ST,BULSAR (ST),58184,4,BNP,0,M,GUJARAT,689982,689966,16,1319778,669122,650656,4.408620237646028,58184,8.432683751170321
30,PATEL DAKSHESBHAI HIRABHAI,ST,BULSAR (ST),22103,5,SP,0,M,GUJARAT,689982,689966,16,1319778,669122,650656,1.6747513596983736,22103,3.203416900730743
36,PATEL SHANKARBHAI CHHAGANBHAI,ST,BULSAR (ST),10643,3,BSP,0,M,GUJARAT,689982,689966,16,1319778,669122,650656,0.8064235045591001,10643,1.5425040073509164
41,SELJA,SC,AMBALA (SC),415247,4,INC,17,F,HARYANA,847725,847673,52,1199338,645266,554072,34.62443447968796,415264,48.985697012592524
52,RATTAN LAL KATARIA,SC,AMBALA (SC),180301,3,BJP,28,M,HARYANA,847725,847673,52,1199338,645266,554072,15.035711367437704,180329,21.272110649090212
54,BALWANT SINGH,SC,AMBALA (SC),130967,2,INLD,5,M,HARYANA,847725,847673,52,1199338,645266,554072,10.920357730681426,130972,15.449821581291104
56,CHANDER PAL,SC,AMBALA (SC),57028,1,BSP,0,M,HARYANA,847725,847673,52,1199338,645266,554072,4.754956484327187,57028,6.727181574213335
49,AMAN KUMAR NAGRA,SC,AMBALA (SC),22038,5,HVP,1,M,HARYANA,847725,847673,52,1199338,645266,554072,1.8375970743860364,22039,2.599781768851927
36,RANBIR SINGH,SC,AMBALA (SC),13291,7,ES,1,M,HARYANA,847725,847673,52,1199338,645266,554072,1.1082780667334813,13292,1.5679613082072608
30,SUNIL KUMAR,SC,AMBALA (SC),9574,13,IND,0,M,HARYANA,847725,847673,52,1199338,645266,554072,0.7982737143324067,9574,1.1293756819723377
68,RAUNAQ SINGH,SC,AMBALA (SC),7324,12,IND,0,M,HARYANA,847725,847673,52,1199338,645266,554072,0.6106702197378887,7324,0.8639594208027367
45,JASWINDER SINGH,SC,AMBALA (SC),3477,10,IND,0,M,HARYANA,847725,847673,52,1199338,645266,554072,0.28990993364672846,3477,0.41015659559409007
41,HEM RAJ,SC,AMBALA (SC),2262,9,LJNSP,0,M,HARYANA,847725,847673,52,1199338,645266,554072,0.18860404656568874,2262,0.26683181456250554
31,ARVIND KUMAR SONKAR,SC,AMBALA (SC),2224,6,ABHM,0,M,HARYANA,847725,847673,52,1199338,645266,554072,0.18543563199031465,2224,0.26234922881830786
52,RAM SARUP,SC,AMBALA (SC),2098,11,IND,0,M,HARYANA,847725,847673,52,1199338,645266,554072,0.17492983629302164,2098,0.24748591819281018
29,SANJEEV GHARU,SC,AMBALA (SC),1842,8,SAP,0,M,HARYANA,847725,847673,52,1199338,645266,554072,0.15358472757471206,1842,0.2172874458108467
34,NAVEEN JINDAL,GEN,KURUKSHETRA,362007,3,INC,47,M,HARYANA,850858,850680,178,1161933,629227,532706,31.15962796477938,362054,42.55163611319397
41,ABHAY SINGH CHAUTALA,GEN,KURUKSHETRA,201769,1,INLD,95,M,HARYANA,850858,850680,178,1161933,629227,532706,17.373118759859647,201864,23.724757832681835
57,GURDAYAL SINGH SAINI,GEN,KURUKSHETRA,126883,2,BJP,27,M,HARYANA,850858,850680,178,1161933,629227,532706,10.922316519110826,126910,14.915532321491954
51,JATINDER SINGH ( KAKKA),GEN,KURUKSHETRA,77134,6,HVP,2,M,HARYANA,850858,850680,178,1161933,629227,532706,6.638592758790739,77136,9.065672532902083
59,SARDAR JAGMEET SINGH SAINI,GEN,KURUKSHETRA,31199,5,ES,3,M,HARYANA,850858,850680,178,1161933,629227,532706,2.685352769910141,31202,3.6671218934299263
41,MONA RAM,GEN,KURUKSHETRA,23054,4,BSP,3,M,HARYANA,850858,850680,178,1161933,629227,532706,1.984365707833412,23057,2.7098528779185242
43,RAGHUBIR CHAND,SC,KURUKSHETRA,8667,13,IND,0,M,HARYANA,850858,850680,178,1161933,629227,532706,0.7459121997567846,8667,1.0186188529695908
44,SUNIL GUPTA,GEN,KURUKSHETRA,7381,15,IND,0,M,HARYANA,850858,850680,178,1161933,629227,532706,0.635234561717414,7381,0.8674772993848562
70,ROOP CHAND,GEN,KURUKSHETRA,3470,14,IND,0,M,HARYANA,850858,850680,178,1161933,629227,532706,0.2986402830455801,3470,0.4078236321454344
35,VISHAL JOLLY,GEN,KURUKSHETRA,2310,7,SP,0,M,HARYANA,850858,850680,178,1161933,629227,532706,0.19880664375656773,2310,0.2714906600161249
39,BHUPENDER SINGH,GEN,KURUKSHETRA,2169,12,IND,0,M,HARYANA,850858,850680,178,1161933,629227,532706,0.18667169277402396,2169,0.2549191521969588
38,JAGIR SINGH,GEN,KURUKSHETRA,1623,10,IND,0,M,HARYANA,850858,850680,178,1161933,629227,532706,0.1396810315224716,1623,0.19074863255678387
40,JAI SINGH,GEN,KURUKSHETRA,1345,11,IND,1,M,HARYANA,850858,850680,178,1161933,629227,532706,0.11584144696811262,1346,0.15819325903969875
50,JAGMOHAN,GEN,KURUKSHETRA,964,9,IND,0,M,HARYANA,850858,850680,178,1161933,629227,532706,0.0829651967884551,964,0.11329740097642615
47,ATAM PRAKASH,GEN,KURUKSHETRA,705,8,IND,0,M,HARYANA,850858,850680,178,1161933,629227,532706,0.060674754912718724,705,0.08285753909583032
42,ARVIND KUMAR SHARMA,GEN,KARNAL,318859,1,INC,89,M,HARYANA,818927,818630,297,1240344,671727,568617,25.714479208993634,318948,38.94706121546853
74,I D SWAMI,GEN,KARNAL,154123,4,BJP,63,M,HARYANA,818927,818630,297,1240344,671727,568617,12.430906264713661,154186,18.827807606783022
44,ASHOK KUMAR ARORA,GEN,KARNAL,113412,2,INLD,98,M,HARYANA,818927,818630,297,1240344,671727,568617,9.15149345665396,113510,13.86082031731766
35,RAJ KUMAR,GEN,KARNAL,82404,9,ES,26,M,HARYANA,818927,818630,297,1240344,671727,568617,6.645736989093348,82430,10.06561024364809
37,ASHOK KUMAR KASHYAP,GEN,KARNAL,67385,3,BSP,7,M,HARYANA,818927,818630,297,1240344,671727,568617,5.433331398386255,67392,8.229304931941432
47,KULDIP SHARMA,GEN,KARNAL,27214,14,IND,9,M,HARYANA,818927,818630,297,1240344,671727,568617,2.194794347374599,27223,3.3242279226353513
53,RAM CHANDER JANGRA,GEN,KARNAL,21368,10,HVP,3,M,HARYANA,818927,818630,297,1240344,671727,568617,1.7229897512303038,21371,2.609634314169639
41,NARESH SACHDEVA,GEN,KARNAL,6282,16,IND,0,M,HARYANA,818927,818630,297,1240344,671727,568617,0.5064723979799153,6282,0.7671013411451815
47,MAHINDER SINGH RANA,SC,KARNAL,4807,17,IND,0,M,HARYANA,818927,818630,297,1240344,671727,568617,0.3875537754042427,4807,0.5869876069539776
36,RAGHUMAL BHATT,SC,KARNAL,3696,8,SP,0,M,HARYANA,818927,818630,297,1240344,671727,568617,0.2979818501963971,3696,0.45132227903097594
46,RAM MEHAR SINGH,GEN,KARNAL,2489,20,IND,1,M,HARYANA,818927,818630,297,1240344,671727,568617,0.20075075946672857,2490,0.3040564055159984
48,MAHINDER SINGH,GEN,KARNAL,2487,7,CPI(ML)(L),0,M,HARYANA,818927,818630,297,1240344,671727,568617,0.20050889108182893,2487,0.3036900724973044
47,RISHI RAM GUPTA,GEN,KARNAL,2364,13,IND,0,M,HARYANA,818927,818630,297,1240344,671727,568617,0.19059228730094233,2364,0.2886704187308515
56,RAJBIR SINGH CHAUHAN,GEN,KARNAL,2088,19,IND,0,M,HARYANA,818927,818630,297,1240344,671727,568617,0.1683403958901724,2088,0.25496778101100587
30,ANGREJ SINGH JOON,GEN,KARNAL,1977,5,RGD,0,M,HARYANA,818927,818630,297,1240344,671727,568617,0.1593912656488845,1977,0.24141345931932884
66,DULI CHAND MALIK,GEN,KARNAL,1888,15,IND,0,M,HARYANA,818927,818630,297,1240344,671727,568617,0.15221583689686088,1888,0.2305455797647409
34,SURINDER SINGH HOODA,GEN,KARNAL,1729,12,LJNSP,0,M,HARYANA,818927,818630,297,1240344,671727,568617,0.1393968124971782,1729,0.2111299297739603
41,RAJ KUMAR KASHYAP,GEN,KARNAL,1707,18,IND,0,M,HARYANA,818927,818630,297,1240344,671727,568617,0.13762311100791394,1707,0.20844348763687115
53,ROSHAN LAL BINDAL,GEN,KARNAL,1314,11,SHS,1,M,HARYANA,818927,818630,297,1240344,671727,568617,0.10601897538102333,1315,0.16057597319419192
35,PREMO ALIAS PREMVATI KASHYAP,GEN,KARNAL,1037,6,FCI,0,F,HARYANA,818927,818630,297,1240344,671727,568617,0.08360583838032029,1037,0.12662911346188366
54,KISHAN SINGH SANGWAN,GEN,SONEPAT,233399,1,BJP,78,M,HARYANA,737119,736518,601,1138771,627795,510976,20.50254177529986,233477,31.674261550712977
60,DHARAM PAL SINGH MALIK,GEN,SONEPAT,225877,3,INC,31,M,HARYANA,737119,736518,601,1138771,627795,510976,19.83787785252698,225908,30.64742599227533
51,KRISHNA MALIK,GEN,SONEPAT,198382,2,INLD,484,F,HARYANA,737119,736518,601,1138771,627795,510976,17.463212533512003,198866,26.978818888130686
50,SUGAN GUPTA,GEN,SONEPAT,37184,4,BSP,1,M,HARYANA,737119,736518,601,1138771,627795,510976,3.2653623950732853,37185,5.044640010636003
50,JAGBIR SINGH MALIK,GEN,SONEPAT,21122,11,IND,4,M,HARYANA,737119,736518,601,1138771,627795,510976,1.8551578851235235,21126,2.86602298950373
35,SHAMSHER,GEN,SONEPAT,2926,16,IND,0,M,HARYANA,737119,736518,601,1138771,627795,510976,0.25694366997403345,2926,0.39695083154823035
39,SANT RAM,SC,SONEPAT,2889,17,IND,0,M,HARYANA,737119,736518,601,1138771,627795,510976,0.25369455316301526,2889,0.39193128924909
26,SITYENDER,GEN,SONEPAT,2055,19,IND,0,M,HARYANA,737119,736518,601,1138771,627795,510976,0.18045770396330782,2055,0.27878809256035997
35,BASANT,GEN,SONEPAT,1786,14,IND,1,M,HARYANA,737119,736518,601,1138771,627795,510976,0.15692356057539225,1787,0.24243032671793838
46,SATBIR,GEN,SONEPAT,1662,18,IND,0,M,HARYANA,737119,736518,601,1138771,627795,510976,0.14594681459222267,1662,0.2254724135451671
50,HARI PARKASH,GEN,SONEPAT,1640,20,IND,0,M,HARYANA,737119,736518,601,1138771,627795,510976,0.1440149072991848,1640,0.22248782082675933
41,KIRPAL SINGH,GEN,SONEPAT,1346,5,JD(S),0,M,HARYANA,737119,736518,601,1138771,627795,510976,0.11819760074676998,1346,0.18260280904440124
52,BRAHAM SINGH,GEN,SONEPAT,1184,15,IND,0,M,HARYANA,737119,736518,601,1138771,627795,510976,0.10397173795258222,1184,0.16062535357248964
48,BALBIR SINGH,SC,SONEPAT,999,6,RSBP,0,M,HARYANA,737119,736518,601,1138771,627795,510976,0.08772615389749124,999,0.13552764207678814
63,JAGDISH RAI AGGARWAL,GEN,SONEPAT,949,10,IND,0,M,HARYANA,737119,736518,601,1138771,627795,510976,0.08333545550422342,949,0.12874447680767961
30,KRISHAN,GEN,SONEPAT,747,9,IND,0,M,HARYANA,737119,736518,601,1138771,627795,510976,0.06559703399542138,747,0.10134048912048123
56,SUBE SINGH,GEN,SONEPAT,671,8,JCP,0,M,HARYANA,737119,736518,601,1138771,627795,510976,0.05892317243765428,671,0.09103007791143629
28,NAVEEN KUMAR,GEN,SONEPAT,597,13,IND,0,M,HARYANA,737119,736518,601,1138771,627795,510976,0.05242493881561789,597,0.08099099331315568
35,JAI KISHAN,GEN,SONEPAT,572,12,IND,2,M,HARYANA,737119,736518,601,1138771,627795,510976,0.050405217554714686,574,0.07787073728936576
43,SATYA PAL,GEN,SONEPAT,531,7,LJNSP,0,M,HARYANA,737119,736518,601,1138771,627795,510976,0.046629216936504354,531,0.07203721515793243
54,BHUPINDER SINGH,GEN,ROHTAK,324117,4,INC,118,M,HARYANA,662049,661651,398,1055610,573080,482530,30.7154157311886,324235,48.97447167807821
36,ABHIMANYU,GEN,ROHTAK,173630,1,BJP,170,M,HARYANA,662049,661651,398,1055610,573080,482530,16.464413940754635,173800,26.251833323515328
62,BHIM SINGH,GEN,ROHTAK,105556,3,INLD,84,M,HARYANA,662049,661651,398,1055610,573080,482530,10.007483824518525,105640,15.95652285555903
28,GEETA,GEN,ROHTAK,24220,2,BSP,8,F,HARYANA,662049,661651,398,1055610,573080,482530,2.2951658282888565,24228,3.6595478582401
56,USHA,GEN,ROHTAK,10318,7,HVP,16,F,HARYANA,662049,661651,398,1055610,573080,482530,0.9789600325877927,10334,1.5609116545754167
34,AJAY SINGH,GEN,ROHTAK,2637,5,AIFB,0,M,HARYANA,662049,661651,398,1055610,573080,482530,0.24980816778924034,2637,0.3983088865023586
59,JAIPAL,GEN,ROHTAK,2575,16,IND,0,M,HARYANA,662049,661651,398,1055610,573080,482530,0.2439347865215373,2575,0.38894402075979273
49,RADHE SHYAM,GEN,ROHTAK,2095,20,IND,0,M,HARYANA,662049,661651,398,1055610,573080,482530,0.19846344767480414,2095,0.31644183436573425
65,NAFE,GEN,ROHTAK,2033,17,IND,0,M,HARYANA,662049,661651,398,1055610,573080,482530,0.1925900664071011,2033,0.30707696862316836
59,ANOOP SINGH MATANHAIL,GEN,ROHTAK,1984,13,IND,0,M,HARYANA,662049,661651,398,1055610,573080,482530,0.18794820056649708,1984,0.2996757037621083
58,RANVIR SINGH,GEN,ROHTAK,1956,19,IND,0,M,HARYANA,662049,661651,398,1055610,573080,482530,0.18529570580043767,1956,0.2954464095557882
39,BHARPUR,GEN,ROHTAK,1849,10,RLD,0,M,HARYANA,662049,661651,398,1055610,573080,482530,0.1751593865158534,1849,0.2792844638387793
50,SHISHPAL,GEN,ROHTAK,1291,11,SAP,0,M,HARYANA,662049,661651,398,1055610,573080,482530,0.12229895510652608,1291,0.19500067215568634
56,RAMPHAL,GEN,ROHTAK,975,21,IND,1,M,HARYANA,662049,661651,398,1055610,573080,482530,0.09245838898835745,976,0.1474211123345855
58,KARAN SINGH,GEN,ROHTAK,959,14,IND,0,M,HARYANA,662049,661651,398,1055610,573080,482530,0.09084794573753564,959,0.1448533265664626
33,AJAY KUMAR,GEN,ROHTAK,949,12,IND,0,M,HARYANA,662049,661651,398,1055610,573080,482530,0.0899006261782287,949,0.14334286434991972
83,HARI SINGH,GEN,ROHTAK,938,24,IND,0,M,HARYANA,662049,661651,398,1055610,573080,482530,0.08885857466299107,938,0.14168135591172254
34,KULDEEP SINGH,GEN,ROHTAK,857,15,IND,0,M,HARYANA,662049,661651,398,1055610,573080,482530,0.08118528623260485,857,0.1294466119577252
28,BIMLA,GEN,ROHTAK,584,9,BRPP,1,F,HARYANA,662049,661651,398,1055610,573080,482530,0.05541819421945605,585,0.08836203966775873
38,SATENDER,GEN,ROHTAK,466,23,IND,0,M,HARYANA,662049,661651,398,1055610,573080,482530,0.044145091463703455,466,0.0703875392908984
49,ANOOP SINGH,SC,ROHTAK,460,6,RVP,0,M,HARYANA,662049,661651,398,1055610,573080,482530,0.04357669972811929,460,0.06948126196097268
51,MUKHTIAR SINGH,GEN,ROHTAK,419,18,IND,0,M,HARYANA,662049,661651,398,1055610,573080,482530,0.03969268953496083,419,0.06328836687314685
55,SAJJAN SINGH,GEN,ROHTAK,404,22,IND,0,M,HARYANA,662049,661651,398,1055610,573080,482530,0.03827171019600042,404,0.061022673548332525
40,JAIMAL,GEN,ROHTAK,379,8,RSKP,0,M,HARYANA,662049,661651,398,1055610,573080,482530,0.035903411297733064,379,0.05724651800697531
48,AVTAR SINGH BHADANA,GEN,FARIDABAD,357268,2,INC,16,M,HARYANA,844718,844661,57,1546578,842158,704420,23.10158297867938,357284,42.29624561096129
49,MOHD ILYAS,GEN,FARIDABAD,205354,3,INLD,1,M,HARYANA,844718,844661,57,1546578,842158,704420,13.278024128107344,205355,24.31047994715396
53,RAMCHANDER BAINDA,GEN,FARIDABAD,171679,4,BJP,35,M,HARYANA,844718,844661,57,1546578,842158,704420,11.10283477457975,171714,20.327967440021403
45,HAJI ABDUL MALIK,GEN,FARIDABAD,71459,1,BSP,0,M,HARYANA,844718,844661,57,1546578,842158,704420,4.620458845270009,71459,8.459509564138564
36,DEVENDER BHADANA,GEN,FARIDABAD,13041,6,HVP,1,M,HARYANA,844718,844661,57,1546578,842158,704420,0.8432811018907549,13042,1.5439472107851377
46,DR K P SINGH,SC,FARIDABAD,4956,14,IND,0,M,HARYANA,844718,844661,57,1546578,842158,704420,0.32044940507365294,4956,0.586704675406467
46,CHAUDHARY AKHTAR,GEN,FARIDABAD,4406,5,SP,1,M,HARYANA,844718,844661,57,1546578,842158,704420,0.2849516804196103,4407,0.5217125715327482
36,SUBHASH BAGHEL,GEN,FARIDABAD,4172,9,LP(S),0,M,HARYANA,844718,844661,57,1546578,842158,704420,0.2697568438190638,4172,0.4938926363591163
37,LOKENDRA SINGH,GEN,FARIDABAD,3918,8,SHS,2,M,HARYANA,844718,844661,57,1546578,842158,704420,0.2534628062729458,3920,0.46406019523675357
33,CHANDER BHAN SHARMA,GEN,FARIDABAD,3769,12,IND,0,M,HARYANA,844718,844661,57,1546578,842158,704420,0.2436993155211053,3769,0.4461844071039093
48,BALDEV SINGH,GEN,FARIDABAD,2063,13,IND,0,M,HARYANA,844718,844661,57,1546578,842158,704420,0.13339126768905288,2063,0.24422351601362824
40,RAM NIWAS RATHI,GEN,FARIDABAD,1096,7,LJNSP,1,M,HARYANA,844718,844661,57,1546578,842158,704420,0.07093079042893408,1097,0.1298658250445711
37,KAMAL GODARA,GEN,FARIDABAD,856,11,IND,0,M,HARYANA,844718,844661,57,1546578,842158,704420,0.05534800055348,856,0.10133559365374006
35,AKHTAR HUSAIN,GEN,FARIDABAD,624,10,IND,0,M,HARYANA,844718,844661,57,1546578,842158,704420,0.04034714059038729,624,0.0738708065887077
54,INDERJIT SINGH,GEN,MAHENDRAGARH,358562,1,INC,152,M,HARYANA,849305,848872,433,1429015,754390,674625,25.102185771318002,358714,42.23618134827889
39,DR SUDHA YADAV,GEN,MAHENDRAGARH,148181,4,BJP,192,F,HARYANA,849305,848872,433,1429015,754390,674625,10.382886113861646,148373,17.46993129676618
48,RAGHU YADAV,GEN,MAHENDRAGARH,121018,7,SP,44,M,HARYANA,849305,848872,433,1429015,754390,674625,8.471709534189634,121062,14.25424317530216
42,SWAMI DHARAM DEV,GEN,MAHENDRAGARH,115131,2,INLD,23,M,HARYANA,849305,848872,433,1429015,754390,674625,8.058277904710586,115154,13.558615573910432
41,ROHTASH,GEN,MAHENDRAGARH,56166,3,BSP,15,M,HARYANA,849305,848872,433,1429015,754390,674625,3.931449284997009,56181,6.614938096443562
45,ANIL RAO,GEN,MAHENDRAGARH,30131,6,HVP,3,M,HARYANA,849305,848872,433,1429015,754390,674625,2.1087252408127277,30134,3.548077545758002
45,SATBIR KUNDU,GEN,MAHENDRAGARH,7206,14,IND,1,M,HARYANA,849305,848872,433,1429015,754390,674625,0.5043334044779096,7207,0.8485761887661089
46,COMRADE RAJENDER SINGH ADVOCATE,GEN,MAHENDRAGARH,3285,13,IND,1,M,HARYANA,849305,848872,433,1429015,754390,674625,0.22994860095940212,3286,0.38690458669147126
28,AJAY KUMAR,GEN,MAHENDRAGARH,2937,5,RVP,2,M,HARYANA,849305,848872,433,1429015,754390,674625,0.20566614066332406,2939,0.346047650726182
41,RAM KISHAN,GEN,MAHENDRAGARH,1683,8,BRPP,0,M,HARYANA,849305,848872,433,1429015,754390,674625,0.11777343134956594,1683,0.19816202659821855
33,NARESH,GEN,MAHENDRAGARH,1495,11,IND,0,M,HARYANA,849305,848872,433,1429015,754390,674625,0.1046175162612009,1495,0.17602628031154885
56,BHAGAT BAL KISHAN SAINI,GEN,MAHENDRAGARH,1439,12,IND,0,M,HARYANA,849305,848872,433,1429015,754390,674625,0.10069873304339003,1439,0.16943265375807276
49,ALAKH MOHAN MATHUR,GEN,MAHENDRAGARH,908,10,IND,0,M,HARYANA,849305,848872,433,1429015,754390,674625,0.0635402707459334,908,0.10691094483136213
49,VED PRAKASH,GEN,MAHENDRAGARH,730,9,NSSP,0,M,HARYANA,849305,848872,433,1429015,754390,674625,0.05108413837503456,730,0.08595263185781316
35,KULDEEP BISHNOI,GEN,BHIWANI,290806,2,INC,130,M,HARYANA,871144,870608,536,1192271,642108,550163,24.40183481775536,290936,33.397004398813515
57,SURENDER SINGH,GEN,BHIWANI,266393,7,HVP,139,M,HARYANA,871144,870608,536,1192271,642108,550163,22.354984730820426,266532,30.595630573131423
43,AJAY SINGH CHAUTALA,GEN,BHIWANI,241821,1,INLD,137,M,HARYANA,871144,870608,536,1192271,642108,550163,20.293876140575424,241958,27.77474217810144
56,RAM BILAS,GEN,BHIWANI,24352,3,BJP,115,M,HARYANA,871144,870608,536,1192271,642108,550163,2.0521341205145474,24467,2.8086056954992515
60,RAMANAND,GEN,BHIWANI,17212,4,BSP,4,M,HARYANA,871144,870608,536,1192271,642108,550163,1.4439670175656374,17216,1.9762519170194595
35,MANGE RAM,GEN,BHIWANI,5637,13,IND,1,M,HARYANA,871144,870608,536,1192271,642108,550163,0.47287906860101436,5638,0.647194952843617
34,SURENDER,GEN,BHIWANI,4855,16,IND,0,M,HARYANA,871144,870608,536,1192271,642108,550163,0.40720607982581136,4855,0.5573131422589147
26,SANJEEV,GEN,BHIWANI,4513,15,IND,0,M,HARYANA,871144,870608,536,1192271,642108,550163,0.3785213261079067,4513,0.518054420394332
33,KULDEEP,GEN,BHIWANI,4448,8,IND,2,M,HARYANA,871144,870608,536,1192271,642108,550163,0.37323729252829263,4450,0.5108225505771721
31,MAHENDER SINGH,GEN,BHIWANI,2975,6,SP,2,M,HARYANA,871144,870608,536,1192271,642108,550163,0.24969155502398366,2977,0.3417345467569082
39,RAJ DEVI JANGRA,GEN,BHIWANI,1949,14,IND,1,F,HARYANA,871144,870608,536,1192271,642108,550163,0.16355342032138667,1950,0.22384358957876083
48,BHAL SINGH,GEN,BHIWANI,1825,11,IND,1,M,HARYANA,871144,870608,536,1192271,642108,550163,0.15315310025992412,1826,0.2096094331132396
38,DEVI LAL,GEN,BHIWANI,1474,10,IND,0,M,HARYANA,871144,870608,536,1192271,642108,550163,0.12362961105319176,1474,0.1692027954046633
34,KAPTAN,GEN,BHIWANI,888,5,LJNSP,3,M,HARYANA,871144,870608,536,1192271,642108,550163,0.07473133205454129,891,0.10227930169983378
31,TAPESH BAGATI,GEN,BHIWANI,845,9,IND,1,M,HARYANA,871144,870608,536,1192271,642108,550163,0.07095702235481699,846,0.09711368040186237
43,MANGAL SINGH,GEN,BHIWANI,615,12,IND,0,M,HARYANA,871144,870608,536,1192271,642108,550163,0.05158223256289887,615,0.07059682440560919
51,JAI PARKASH,GEN,HISSAR,407162,1,INC,48,M,HARYANA,769851,769650,201,1136762,620701,516061,35.82192226693011,407210,52.89465104286414
52,SURENDER SINGH BARWALA,GEN,HISSAR,224326,4,INLD,116,M,HARYANA,769851,769650,201,1136762,620701,516061,19.743974552280953,224442,29.153953167561
51,SWAMI RAGHVANAND,GEN,HISSAR,64689,2,BJP,33,M,HARYANA,769851,769650,201,1136762,620701,516061,5.693540072592152,64722,8.407081370291134
47,SANT RAM PRAKASH,SC,HISSAR,25059,3,BSP,1,M,HARYANA,769851,769650,201,1136762,620701,516061,2.2045071879601887,25060,3.2551753521135907
66,KANWAL SINGH,GEN,HISSAR,19472,5,HVP,3,M,HARYANA,769851,769650,201,1136762,620701,516061,1.7131994208110406,19475,2.5297102945894725
35,SUNIL KUMAR,GEN,HISSAR,9686,16,IND,0,M,HARYANA,769851,769650,201,1136762,620701,516061,0.8520692985866875,9686,1.2581655411241917
46,RAMJI LAL,GEN,HISSAR,4917,13,IND,0,M,HARYANA,769851,769650,201,1136762,620701,516061,0.432544367246618,4917,0.6386950202052086
48,SATPAL,GEN,HISSAR,3115,15,IND,0,M,HARYANA,769851,769650,201,1136762,620701,516061,0.2740239381682357,3115,0.4046237518688682
35,SHAMSHER,GEN,HISSAR,2933,14,IND,0,M,HARYANA,769851,769650,201,1136762,620701,516061,0.2580135507696422,2933,0.38098281355742863
50,RAMNIWAS,GEN,HISSAR,2598,6,SP,0,M,HARYANA,769851,769650,201,1136762,620701,516061,0.2285438816568464,2598,0.3374678996325263
56,RANDHIR SINGH,GEN,HISSAR,2105,12,IND,0,M,HARYANA,769851,769650,201,1136762,620701,516061,0.18517508502219462,2105,0.27342953376692375
32,BALWAN ARYA,GEN,HISSAR,1386,11,IND,0,M,HARYANA,769851,769650,201,1136762,620701,516061,0.12192525788159703,1386,0.180034837910193
56,PARMESHWAR DAS,GEN,HISSAR,666,9,IND,0,M,HARYANA,769851,769650,201,1136762,620701,516061,0.0585874615794687,666,0.08651024678801482
44,PRITAM KUMAR,GEN,HISSAR,575,10,IND,0,M,HARYANA,769851,769650,201,1136762,620701,516061,0.05058226788017192,575,0.07468977763229509
34,NIRAJ,GEN,HISSAR,535,8,IND,0,M,HARYANA,769851,769650,201,1136762,620701,516061,0.047063501418942576,535,0.0694939670143963
47,ATAM PRAKASH,GEN,HISSAR,426,7,IND,0,M,HARYANA,769851,769650,201,1136762,620701,516061,0.03747486281209259,426,0.055335383080622094
66,ATMA SINGH GILL,SC,SIRSA (SC),349388,1,INC,9,M,HARYANA,841682,841648,34,1219935,654179,565756,28.640624295556734,349397,41.51175859766515
41,DR SUSHIL INDORA,SC,SIRSA (SC),277905,4,INLD,17,M,HARYANA,841682,841648,34,1219935,654179,565756,22.781705582674487,277922,33.01983409411156
50,MAHAVIR PARSHAD,SC,SIRSA (SC),115121,2,BJP,7,M,HARYANA,841682,841648,34,1219935,654179,565756,9.437224114399537,115128,13.678325068137372
51,RAIR CHAND,SC,SIRSA (SC),46058,6,HVP,1,M,HARYANA,841682,841648,34,1219935,654179,565756,3.775529024087349,46059,5.472256743045474
47,DR RAMESH BHUKAL,SC,SIRSA (SC),24448,3,BSP,0,M,HARYANA,841682,841648,34,1219935,654179,565756,2.004041198916336,24448,2.904659954709736
31,VIKARAMJIT,SC,SIRSA (SC),13132,8,IND,0,M,HARYANA,841682,841648,34,1219935,654179,565756,1.0764507945095436,13132,1.5602092001492252
36,AMI LAL,SC,SIRSA (SC),10823,5,RVP,0,M,HARYANA,841682,841648,34,1219935,654179,565756,0.887178415243435,10823,1.2858775642107114
49,DESRAJ,SC,SIRSA (SC),4773,7,IND,0,M,HARYANA,841682,841648,34,1219935,654179,565756,0.3912503535024407,4773,0.5670787779707775
63,DHANI RAM SHANDIL,SC,SIMLA (SC),309598,1,INC,1584,M,HIMACHAL PRADESH,528655,526021,2634,1018988,538046,480942,30.538338037346858,311182,58.86296355846441
55,HIRA NAND KASHYAP,SC,SIMLA (SC),201964,3,BJP,1038,M,HIMACHAL PRADESH,528655,526021,2634,1018988,538046,480942,19.921922534907182,203002,38.39971247789201
45,SOM NATH,SC,SIMLA (SC),14459,2,BSP,12,M,HIMACHAL PRADESH,528655,526021,2634,1018988,538046,480942,1.4201344863727543,14471,2.7373239636435858
47,PRATIBHA SINGH,GEN,MANDI,355416,1,INC,2207,F,HIMACHAL PRADESH,669552,665255,4297,1065083,541375,523708,33.577007613491155,357623,53.41228164504026
55,MAHESHWAR SINGH,GEN,MANDI,288992,2,BJP,2065,M,HIMACHAL PRADESH,669552,665255,4297,1065083,541375,523708,27.327166051847602,291057,43.47041006523765
42,MOHAN LAL SAHNI,SC,MANDI,8650,3,BSP,21,M,HIMACHAL PRADESH,669552,665255,4297,1065083,541375,523708,0.8141149562991804,8671,1.295045045045045
41,SHAN MOHAMMAD,GEN,MANDI,8075,5,IND,1,M,HIMACHAL PRADESH,669552,665255,4297,1065083,541375,523708,0.7582507654333043,8076,1.2061796544555166
70,KASHMIR SINGH GULERIA,GEN,MANDI,4122,4,IND,3,M,HIMACHAL PRADESH,669552,665255,4297,1065083,541375,523708,0.3872937602046038,4125,0.6160835902215213
59,CHANDER KUMAR,GEN,KANGRA,313148,1,INC,1407,M,HIMACHAL PRADESH,643177,640162,3015,1033686,516772,516914,30.430420843466973,314555,48.906444104810966
69,SHANTA KUMAR,GEN,KANGRA,295171,3,BJP,1593,M,HIMACHAL PRADESH,643177,640162,3015,1033686,516772,516914,28.709298568424067,296764,46.14033151061061
62,LT COL SHAKTI CHAND CHAUDHARY (,GEN,KANGRA,10848,2,BSP,12,M,HIMACHAL PRADESH,643177,640162,3015,1033686,516772,516914,1.050609179189812,10860,1.6884932141541131
50,FAKIR CHAND,GEN,KANGRA,10591,6,IND,3,M,HIMACHAL PRADESH,643177,640162,3015,1033686,516772,516914,1.0248760261820322,10594,1.6471360138810933
48,ROSHAN RANA,GEN,KANGRA,7092,4,SP,0,M,HIMACHAL PRADESH,643177,640162,3015,1033686,516772,516914,0.68608842530517,7092,1.1026513696851723
62,DHANI RAM,ST,KANGRA,3312,5,IND,0,M,HIMACHAL PRADESH,643177,640162,3015,1033686,516772,516914,0.3204067772998764,3312,0.51494378685805
44,SURESH CHANDEL,GEN,HAMIRPUR,311104,3,BJP,2139,M,HIMACHAL PRADESH,654102,650008,4094,1064238,532635,531603,29.433547759053898,313243,47.8890142515999
53,THAKUR RAM LAL,GEN,HAMIRPUR,309726,2,INC,1902,M,HIMACHAL PRADESH,654102,650008,4094,1064238,532635,531603,29.281795989243008,311628,47.642110863443314
60,ER MOHAR SINGH MASTANA,SC,HAMIRPUR,9431,1,BSP,42,M,HIMACHAL PRADESH,654102,650008,4094,1064238,532635,531603,0.8901204429836184,9473,1.448245074927152
60,RAMESHWARI KANWAR,GEN,HAMIRPUR,5565,9,IND,1,F,HIMACHAL PRADESH,654102,650008,4094,1064238,532635,531603,0.523003313168671,5566,0.8509376213495755
72,RANJIT SINGH,GEN,HAMIRPUR,4448,4,JD(S),5,M,HIMACHAL PRADESH,654102,650008,4094,1064238,532635,531603,0.4184214433237678,4453,0.6807806733506395
60,COL MATWAR SINGH ( RETD ),GEN,HAMIRPUR,4253,8,IND,0,M,HIMACHAL PRADESH,654102,650008,4094,1064238,532635,531603,0.399628654492698,4253,0.6502044023714956
49,GOPI CHAND,GEN,HAMIRPUR,3167,7,IND,1,M,HIMACHAL PRADESH,654102,650008,4094,1064238,532635,531603,0.2976777750841447,3168,0.48432813230963984
58,KHUSHI RAM,GEN,HAMIRPUR,1160,6,IND,0,M,HIMACHAL PRADESH,654102,650008,4094,1064238,532635,531603,0.10899817522020451,1160,0.17734237167903477
53,CAPT S S KALMOTIA ( RETD ),SC,HAMIRPUR,1154,5,IND,4,M,HIMACHAL PRADESH,654102,650008,4094,1064238,532635,531603,0.10881024733189382,1158,0.17703660896924334
54,ABDUL RASHID SHAHEEN,GEN,BARAMULLA,127335,1,JKN,318,M,JAMMU & KASHMIR,334770,333450,1320,940998,523161,417837,13.565703646553978,127653,38.13155300654181
51,NIZAM-UDDIN BHAT,GEN,BARAMULLA,117624,5,JKPDP,134,M,JAMMU & KASHMIR,334770,333450,1320,940998,523161,417837,12.514160497684374,117758,35.17579233503599
82,GHULAM RASOOL KAR,GEN,BARAMULLA,61962,2,INC,354,M,JAMMU & KASHMIR,334770,333450,1320,940998,523161,417837,6.622330759470264,62316,18.614571198136034
44,MIR KHURSHEED ABBASI,GEN,BARAMULLA,10565,6,IND,4,M,JAMMU & KASHMIR,334770,333450,1320,940998,523161,417837,1.1231692309654218,10569,3.1570929294739676
51,MOHMAD AKBAR,GEN,BARAMULLA,8506,3,BJP,497,M,JAMMU & KASHMIR,334770,333450,1320,940998,523161,417837,0.9567501737516977,9003,2.689309077874362
38,SYED MOHD RAFIQ SHAH,GEN,BARAMULLA,7458,4,JKNPP,13,M,JAMMU & KASHMIR,334770,333450,1320,940998,523161,417837,0.7939443016882076,7471,2.231681452937838
32,OMAR ABDULLAH,GEN,SRINAGAR,98416,4,JKN,6,M,JAMMU & KASHMIR,195678,195645,33,1053734,605469,448265,9.340307895541,98422,50.29793844990239
50,ADVOCATE GHULAM NABI LONE,GEN,SRINAGAR,75261,5,JKPDP,2,M,JAMMU & KASHMIR,195678,195645,33,1053734,605469,448265,7.14250465487495,75263,38.46267848199593
38,NAZIR AHMAD KHAN,GEN,SRINAGAR,6873,13,IND,0,M,JAMMU & KASHMIR,195678,195645,33,1053734,605469,448265,0.6522518965887026,6873,3.512403029466777
38,IFTIKHAR SADIQ,GEN,SRINAGAR,3129,1,BJP,25,M,JAMMU & KASHMIR,195678,195645,33,1053734,605469,448265,0.29931652580252704,3154,1.611831682662333
35,MUSHTAQ SHAMIM,GEN,SRINAGAR,2549,12,IND,0,M,JAMMU & KASHMIR,195678,195645,33,1053734,605469,448265,0.24190165639525726,2549,1.3026502723862672
35,PEER ALI SHAH,GEN,SRINAGAR,1519,6,JKAL,0,M,JAMMU & KASHMIR,195678,195645,33,1053734,605469,448265,0.14415402748701284,1519,0.7762753094369321
49,KRISHAN KUMAR,GEN,SRINAGAR,1327,10,IND,0,M,JAMMU & KASHMIR,195678,195645,33,1053734,605469,448265,0.12593311025363138,1327,0.6781549279939492
58,BANSI LAL,GEN,SRINAGAR,1282,3,BSP,0,M,JAMMU & KASHMIR,195678,195645,33,1053734,605469,448265,0.12166258277705759,1282,0.6551579635932501
30,DARAKSHAN ANDRABI,GEN,SRINAGAR,1265,7,SDP,0,F,JAMMU & KASHMIR,195678,195645,33,1053734,605469,448265,0.1200492723970186,1265,0.6464702214863194
37,ABDUL RASHID LONE,GEN,SRINAGAR,1148,9,IND,0,M,JAMMU & KASHMIR,195678,195645,33,1053734,605469,448265,0.10894590095792676,1148,0.5866781140445017
45,BASHIR AHMAD,GEN,SRINAGAR,1084,2,JKNPP,0,M,JAMMU & KASHMIR,195678,195645,33,1053734,605469,448265,0.10287226188013293,1084,0.553971320230174
52,MEHBOOBA,GEN,SRINAGAR,956,11,IND,0,F,JAMMU & KASHMIR,195678,195645,33,1053734,605469,448265,0.09072498372454528,956,0.4885577326015188
29,MOHMAD YOUSUF WANI,GEN,SRINAGAR,836,8,AIFB,0,M,JAMMU & KASHMIR,195678,195645,33,1053734,605469,448265,0.07933691045368185,836,0.42723249419965453
42,MEHBOOBA MUFTI,GEN,ANANTNAG,73805,3,JKPDP,631,F,JAMMU & KASHMIR,150219,146632,3587,998905,568139,430766,7.451759676846146,74436,49.55165458430692
62,DR MEHBOOB BEG,GEN,ANANTNAG,34256,2,JKN,1242,M,JAMMU & KASHMIR,150219,146632,3587,998905,568139,430766,3.5536912919647015,35498,23.630832318148837
54,MOHAMAD YUSUF TARIGAMI,GEN,ANANTNAG,18115,4,CPM,351,M,JAMMU & KASHMIR,150219,146632,3587,998905,568139,430766,1.8486242435466835,18466,12.292719296493786
42,SOFI MOHD YOUSUF,GEN,ANANTNAG,4140,1,BJP,696,M,JAMMU & KASHMIR,150219,146632,3587,998905,568139,430766,0.48413012248412013,4836,3.2192998222595013
32,IMTIYAZ AHMAD RATHER,GEN,ANANTNAG,2811,9,IND,16,M,JAMMU & KASHMIR,150219,146632,3587,998905,568139,430766,0.2830098958359404,2827,1.8819190648320119
42,AB MAJEED NAIKOO,GEN,ANANTNAG,2740,11,IND,20,M,JAMMU & KASHMIR,150219,146632,3587,998905,568139,430766,0.27630255129366654,2760,1.837317516426018
65,MOHD MAQBOOL DAR,GEN,ANANTNAG,2654,14,IND,37,M,JAMMU & KASHMIR,150219,146632,3587,998905,568139,430766,0.2693949875113249,2691,1.7913845785153675
35,SANJAY SARAF,GEN,ANANTNAG,1075,6,LJNSP,520,M,JAMMU & KASHMIR,150219,146632,3587,998905,568139,430766,0.15967484395412979,1595,1.0617831299635865
39,GH RASOOL,GEN,ANANTNAG,1575,12,IND,11,M,JAMMU & KASHMIR,150219,146632,3587,998905,568139,430766,0.15877385737382432,1586,1.055791877192632
39,HAMIDULLAH WANI,GEN,ANANTNAG,1489,5,AIFB,15,M,JAMMU & KASHMIR,150219,146632,3587,998905,568139,430766,0.15056486853104148,1504,1.0012049075017142
35,GH MOHI-UD-DIN DAR,GEN,ANANTNAG,1258,13,IND,20,M,JAMMU & KASHMIR,150219,146632,3587,998905,568139,430766,0.12794009440337167,1278,0.8507578934755258
54,MOHD YOUSUF QURASHI,GEN,ANANTNAG,1110,8,RLD,5,M,JAMMU & KASHMIR,150219,146632,3587,998905,568139,430766,0.11162222633783994,1115,0.7422496488460182
54,GH MOHD TANTARY,GEN,ANANTNAG,854,7,SAP,10,M,JAMMU & KASHMIR,150219,146632,3587,998905,568139,430766,0.08649471170932171,864,0.5751602660116231
43,RAMESH KUMAR BHAT,GEN,ANANTNAG,750,10,IND,13,M,JAMMU & KASHMIR,150219,146632,3587,998905,568139,430766,0.07638364008589404,763,0.507925096026468
56,THUPSTAN CHHEWANG,ST,LADAKH,65759,3,IND,1080,M,JAMMU & KASHMIR,128931,127813,1118,175768,87467,88301,38.02683082244777,66839,51.840907151887436
66,HASSAN KHAN,GEN,LADAKH,41116,2,JKN,10,M,JAMMU & KASHMIR,128931,127813,1118,175768,87467,88301,23.39788812525602,41126,31.89768170571856
66,WAZIR MOHD ALI,GEN,LADAKH,18115,4,IND,2,M,JAMMU & KASHMIR,128931,127813,1118,175768,87467,88301,10.307336944153658,18117,14.051702073201946
63,SONAM PALZOR,ST,LADAKH,2823,1,BJP,26,M,JAMMU & KASHMIR,128931,127813,1118,175768,87467,88301,1.6208866232761368,2849,2.2097090691920487
45,CH LAL SINGH,GEN,UDHAMPUR,240852,5,INC,20,M,JAMMU & KASHMIR,608074,607945,129,1348721,716841,631880,17.85929039438105,240872,39.612284031219886
70,PROF CHAMAN LAL GUPTA,GEN,UDHAMPUR,193672,3,BJP,25,M,JAMMU & KASHMIR,608074,607945,129,1348721,716841,631880,14.361532147864533,193697,31.85418222124281
41,KHALID NAJIB SUHARWARDY,GEN,UDHAMPUR,69892,4,JKN,79,M,JAMMU & KASHMIR,608074,607945,129,1348721,716841,631880,5.187952141325003,69971,11.506987636373205
63,PROF BHIM SINGH,GEN,UDHAMPUR,49868,1,JKNPP,1,M,JAMMU & KASHMIR,608074,607945,129,1348721,716841,631880,3.697503041770685,49869,8.20113999282982
42,JIA LAL VERMA,GEN,UDHAMPUR,18973,2,BSP,1,M,JAMMU & KASHMIR,608074,607945,129,1348721,716841,631880,1.4068143077775166,18974,3.1203439055115
50,AMAR NATH,SC,UDHAMPUR,5031,6,IJP,0,M,JAMMU & KASHMIR,608074,607945,129,1348721,716841,631880,0.37302006864281045,5031,0.82736640606242
58,RANBIR SINGH,GEN,UDHAMPUR,3968,16,IND,0,M,JAMMU & KASHMIR,608074,607945,129,1348721,716841,631880,0.2942046575978279,3968,0.6525521564809547
40,JATINDER SINGH,GEN,UDHAMPUR,3288,13,IND,0,M,JAMMU & KASHMIR,608074,607945,129,1348721,716841,631880,0.24378652071110332,3288,0.5407236619227265
29,KULDEEP KUMAR,GEN,UDHAMPUR,3288,12,SJP(R),0,M,JAMMU & KASHMIR,608074,607945,129,1348721,716841,631880,0.24378652071110332,3288,0.5407236619227265
55,PURAN CHAND,SC,UDHAMPUR,2579,8,RPI,0,M,JAMMU & KASHMIR,608074,607945,129,1348721,716841,631880,0.1912181985747979,2579,0.4241260109789269
38,SURAM CHAND,GEN,UDHAMPUR,2349,19,IND,0,M,JAMMU & KASHMIR,608074,607945,129,1348721,716841,631880,0.17416500521605285,2349,0.38630166723129095
59,KESARI SHASHI KUMAR,GEN,UDHAMPUR,2179,20,IND,0,M,JAMMU & KASHMIR,608074,607945,129,1348721,716841,631880,0.1615604709943717,2179,0.3583445435917339
42,BASHIR AHMED SHEIKH,GEN,UDHAMPUR,2122,7,SAP,0,M,JAMMU & KASHMIR,608074,607945,129,1348721,716841,631880,0.15733424481416097,2122,0.3489706844890589
53,DEV RAJ,SC,UDHAMPUR,1858,14,IND,0,M,JAMMU & KASHMIR,608074,607945,129,1348721,716841,631880,0.13776014461107966,1858,0.30555491601351153
47,RAJINDER KUMAR,GEN,UDHAMPUR,1618,15,IND,2,M,JAMMU & KASHMIR,608074,607945,129,1348721,716841,631880,0.12011379670072608,1620,0.26641494291813167
28,SUDESH KUMAR SHARMA,GEN,UDHAMPUR,1498,17,IND,1,M,JAMMU & KASHMIR,608074,607945,129,1348721,716841,631880,0.11114233410764718,1499,0.24651604903350577
51,"SURJIT SINGH ""G"" SITARA",GEN,UDHAMPUR,1391,9,SPI,0,M,JAMMU & KASHMIR,608074,607945,129,1348721,716841,631880,0.1031347476609321,1391,0.2287550528389637
30,KALOO CHOWDHRY,GEN,UDHAMPUR,1371,11,AIFB,0,M,JAMMU & KASHMIR,608074,607945,129,1348721,716841,631880,0.10165186128191078,1371,0.22546597946960403
48,SURINDER SINGH,GEN,UDHAMPUR,1222,10,SP,0,M,JAMMU & KASHMIR,608074,607945,129,1348721,716841,631880,0.09060435775820204,1222,0.20096238286787463
30,SANJU GUPTA,GEN,UDHAMPUR,926,18,IND,0,M,JAMMU & KASHMIR,608074,607945,129,1348721,716841,631880,0.06865763934868664,926,0.1522840970013518
51,MADAN LAL SHARMA,GEN,JAMMU,319830,4,INC,164,M,JAMMU & KASHMIR,821670,820595,1075,1849989,967158,882831,17.297075820450825,319994,38.94434505336692
48,DR NIRMAL SINGH,GEN,JAMMU,301784,5,BJP,642,M,JAMMU & KASHMIR,821670,820595,1075,1849989,967158,882831,16.3474485523968,302426,36.806260420850215
54,SURJIT SINGH SLATHIA,GEN,JAMMU,120357,2,JKN,40,M,JAMMU & KASHMIR,821670,820595,1075,1849989,967158,882831,6.507984642070845,120397,14.652719461584335
47,TIRATH KUMAR,SC,JAMMU,29454,1,BSP,44,M,JAMMU & KASHMIR,821670,820595,1075,1849989,967158,882831,1.594495967273319,29498,3.5900057200579307
38,S KULDEEP SINGH,GEN,JAMMU,9186,3,JKNPP,9,M,JAMMU & KASHMIR,821670,820595,1075,1849989,967158,882831,0.4970299823404355,9195,1.1190623973127898
28,PANKAJ KOHLI,GEN,JAMMU,4655,6,SP,6,M,JAMMU & KASHMIR,821670,820595,1075,1849989,967158,882831,0.2519474440118293,4661,0.5672593620309857
25,SHAHZAD KHAN,GEN,JAMMU,3802,20,IND,1,M,JAMMU & KASHMIR,821670,820595,1075,1849989,967158,882831,0.2055687898684803,3803,0.4628378789538379
32,RAMESH CHANDER SHARMA,GEN,JAMMU,3314,16,IND,1,M,JAMMU & KASHMIR,821670,820595,1075,1849989,967158,882831,0.17919025464475735,3315,0.40344663916170725
25,SHARAZ AHMAD,GEN,JAMMU,2894,21,IND,62,M,JAMMU & KASHMIR,821670,820595,1075,1849989,967158,882831,0.15978473385517428,2956,0.3597551328392177
65,YUDHVIR SINGH,GEN,JAMMU,2295,26,IND,5,M,JAMMU & KASHMIR,821670,820595,1075,1849989,967158,882831,0.12432506355443194,2300,0.2799177285284847
60,BALBIR SINGH,GEN,JAMMU,2056,13,IND,4,M,JAMMU & KASHMIR,821670,820595,1075,1849989,967158,882831,0.11135201344440428,2060,0.25070892207333845
45,OM PARKASH MALHOTRA,SC,JAMMU,1900,12,IND,2,M,JAMMU & KASHMIR,821670,820595,1075,1849989,967158,882831,0.10281142212196936,1902,0.23147979115703382
46,RAJAN PADRI,GEN,JAMMU,1746,7,AIFB,0,M,JAMMU & KASHMIR,821670,820595,1075,1849989,967158,882831,0.09437893955045137,1746,0.2124940669611888
51,CHARANJIT SINGH BALI,GEN,JAMMU,1707,15,IND,0,M,JAMMU & KASHMIR,821670,820595,1075,1849989,967158,882831,0.09227081890757188,1707,0.20774763591222753
55,SATISH POONCHI,GEN,JAMMU,1646,18,IND,10,M,JAMMU & KASHMIR,821670,820595,1075,1849989,967158,882831,0.089514045759191,1656,0.20154076454050895
48,SUBHASH CHANDER LANGER,GEN,JAMMU,1650,8,SPI,0,M,JAMMU & KASHMIR,821670,820595,1075,1849989,967158,882831,0.08918971950644031,1650,0.20081054437913032
38,SUDESH PURI,GEN,JAMMU,1614,9,SAP,6,F,JAMMU & KASHMIR,821670,820595,1075,1849989,967158,882831,0.08756808824268685,1620,0.19715944357223703
33,QARI ZAHIR ABBAS BHATTI,GEN,JAMMU,1549,11,JD(S),67,M,JAMMU & KASHMIR,821670,820595,1075,1849989,967158,882831,0.08735187074085306,1616,0.19667263013131792
32,MUSHTAQ AHMED,GEN,JAMMU,1491,25,IND,0,M,JAMMU & KASHMIR,821670,820595,1075,1849989,967158,882831,0.08059507380854697,1491,0.18145971010259593
38,SANJEEV KUMAR MANMOTRA,GEN,JAMMU,1485,10,LJNSP,0,M,JAMMU & KASHMIR,821670,820595,1075,1849989,967158,882831,0.08027074755579627,1485,0.1807294899412173
36,SUBASH SHARMA,GEN,JAMMU,1298,17,IND,0,M,JAMMU & KASHMIR,821670,820595,1075,1849989,967158,882831,0.07016257934506638,1298,0.15797096157824916
43,CH MOHD IQBAL,ST,JAMMU,1184,24,IND,9,M,JAMMU & KASHMIR,821670,820595,1075,1849989,967158,882831,0.06448686992192927,1193,0.1451921087541227
48,GURDEEP SINGH BIJRAL,GEN,JAMMU,1039,22,IND,0,M,JAMMU & KASHMIR,821670,820595,1075,1849989,967158,882831,0.05616249610132817,1039,0.1264497912787372
58,JASBIR SINGH,GEN,JAMMU,1007,14,IND,3,M,JAMMU & KASHMIR,821670,820595,1075,1849989,967158,882831,0.05459491921303316,1010,0.1229203938320737
66,LOCHAN SINGH,GEN,JAMMU,871,23,IND,0,M,JAMMU & KASHMIR,821670,820595,1075,1849989,967158,882831,0.04708136102430879,871,0.10600362676013485
41,SHUKEEL KUMAR GUPTA,GEN,JAMMU,781,19,IND,0,M,JAMMU & KASHMIR,821670,820595,1075,1849989,967158,882831,0.042216467233048414,781,0.09505032433945501
94,RAMCHANDRA VEERAPPA,SC,BIDAR (SC),312391,3,BJP,447,M,KARNATAKA,815792,814933,859,1372985,703119,669866,22.785245286729282,312838,38.347765116598346
52,NARSINGRAO HULLA SURYAWANSHI,SC,BIDAR (SC),288852,1,INC,365,M,KARNATAKA,815792,814933,859,1372985,703119,669866,21.06483319191397,289217,35.45229666385549
60,MOTIRAM CHOWDHARY,SC,BIDAR (SC),173247,2,JD(S),44,M,KARNATAKA,815792,814933,859,1372985,703119,669866,12.62147802051734,173291,21.24205679879185
39,SURENDRA NARENDRA DANDE,SC,BIDAR (SC),25907,5,KNDP,1,M,KARNATAKA,815792,814933,859,1372985,703119,669866,1.8869834703219628,25908,3.175809520073744
27,DHANAJI BHIMA LAMANI,SC,BIDAR (SC),14536,4,RSPS,2,M,KARNATAKA,815792,814933,859,1372985,703119,669866,1.0588608032862705,14538,1.7820719006805656
59,IQBAL AHMED SARADGI,GEN,GULBARGA,312432,1,INC,169,M,KARNATAKA,827894,827038,856,1439006,721781,717225,21.723397956645073,312601,37.758577788943995
60,BASAWARAJ PATIL SEDAM,GEN,GULBARGA,254548,2,BJP,582,M,KARNATAKA,827894,827038,856,1439006,721781,717225,17.729599459626993,255130,30.816747071484997
51,VITHAL HEROOR,GEN,GULBARGA,189001,3,JD(S),99,M,KARNATAKA,827894,827038,856,1439006,721781,717225,13.14101539534929,189100,22.84108835189046
32,SURYAKANT NIMBALKAR,SC,GULBARGA,26723,4,BSP,1,M,KARNATAKA,827894,827038,856,1439006,721781,717225,1.8571152587272048,26724,3.2279494717922823
25,SANGANNA,GEN,GULBARGA,15212,11,IND,0,M,KARNATAKA,827894,827038,856,1439006,721781,717225,1.0571185943630534,15212,1.8374332946005163
59,ARUN KUMAR CHANDRASHEKARA PATIL,GEN,GULBARGA,7155,5,KNDP,2,M,KARNATAKA,827894,827038,856,1439006,721781,717225,0.4973572035140924,7157,0.8644826511606559
40,BHAGAVANREDDY B,GEN,GULBARGA,6748,10,IND,1,M,KARNATAKA,827894,827038,856,1439006,721781,717225,0.46900429880069994,6749,0.8152009798355828
60,HAMID PASHA SARMAST,GEN,GULBARGA,4268,9,MUL,0,M,KARNATAKA,827894,827038,856,1439006,721781,717225,0.2965936208744091,4268,0.5155249343514992
65,BASAWANTH RAO REVANSIDDAPPA,GEN,GULBARGA,3900,7,AIFB,0,M,KARNATAKA,827894,827038,856,1439006,721781,717225,0.27102041270154537,3900,0.471074799430845
28,SANDESH C BANDAK,GEN,GULBARGA,3671,8,USYP,0,M,KARNATAKA,827894,827038,856,1439006,721781,717225,0.2551066500070187,3671,0.4434142535155467
38,UMESH HAVANOOR,GEN,GULBARGA,3380,6,SP,2,M,KARNATAKA,827894,827038,856,1439006,721781,717225,0.2350233425016991,3382,0.40850640299361995
66,A VENKATESH NAIK,ST,RAICHUR,289363,3,INC,61,M,KARNATAKA,825096,824732,364,1413018,702763,710255,20.482683164687217,289424,35.07761521083607
53,RAJA MADANGOPAL NAYAK,ST,RAICHUR,288788,2,JD(S),128,M,KARNATAKA,825096,824732,364,1413018,702763,710255,20.44673174722473,288916,35.0160466176057
53,KALLUR SURESHREDDY,GEN,RAICHUR,198630,1,BJP,174,M,KARNATAKA,825096,824732,364,1413018,702763,710255,14.069459837029678,198804,24.09465080427005
28,BASAVALINGAPPA B,SC,RAICHUR,47951,4,IND,1,M,KARNATAKA,825096,824732,364,1413018,702763,710255,3.3935873428363967,47952,5.81168736728817
62,K VIRUPAXAPPA,GEN,KOPPAL,355872,3,INC,286,M,KARNATAKA,894082,892586,1496,1413496,702828,710668,25.19695846327121,356158,39.835048686809486
49,NAGAPPA BHEEMAPPA SALONI,GEN,KOPPAL,311614,2,BJP,921,M,KARNATAKA,894082,892586,1496,1413496,702828,710668,22.11078064600112,312535,34.955966007592146
63,AGADI VIRUPAXAPPA SANGANNA,GEN,KOPPAL,158267,1,JD(S),285,M,KARNATAKA,894082,892586,1496,1413496,702828,710668,11.217010872333562,158552,17.733496480188617
51,ABEED HUSSAIN,GEN,KOPPAL,24667,4,KNDP,2,M,KARNATAKA,894082,892586,1496,1413496,702828,710668,1.745247245128391,24669,2.7591428974076204
33,PUJAR D H,SC,KOPPAL,23650,6,IND,1,M,KARNATAKA,894082,892586,1496,1413496,702828,710668,1.6732272323374102,23651,2.6452830948391757
63,GIRIJA SHANKARA PATIL,GEN,KOPPAL,18516,5,JP,1,M,KARNATAKA,894082,892586,1496,1413496,702828,710668,1.3100143191066689,18517,2.0710628331629537
41,G KARUNAKARA REDDY,GEN,BELLARY,318301,2,BJP,677,M,KARNATAKA,950328,949130,1198,1423161,711374,711787,22.413346065554073,318978,33.565042806273205
53,KONDAIAH K C,GEN,BELLARY,286973,3,INC,326,M,KARNATAKA,950328,949130,1198,1423161,711374,711787,20.18738568580786,287299,30.231562155382143
43,GULAGI NAGARAJ B,GEN,BELLARY,247661,4,JD(S),181,M,KARNATAKA,950328,949130,1198,1423161,711374,711787,17.4148954334752,247842,26.07962724448822
58,KAMALA NABHAN B,GEN,BELLARY,36269,1,BSP,8,M,KARNATAKA,950328,949130,1198,1423161,711374,711787,2.5490439943196868,36277,3.817313601198744
37,SOMASHEKARA K,SC,BELLARY,19639,8,IND,3,M,KARNATAKA,950328,949130,1198,1423161,711374,711787,1.3801671068839014,19642,2.0668653349159447
45,NARAYANA MOORTHY P,SC,BELLARY,17569,7,IND,2,M,KARNATAKA,950328,949130,1198,1423161,711374,711787,1.2346459746999812,17571,1.848940576306286
37,IDLI RAMAPPA,GEN,BELLARY,12413,5,CPI(ML)(L),0,M,KARNATAKA,950328,949130,1198,1423161,711374,711787,0.8722133335581849,12413,1.3061806029076277
26,GHOUSIA BEGUM,GEN,BELLARY,10305,6,IND,1,F,KARNATAKA,950328,949130,1198,1423161,711374,711787,0.7241626210948726,10306,1.0844676785278347
52,G M SIDDESWARA,GEN,DAVANGERE,369520,3,BJP,979,M,KARNATAKA,910398,908840,1558,1332608,676741,655867,27.802549586975317,370499,40.696376749509554
36,MALLIKARJUN S S,GEN,DAVANGERE,337397,2,INC,426,M,KARNATAKA,910398,908840,1558,1332608,676741,655867,25.35051568053021,337823,37.107177300477375
83,CHANNAIAH ODEYAR,GEN,DAVANGERE,158367,1,JD(S),148,M,KARNATAKA,910398,908840,1558,1332608,676741,655867,11.89509593218711,158515,17.41161557912034
51,DR SRIDHARA UDUPA,GEN,DAVANGERE,16582,6,IND,0,M,KARNATAKA,910398,908840,1558,1332608,676741,655867,1.2443269138411297,16582,1.8214011893699238
40,MADAPPA R,ST,DAVANGERE,14645,5,IND,1,M,KARNATAKA,910398,908840,1558,1332608,676741,655867,1.099047882047834,14646,1.608746943644428
34,MALLIKARJUNA SWAMY T M,GEN,DAVANGERE,12329,4,IND,4,M,KARNATAKA,910398,908840,1558,1332608,676741,655867,0.9254784602823937,12333,1.3546822378783785
64,N Y HANUMANTHAPPA,GEN,CHITRADURGA,322061,3,INC,548,M,KARNATAKA,918905,917040,1865,1316427,665970,650457,24.50641015415211,322609,35.107981782665235
64,KODANDARAMAIAH P,GEN,CHITRADURGA,284762,1,JD(S),387,M,KARNATAKA,918905,917040,1865,1316427,665970,650457,21.660828895183705,285149,31.031390622534428
64,MUDALAGIRIYAPPA C P,GEN,CHITRADURGA,240243,2,BJP,921,M,KARNATAKA,918905,917040,1865,1316427,665970,650457,18.319587793322377,241164,26.24471517730342
66,PARAMESWARAPPA S,GEN,CHITRADURGA,36076,5,JP,5,M,KARNATAKA,918905,917040,1865,1316427,665970,650457,2.740828014010652,36081,3.9265212399540754
40,VENKATESHA C,GEN,CHITRADURGA,19511,6,KNDP,3,M,KARNATAKA,918905,917040,1865,1316427,665970,650457,1.482345773825666,19514,2.1236145194552214
50,KRISHNAPPA,GEN,CHITRADURGA,14387,4,RJD,1,M,KARNATAKA,918905,917040,1865,1316427,665970,650457,1.0929584397767593,14388,1.5657766580876153
74,S MALLIKARJUNAIAH,GEN,TUMKUR,302378,3,BJP,638,M,KARNATAKA,863743,862673,1070,1221507,617612,603895,24.806734631893228,303016,35.08173148725952
48,JAGADEESH D L,GEN,TUMKUR,300427,1,JD(S),238,M,KARNATAKA,863743,862673,1070,1221507,617612,603895,24.61426745814801,300665,34.809544042614526
63,BASAVARAJ G S,GEN,TUMKUR,227518,2,INC,183,M,KARNATAKA,863743,862673,1070,1221507,617612,603895,18.640990186711985,227701,26.362123918804553
33,PAVAGADA SREERAM,SC,TUMKUR,22109,5,IND,11,M,KARNATAKA,863743,862673,1070,1221507,617612,603895,1.8108778746253602,22120,2.5609469483399576
39,CHOUDHARI VEER SINGH,GEN,TUMKUR,10241,4,SP,0,M,KARNATAKA,863743,862673,1070,1221507,617612,603895,0.8383906109420577,10241,1.1856536029814424
77,R L JALAPPA,GEN,CHIKBALLAPUR,375642,2,INC,562,M,KARNATAKA,931128,929379,1749,1314311,669455,644856,28.623666696847245,376204,40.403038035586945
38,SHASHI KUMAR,ST,CHIKBALLAPUR,315829,3,JD(S),353,M,KARNATAKA,931128,929379,1749,1314311,669455,644856,24.05686325382653,316182,33.95687810913215
47,ASHOK KRISHNAPPA,GEN,CHIKBALLAPUR,190940,1,JD(U),826,M,KARNATAKA,931128,929379,1749,1314311,669455,644856,14.590610593687492,191766,20.59502023352321
34,SURESH D R,GEN,CHIKBALLAPUR,21430,6,IND,2,M,KARNATAKA,931128,929379,1749,1314311,669455,644856,1.6306642796111424,21432,2.301724360130938
48,NARAYANA SWAMY D N ( KWALITY),GEN,CHIKBALLAPUR,15959,4,KNDP,5,M,KARNATAKA,931128,929379,1749,1314311,669455,644856,1.2146288055110244,15964,1.71447964189671
58,VEERAPPA,GEN,CHIKBALLAPUR,9579,5,IND,1,M,KARNATAKA,931128,929379,1749,1314311,669455,644856,0.7288990200949395,9580,1.028859619730048
57,K H MUNIYAPPA,SC,KOLAR (SC),384152,2,INC,1430,M,KARNATAKA,909264,905808,3456,1262765,642615,620150,30.534739242851995,385582,42.40594590789913
58,VEERAIAH D S,SC,KOLAR (SC),372035,3,BJP,1912,M,KARNATAKA,909264,905808,3456,1262765,642615,620150,29.613348485268435,373947,41.12633954495064
59,GANGADHARAPPA S L,SC,KOLAR (SC),83342,1,JD(S),91,M,KARNATAKA,909264,905808,3456,1262765,642615,620150,6.607167604423626,83433,9.175882911893575
44,BALAJI CHANNAIAH,SC,KOLAR (SC),27687,4,JP,17,M,KARNATAKA,909264,905808,3456,1262765,642615,620150,2.1939157325393084,27704,3.046859877879252
36,SREENIVASAPPA B N,SC,KOLAR (SC),22047,8,IND,0,M,KARNATAKA,909264,905808,3456,1262765,642615,620150,1.7459305571503805,22047,2.424708335532914
32,SRINIVASA,SC,KOLAR (SC),7199,7,IND,3,M,KARNATAKA,909264,905808,3456,1262765,642615,620150,0.5703357315098216,7202,0.792069190026219
31,RAVI KUMAR M,SC,KOLAR (SC),4692,6,IND,1,M,KARNATAKA,909264,905808,3456,1262765,642615,620150,0.3716447636733676,4693,0.51613172851889
32,SURESHA N,SC,KOLAR (SC),4654,5,KNDP,2,M,KARNATAKA,909264,905808,3456,1262765,642615,620150,0.36871468563034293,4656,0.5120625032993719
37,TEJASHWINI SEE RAMESH,GEN,KANAKAPURA,583920,1,INC,318,F,KARNATAKA,1552416,1551189,1227,2695484,1416942,1278542,21.67469738273349,584238,37.63411353657782
65,RAMACHANDRA GOWDA,GEN,KANAKAPURA,467257,3,BJP,318,M,KARNATAKA,1552416,1551189,1227,2695484,1416942,1278542,17.34660639796044,467575,30.1191819718426
71,DEVEGOWDA H D,GEN,KANAKAPURA,461731,2,JD(S),589,M,KARNATAKA,1552416,1551189,1227,2695484,1416942,1278542,17.15165068685253,462320,29.780677344217015
59,MUNIRAMAIAH,GEN,KANAKAPURA,23349,5,IND,1,M,KARNATAKA,1552416,1551189,1227,2695484,1416942,1278542,0.8662637210979549,23350,1.5041071465380413
64,KUMAR G S,GEN,KANAKAPURA,14932,4,IND,1,M,KARNATAKA,1552416,1551189,1227,2695484,1416942,1278542,0.5540006915270134,14933,0.9619200008245213
61,DR H T SANGLIANA,GEN,BANGALORE NORTH,473379,3,BJP,123,M,KARNATAKA,1156845,1156652,193,2133579,1113038,1020541,22.19285060454757,473502,40.930461729963824
70,JAFFER SHARIEF C K,GEN,BANGALORE NORTH,443104,2,INC,40,M,KARNATAKA,1156845,1156652,193,2133579,1113038,1020541,20.76998320662136,443144,38.30625537561212
55,IBRAHIM C M,GEN,BANGALORE NORTH,208565,1,JD(S),23,M,KARNATAKA,1156845,1156652,193,2133579,1113038,1020541,9.776436682213314,208588,18.030764709187487
47,VENKATESH M,GEN,BANGALORE NORTH,11345,8,IND,2,M,KARNATAKA,1156845,1156652,193,2133579,1113038,1020541,0.531829381522784,11347,0.9808574182366695
58,JOE SIMON,GEN,BANGALORE NORTH,7075,4,KNDP,4,M,KARNATAKA,1156845,1156652,193,2133579,1113038,1020541,0.3317899173173339,7079,0.6119229455977249
65,MOHAMAD IBRAHIM,GEN,BANGALORE NORTH,6878,7,IND,0,M,KARNATAKA,1156845,1156652,193,2133579,1113038,1020541,0.32236912718019817,6878,0.5945481028141194
36,MEER LAYAQ HUSSAIN,GEN,BANGALORE NORTH,3604,6,IND,0,M,KARNATAKA,1156845,1156652,193,2133579,1113038,1020541,0.16891804803103144,3604,0.3115369820503179
47,UMA K,GEN,BANGALORE NORTH,2702,5,IND,1,F,KARNATAKA,1156845,1156652,193,2133579,1113038,1020541,0.12668853602327357,2703,0.23365273653773844
44,ANANTH KUMAR,GEN,BANGALORE SOUTH,386669,1,BJP,13,M,KARNATAKA,800649,800633,16,1620352,852868,767484,23.864073978987282,386682,48.29606981336391
51,KRISHNAPPA M,GEN,BANGALORE SOUTH,324408,2,INC,3,M,KARNATAKA,800649,800633,16,1620352,852868,767484,20.021020124022435,324411,40.518504363335246
50,JAYANTHI,GEN,BANGALORE SOUTH,77551,3,JD(S),0,F,KARNATAKA,800649,800633,16,1620352,852868,767484,4.786058831661269,77551,9.686017218531466
55,SRINIVASA RAO S V,GEN,BANGALORE SOUTH,5012,7,IND,0,M,KARNATAKA,800649,800633,16,1620352,852868,767484,0.30931550675408803,5012,0.6259921638570709
70,GUINNESS HOTTE PAKSHA RANGASWAMY,GEN,BANGALORE SOUTH,3304,4,IND,0,M,KARNATAKA,800649,800633,16,1620352,852868,767484,0.20390631171498538,3304,0.41266522533594624
44,DR MANJUNATH B R,GEN,BANGALORE SOUTH,1934,6,IND,0,M,KARNATAKA,800649,800633,16,1620352,852868,767484,0.11935678173631409,1934,0.24155403928562955
45,BHADRAPPA,GEN,BANGALORE SOUTH,1755,5,IND,0,M,KARNATAKA,800649,800633,16,1620352,852868,767484,0.10830979935223951,1755,0.21919717629073415
53,AMBAREESH M H,GEN,MANDYA,410476,1,INC,640,M,KARNATAKA,857564,856067,1497,1198750,604908,593842,34.29539103232534,411116,47.93997882373794
65,DR S RAMEGOWDA,GEN,MANDYA,285960,4,JD(S),718,M,KARNATAKA,857564,856067,1497,1198750,604908,593842,23.914744525547444,286678,33.42934171676983
57,DR K S JAYARAM,GEN,MANDYA,98155,2,JD(U),105,M,KARNATAKA,857564,856067,1497,1198750,604908,593842,8.19687174139729,98260,11.458036951177988
74,B T SRINIVASAGOWDA,GEN,MANDYA,33008,5,KNDP,6,M,KARNATAKA,857564,856067,1497,1198750,604908,593842,2.7540354535974974,33014,3.849741826849075
33,RAVIKEERTI C,SC,MANDYA,28468,3,BSP,28,M,KARNATAKA,857564,856067,1497,1198750,604908,593842,2.3771428571428572,28496,3.3229006814651734
56,M SHIVANNA,SC,CHAMARAJANAGAR (SC),316504,2,JD(S),157,M,KARNATAKA,853214,852745,469,1189973,603202,586771,26.610771841041768,316661,37.1139010846048
55,A SIDDARAJU,SC,CHAMARAJANAGAR (SC),272513,4,INC,159,M,KARNATAKA,853214,852745,469,1189973,603202,586771,22.914133345882636,272672,31.958219157210266
52,N CHAMARAJU,SC,CHAMARAJANAGAR (SC),91629,1,JD(U),87,M,KARNATAKA,853214,852745,469,1189973,603202,586771,7.7074017645778525,91716,10.749471996474506
43,N SHIVAMALLU,SC,CHAMARAJANAGAR (SC),78802,3,BSP,53,M,KARNATAKA,853214,852745,469,1189973,603202,586771,6.626620940138977,78855,9.242112764206869
65,MK KEMPASIDDAIAH,SC,CHAMARAJANAGAR (SC),35336,5,JP,1,M,KARNATAKA,853214,852745,469,1189973,603202,586771,2.969563174962793,35337,4.141633869111383
53,S PUTTANNA,SC,CHAMARAJANAGAR (SC),24463,8,IND,3,M,KARNATAKA,853214,852745,469,1189973,603202,586771,2.056013035589883,24466,2.86751037840448
64,N RANGASWAMY,SC,CHAMARAJANAGAR (SC),18898,7,USYP,3,M,KARNATAKA,853214,852745,469,1189973,603202,586771,1.5883553660461205,18901,2.215270729266046
50,MULLURU NAGARAJU,SC,CHAMARAJANAGAR (SC),14600,6,KNDP,6,M,KARNATAKA,853214,852745,469,1189973,603202,586771,1.2274228070720932,14606,1.7118800207216476
48,C H VIJAYASHANKAR,GEN,MYSORE,315977,2,BJP,465,M,KARNATAKA,957267,956548,719,1478718,750875,727843,21.399753029313228,316442,33.05681695911381
63,A S GURUSWAMY,GEN,MYSORE,306189,1,JD(S),103,M,KARNATAKA,957267,956548,719,1478718,750875,727843,20.713347643025916,306292,31.99650672174012
51,SRIKANTADATTA NARASIMHARAJA,GEN,MYSORE,299083,3,INC,144,M,KARNATAKA,957267,956548,719,1478718,750875,727843,20.23556891848209,299227,31.258468118090356
36,P N SRINATH,GEN,MYSORE,18957,5,IND,0,M,KARNATAKA,957267,956548,719,1478718,750875,727843,1.2819888579161138,18957,1.9803252384131074
54,KALIMULLA KHAN,GEN,MYSORE,16342,4,KNDP,7,M,KARNATAKA,957267,956548,719,1478718,750875,727843,1.1056198680208125,16349,1.7078829626426064
51,D V SADANANDA GOWDA,GEN,MANGALORE,383228,2,BJP,1532,M,KARNATAKA,791572,789575,1997,1101484,549464,552020,34.93105664721412,384760,48.607075540822564
64,M VEERAPPA MOILY,GEN,MANGALORE,350914,1,INC,431,M,KARNATAKA,791572,789575,1997,1101484,549464,552020,31.897422023379367,351345,44.385728651341886
68,A K SUBBAIAH,GEN,MANGALORE,39751,3,JD(S),23,M,KARNATAKA,791572,789575,1997,1101484,549464,552020,3.6109466864702533,39774,5.024685057076299
32,ROHIT KUMAR JOSHI,GEN,MANGALORE,15682,4,KNDP,11,M,KARNATAKA,791572,789575,1997,1101484,549464,552020,1.4247142945335567,15693,1.9825107507592488
64,MANORAMA MADHWARAJ,GEN,UDUPI,368507,2,BJP,1120,F,KARNATAKA,780356,778545,1811,1138398,546731,591667,32.46904861041569,369627,47.366458385659875
49,VINAYA KUMAR SORAKE,GEN,UDUPI,339956,3,INC,668,M,KARNATAKA,780356,778545,1811,1138398,546731,591667,29.921345610234734,340624,43.649821363582774
60,TARANATHA SHETTY KODAVOOR,GEN,UDUPI,45561,1,JD(S),13,M,KARNATAKA,780356,778545,1811,1138398,546731,591667,4.003345051554905,45574,5.840155006176668
41,OSWALD FERNANDIS,GEN,UDUPI,24521,4,KNDP,10,M,KARNATAKA,780356,778545,1811,1138398,546731,591667,2.154870265056685,24531,3.143565244580679
71,H D DEVEGOWDA,GEN,HASSAN,461391,2,JD(S),1234,M,KARNATAKA,912195,910103,2092,1292878,644305,648573,35.782571905469815,462625,50.71558164646813
78,H C SRIKANTAIAH ALIAS ANNAIAH,GEN,HASSAN,271807,4,INC,513,M,KARNATAKA,912195,910103,2092,1292878,644305,648573,21.063085612099517,272320,29.853266023163904
69,H N NANJEGOWDA,GEN,HASSAN,86735,3,JD(U),205,M,KARNATAKA,912195,910103,2092,1292878,644305,648573,6.7245323998087985,86940,9.530856889151991
47,AIJAZ AHMED FAROOQUI,GEN,HASSAN,52795,1,BSP,127,M,KARNATAKA,912195,910103,2092,1292878,644305,648573,4.093348328303212,52922,5.8016104012848135
48,KOVIBABANNA,GEN,HASSAN,22793,6,IND,2,M,KARNATAKA,912195,910103,2092,1292878,644305,648573,1.7631207275551133,22795,2.498917446379338
37,SIDDESH GOWDA,GEN,HASSAN,14582,5,KNDP,11,M,KARNATAKA,912195,910103,2092,1292878,644305,648573,1.1287221222729447,14593,1.5997675935518172
76,D C SRIKANTAPPA,GEN,CHIKMAGALUR,339924,3,BJP,1467,M,KARNATAKA,819254,817048,2206,1121327,558434,562893,30.44526708087828,341391,41.67095918970185
51,B L SHANKAR,GEN,CHIKMAGALUR,267294,2,INC,425,M,KARNATAKA,819254,817048,2206,1121327,558434,562893,23.875194301037965,267719,32.678387899235155
57,D K THARADEVI SIDDHARTHA,GEN,CHIKMAGALUR,172125,1,JD(S),302,F,KARNATAKA,819254,817048,2206,1121327,558434,562893,15.377048800216173,172427,21.046830409128304
61,H B SRIKANTA MURTHY,GEN,CHIKMAGALUR,16031,7,IND,4,M,KARNATAKA,819254,817048,2206,1121327,558434,562893,1.4300021314032392,16035,1.9572684417775197
33,S UMESHKUMAR,GEN,CHIKMAGALUR,10411,4,KNDP,3,M,KARNATAKA,819254,817048,2206,1121327,558434,562893,0.9287210599584242,10414,1.2711564423243586
35,B RUDRAIAH,SC,CHIKMAGALUR,5870,6,IND,5,M,KARNATAKA,819254,817048,2206,1121327,558434,562893,0.5239328046145326,5875,0.7171158151196089
42,U BABU MOGERA,SC,CHIKMAGALUR,5393,5,IND,0,M,KARNATAKA,819254,817048,2206,1121327,558434,562893,0.48094801962317857,5393,0.6582818027132
71,S BANGARAPPA,GEN,SHIMOGA,448648,2,BJP,1449,M,KARNATAKA,887290,885362,1928,1257953,636546,621407,35.780112611520465,450097,50.72715797540827
48,AYANUR MANJUNATH,GEN,SHIMOGA,373505,1,INC,447,M,KARNATAKA,887290,885362,1928,1257953,636546,621407,29.727024777555282,373952,42.14540905453685
72,G MADAPPA,GEN,SHIMOGA,21412,3,JD(S),10,M,KARNATAKA,887290,885362,1928,1257953,636546,621407,1.702925308020252,21422,2.4143177540601157
56,SACHIDEVI,GEN,SHIMOGA,18765,6,IND,3,F,KARNATAKA,887290,885362,1928,1257953,636546,621407,1.4919476323837217,18768,2.115204724498191
55,S DODDANNA,GEN,SHIMOGA,16265,5,JP,17,M,KARNATAKA,887290,885362,1928,1257953,636546,621407,1.2943249867045907,16282,1.8350257525724396
54,D M CHANDRAPPA,GEN,SHIMOGA,6767,4,KNDP,2,M,KARNATAKA,887290,885362,1928,1257953,636546,621407,0.5380964153668699,6769,0.7628847389241398
35,ANANTHKUMAR HEGDE,GEN,KANARA,431965,1,BJP,1209,M,KARNATAKA,833932,832123,1809,1207373,616079,591294,35.877396628879396,433174,51.94356374380645
62,ALVA MARGARET,GEN,KANARA,260447,2,INC,501,F,KARNATAKA,833932,832123,1809,1207373,616079,591294,21.612873569311223,260948,31.29128034420073
56,DEVARAYA NAIK G,GEN,KANARA,69429,3,JD(S),58,M,KARNATAKA,833932,832123,1809,1207373,616079,591294,5.755222288389752,69487,8.332453965071492
50,NEERNALLI RAMAKRISHN,GEN,KANARA,24206,5,JP,7,M,KARNATAKA,833932,832123,1809,1207373,616079,591294,2.0054283141995057,24213,2.9034741441748246
44,JAYANT MUKUND TINAIKAR,GEN,KANARA,19808,4,KNDP,32,M,KARNATAKA,833932,832123,1809,1207373,616079,591294,1.6432370112632964,19840,2.3790908611253676
34,MUTAGUPPI LAXMESH PUTTA,GEN,KANARA,17512,7,IND,1,M,KARNATAKA,833932,832123,1809,1207373,616079,591294,1.4505045251136144,17513,2.1000513231294637
70,AJEYA MADHAV SHANBHAG,GEN,KANARA,8756,6,IND,1,M,KARNATAKA,833932,832123,1809,1207373,616079,591294,0.7252936747798733,8757,1.0500856184916756
49,KUNNUR MANJUNATH CHANNAPPA,GEN,DHARWAD SOUTH,442146,1,BJP,613,M,KARNATAKA,864810,863896,914,1204353,624171,580182,36.76322473560493,442759,51.19725720100369
68,PROF I G SANADI,GEN,DHARWAD SOUTH,297362,3,INC,285,M,KARNATAKA,864810,863896,914,1204353,624171,580182,24.714265667956155,297647,34.41761774262555
39,PREMA SANGANABASANAGOUDA PATIL,GEN,DHARWAD SOUTH,76541,2,JD(S),14,F,KARNATAKA,864810,863896,914,1204353,624171,580182,6.356525038755248,76555,8.852233438558759
46,HOSAMANI MOHAMED HANEEF MEERASAB,GEN,DHARWAD SOUTH,23620,6,IND,0,M,KARNATAKA,864810,863896,914,1204353,624171,580182,1.9612190113695902,23620,2.7312357627687005
58,PATIL SHIDDANAGOUDA SIDDALINGAPPA,GEN,DHARWAD SOUTH,12337,5,KNDP,2,M,KARNATAKA,864810,863896,914,1204353,624171,580182,1.0245335047116584,12339,1.4267873868248517
33,DR SYED ROSHAN MULLA,GEN,DHARWAD SOUTH,11890,4,BSP,0,M,KARNATAKA,864810,863896,914,1204353,624171,580182,0.9872520764260977,11890,1.3748684682184527
42,PRALHAD JOSHI,GEN,DHARWAD NORTH,384621,1,BJP,463,M,KARNATAKA,810552,809816,736,1250578,642315,608263,30.792481556528262,385084,47.50885816085828
60,B S PATIL,GEN,DHARWAD NORTH,301782,2,INC,224,M,KARNATAKA,810552,809816,736,1250578,642315,608263,24.14931335750349,302006,37.259299835174055
50,SHAGOTI CHIKKAPPA NINGAPPA,GEN,DHARWAD NORTH,52549,4,JD(S),23,M,KARNATAKA,810552,809816,736,1250578,642315,608263,4.203816155409738,52572,6.485950315340657
58,JAGADGURU MATE MAHADEVI,GEN,DHARWAD NORTH,27596,6,KNDP,20,F,KARNATAKA,810552,809816,736,1250578,642315,608263,2.2082589010841387,27616,3.407060867162132
44,BADNI HEMARAJ ADIVEPPA,GEN,DHARWAD NORTH,16301,8,IND,0,M,KARNATAKA,810552,809816,736,1250578,642315,608263,1.3034772721093766,16301,2.011098609342769
41,BAKKAI LAXMAN CHANDRAPPA,SC,DHARWAD NORTH,12984,3,BSP,3,M,KARNATAKA,810552,809816,736,1250578,642315,608263,1.0384798069372723,12987,1.6022414354662007
43,KUSUGAL CHANNA BASAPPA,GEN,DHARWAD NORTH,8581,7,IND,1,M,KARNATAKA,810552,809816,736,1250578,642315,608263,0.6862426813841279,8582,1.0587846307207927
43,PROF ASHOK BADIGER,GEN,DHARWAD NORTH,5402,5,SP,2,M,KARNATAKA,810552,809816,736,1250578,642315,608263,0.43212018762524207,5404,0.6667061459351158
48,ANGADI SURESH CHANABASAPPA,GEN,BELGAUM,409743,2,BJP,1100,M,KARNATAKA,893902,892332,1570,1354182,685575,668607,30.338831855688525,410843,45.96063103114212
43,AMARSINH VASANTRAO PATIL,GEN,BELGAUM,325695,1,INC,395,M,KARNATAKA,893902,892332,1570,1354182,685575,668607,24.080219645512937,326090,36.479390358227185
60,JAMEELAHAMED REZA,GEN,BELGAUM,66810,3,JD(S),21,M,KARNATAKA,893902,892332,1570,1354182,685575,668607,4.935156426536462,66831,7.476322907880283
40,JADHAV DATTATREYA NARAYAN,GEN,BELGAUM,38982,7,IND,7,M,KARNATAKA,893902,892332,1570,1354182,685575,668607,2.8791550914131188,38989,4.361663806547027
71,BALASAHEB PATIL,GEN,BELGAUM,27819,4,SHS,34,M,KARNATAKA,893902,892332,1570,1354182,685575,668607,2.0568136336179332,27853,3.11588966128278
36,SIDNAL SHASHIKANT SHANMUKHAPPA,GEN,BELGAUM,12729,6,KNDP,11,M,KARNATAKA,893902,892332,1570,1354182,685575,668607,0.9407893473698513,12740,1.4252121597222067
52,V S SHAMASUNDAR GAEKWAD,GEN,BELGAUM,10554,5,USYP,2,M,KARNATAKA,893902,892332,1570,1354182,685575,668607,0.7795111735350196,10556,1.1808900751983997
52,JIGAJINAGI RAMESH CHANDAPPA,SC,CHIKKODI (SC),378590,4,BJP,990,M,KARNATAKA,838005,836452,1553,1184275,601433,582842,32.051677186464296,379580,45.295672460188186
42,GHATAGE S B,SC,CHIKKODI (SC),335610,3,INC,478,M,KARNATAKA,838005,836452,1553,1184275,601433,582842,28.37921935361297,336088,40.10572729279659
61,KHOKATE SHIVABAL RAMACHANDRA,SC,CHIKKODI (SC),66636,1,JD(S),35,M,KARNATAKA,838005,836452,1553,1184275,601433,582842,5.629689050262819,66671,7.955919117427699
46,M GOPINATH,SC,CHIKKODI (SC),29233,2,BSP,42,M,KARNATAKA,838005,836452,1553,1184275,601433,582842,2.4719765257224884,29275,3.4934159104062625
57,AVINASH DATTA KATTI,SC,CHIKKODI (SC),15526,6,IND,2,M,KARNATAKA,838005,836452,1553,1184275,601433,582842,1.3111819467606765,15528,1.8529722376358138
63,CHANDRAKANT RANOJI VINAYAK,SC,CHIKKODI (SC),10857,5,KNDP,6,M,KARNATAKA,838005,836452,1553,1184275,601433,582842,0.9172700597411919,10863,1.296292981545456
52,GADDIGOUDAR PARVATAGOUDA,GEN,BAGALKOT,457973,2,BJP,1478,M,KARNATAKA,868472,866238,2234,1324829,664623,660206,34.68002285577988,459451,52.90337512320489
71,PATIL R S,GEN,BAGALKOT,291422,3,INC,646,M,KARNATAKA,868472,866238,2234,1324829,664623,660206,22.045713069384803,292068,33.630099761420055
42,SANGLIKAR DHARAPPA SIDDAPPA,GEN,BAGALKOT,63991,4,JD(S),84,M,KARNATAKA,868472,866238,2234,1324829,664623,660206,4.836473235413778,64075,7.377900496504205
45,AARI NOORMOHD KASIMSAHAB,GEN,BAGALKOT,27997,1,BSP,12,M,KARNATAKA,868472,866238,2234,1324829,664623,660206,2.114159638715638,28009,3.2250895826232737
34,BASAVARAJ DEVARU,GEN,BAGALKOT,24855,5,KNDP,14,M,KARNATAKA,868472,866238,2234,1324829,664623,660206,1.8771479187125282,24869,2.8635350362475704
41,BASANAGOUDA R PATIL(YATNAL),GEN,BIJAPUR,344093,2,BJP,812,M,KARNATAKA,789734,788537,1197,1328325,679490,648835,25.965407562155345,344905,43.67356603615901
74,BASANAGOUDA SOMANAGOUDA PATIL,GEN,BIJAPUR,307068,3,INC,304,M,KARNATAKA,789734,788537,1197,1328325,679490,648835,23.139818944911823,307372,38.920953131054254
55,KHED NINGAPPA SIDDAPPA,GEN,BIJAPUR,137376,1,JD(S),81,M,KARNATAKA,789734,788537,1197,1328325,679490,648835,10.348145220484446,137457,17.405480832786736
59,P KARUNAKARAN,GEN,KASARAGOD,435195,1,CPM,2089,M,KERALA,901603,898311,3292,1160134,557500,602634,37.692542413203995,437284,48.50072592926155
66,N A MOHAMMED,GEN,KASARAGOD,328126,3,INC,902,M,KERALA,901603,898311,3292,1160134,557500,602634,28.361206550277814,329028,36.493667390192805
41,ADV V BALAKRISHNA SHETTY,GEN,KASARAGOD,110056,2,BJP,272,M,KERALA,901603,898311,3292,1160134,557500,602634,9.50993592119531,110328,12.236871438981458
33,P SIVANANDAN,GEN,KASARAGOD,7715,10,IND,11,M,KERALA,901603,898311,3292,1160134,557500,602634,0.6659575531792017,7726,0.8569181779563734
28,SUKUMARAN,ST,KASARAGOD,5943,4,BSP,4,M,KERALA,901603,898311,3292,1160134,557500,602634,0.5126131981305608,5947,0.6596029516317049
29,M A MOHAMMED,GEN,KASARAGOD,4646,9,IND,6,M,KERALA,901603,898311,3292,1160134,557500,602634,0.40098816171235385,4652,0.5159698891862604
53,JOSEPH KAITHAMATTAM,GEN,KASARAGOD,2110,8,IND,2,M,KERALA,901603,898311,3292,1160134,557500,602634,0.18204793584189413,2112,0.2342494423820684
37,ISMAIL ANDRUMAN,GEN,KASARAGOD,1592,7,IND,0,M,KERALA,901603,898311,3292,1160134,557500,602634,0.1372255273959732,1592,0.17657439028042277
41,ABBAS MUTHALAPPARA,GEN,KASARAGOD,1528,5,IND,3,M,KERALA,901603,898311,3292,1160134,557500,602634,0.13196751409750943,1531,0.1698086630146528
31,ASHRAF MANGAD,GEN,KASARAGOD,1400,6,IND,3,M,KERALA,901603,898311,3292,1160134,557500,602634,0.12093430586466736,1403,0.15561172711270924
36,A P ABDULLAKUTTY,GEN,CANNANORE,433010,1,CPM,2048,M,KERALA,860998,857497,3501,1088892,522202,566690,39.95419196761479,435058,50.52950181068946
60,MULLAPPALLY RAMACHANDRAN,GEN,CANNANORE,349911,2,INC,1298,M,KERALA,860998,857497,3501,1088892,522202,566690,32.25379560140032,351209,40.790919374957895
52,O K VASU MASTER,GEN,CANNANORE,47082,3,BJP,131,M,KERALA,860998,857497,3501,1088892,522202,566690,4.3358753668867065,47213,5.48352028692285
56,THOMAS MANNAKUZHI,GEN,CANNANORE,10291,6,IND,4,M,KERALA,860998,857497,3501,1088892,522202,566690,0.9454564823692341,10295,1.1957054487931447
36,SREERAMAN KOYYON,SC,CANNANORE,4757,9,IND,16,M,KERALA,860998,857497,3501,1088892,522202,566690,0.43833548230678526,4773,0.5543566884011345
53,SATHEESH KUMAR PAMBAN,GEN,CANNANORE,4274,10,IND,0,M,KERALA,860998,857497,3501,1088892,522202,566690,0.3925090826271109,4274,0.49640068850334146
55,GEORGE NJAVARAKKATTU,GEN,CANNANORE,3495,5,IND,1,M,KERALA,860998,857497,3501,1088892,522202,566690,0.3210603071746326,3496,0.4060404321496682
43,M RAMACHANDRAN,GEN,CANNANORE,2340,8,IND,2,M,KERALA,860998,857497,3501,1088892,522202,566690,0.21508101813586655,2342,0.2720099233679985
28,THEKKUMBATH ABDULLA,GEN,CANNANORE,1483,4,IND,1,M,KERALA,860998,857497,3501,1088892,522202,566690,0.13628532489907172,1484,0.17235812394453878
57,PALLIPRAM PRABHAKARAN,SC,CANNANORE,854,7,IND,0,M,KERALA,860998,857497,3501,1088892,522202,566690,0.078428347347579,854,0.09918722226997044
47,P SATHEEDEVI,GEN,BADAGARA,427589,3,CPM,1705,F,KERALA,828533,826054,2479,1092826,517429,575397,39.28292335650872,429294,51.81374791348081
61,M T PADMA,GEN,BADAGARA,298083,1,INC,622,F,KERALA,828533,826054,2479,1092826,517429,575397,27.33326256878954,298705,36.05227552795121
47,K P SREESAN,GEN,BADAGARA,81784,2,BJP,117,M,KERALA,828533,826054,2479,1092826,517429,575397,7.494422716882651,81901,9.885061910629993
43,K T KUNHIKANNAN,GEN,BADAGARA,7462,6,IND,20,M,KERALA,828533,826054,2479,1092826,517429,575397,0.6846469611813775,7482,0.9030418824597211
40,DR K N AJOYKUMAR,GEN,BADAGARA,7292,4,IND,14,M,KERALA,828533,826054,2479,1092826,517429,575397,0.6685419270771377,7306,0.8817995179431598
65,KALANDAN HAJE T K,GEN,BADAGARA,3844,5,IND,1,M,KERALA,828533,826054,2479,1092826,517429,575397,0.35184009165228497,3845,0.4640732475351012
66,M P VEERENDRA KUMAR,GEN,CALICUT,338932,4,JD(S),1179,M,KERALA,781184,779220,1964,1110149,540957,569192,30.636518161075678,340111,43.53788608061609
55,ADV V BALARAM,GEN,CALICUT,274209,1,INC,576,M,KERALA,781184,779220,1964,1110149,540957,569192,24.752082828521218,274785,35.17545162215304
32,M T RAMESH,GEN,CALICUT,97711,3,BJP,178,M,KERALA,781184,779220,1964,1110149,540957,569192,8.817645198977795,97889,12.530850606259216
50,A C VARKEY,GEN,CALICUT,33992,10,IND,13,M,KERALA,781184,779220,1964,1110149,540957,569192,3.06310234031648,34005,4.353007742094052
39,K VEERENDRA KUMAR,GEN,CALICUT,7159,11,IND,3,M,KERALA,781184,779220,1964,1110149,540957,569192,0.6451386255358514,7162,0.9168134524004588
54,DR D SURENDRANATH,GEN,CALICUT,6304,13,IND,2,M,KERALA,781184,779220,1964,1110149,540957,569192,0.5680318587865232,6306,0.8072361953137801
34,K ARUNKUMAR,GEN,CALICUT,4490,5,IND,0,M,KERALA,781184,779220,1964,1110149,540957,569192,0.4044502134398175,4490,0.5747685564476487
61,P BHARATHAN,SC,CALICUT,4009,2,BSP,5,M,KERALA,781184,779220,1964,1110149,540957,569192,0.36157308613528455,4014,0.5138354088153367
36,K BALARAM,GEN,CALICUT,3170,8,IND,3,M,KERALA,781184,779220,1964,1110149,540957,569192,0.28581748936404033,3173,0.406178313943962
26,BABU KARIMPADY,ST,CALICUT,2535,7,IND,4,M,KERALA,781184,779220,1964,1110149,540957,569192,0.2287080382903556,2539,0.3250194576437817
52,T K CHANDRAMATHI,SC,CALICUT,2301,6,IND,1,F,KERALA,781184,779220,1964,1110149,540957,569192,0.20735955263662806,2302,0.2946808946419794
55,M P SHANTHIVARMA JAIN,GEN,CALICUT,2223,12,IND,0,M,KERALA,781184,779220,1964,1110149,540957,569192,0.2002433907520522,2223,0.2845680403080452
69,A V K MOOSAD,GEN,CALICUT,2185,9,IND,0,M,KERALA,781184,779220,1964,1110149,540957,569192,0.1968204268075727,2185,0.27970362936260856
66,T K HAMZA,GEN,MANJERI,425167,4,CPM,1753,M,KERALA,907283,904535,2748,1262202,612925,649277,33.82342921339057,426920,47.05477783668381
53,K P A MAJEED,GEN,MANJERI,378312,3,MUL,865,M,KERALA,907283,904535,2748,1262202,612925,649277,30.040912627297374,379177,41.79258290963239
35,UMA UNNI,GEN,MANJERI,84027,2,BJP,122,F,KERALA,907283,904535,2748,1262202,612925,649277,6.6668409652337735,84149,9.274834864094224
40,ANWAR SHAKEEL OMAR,GEN,MANJERI,9208,5,IND,5,M,KERALA,907283,904535,2748,1262202,612925,649277,0.7299148630726302,9213,1.0154494242700458
25,ABDUL MUNEER C,GEN,MANJERI,7821,1,BSP,3,M,KERALA,907283,904535,2748,1262202,612925,649277,0.619869085930778,7824,0.8623549653195309
65,E AHAMMED,GEN,PONNANI,353731,2,MUL,320,M,KERALA,730339,729438,901,1172057,557292,614765,30.207660548932346,354051,48.477624774248675
36,P P SUNEER,GEN,PONNANI,250777,3,CPI,516,M,KERALA,730339,729438,901,1172057,557292,614765,21.440339505672508,251293,34.407720250459036
38,ARAVINDAN,GEN,PONNANI,71555,1,BJP,54,M,KERALA,730339,729438,901,1172057,557292,614765,6.109685791731971,71609,9.804898820958487
41,U KUNHI MUHAMED,GEN,PONNANI,45709,4,PDP,11,M,KERALA,730339,729438,901,1172057,557292,614765,3.900834174447147,45720,6.260106608027232
31,SALEEM VELIYANCODE,GEN,PONNANI,7666,5,IND,0,M,KERALA,730339,729438,901,1172057,557292,614765,0.6540637528720873,7666,1.0496495463065783
45,N N KRISHNADAS,GEN,PALGHAT,374011,2,CPM,1133,M,KERALA,820856,818853,2003,1113144,542428,570716,33.701300101334596,375144,45.70156032239516
62,V S VIJAYA RAGHAVAN,GEN,PALGHAT,276420,3,INC,566,M,KERALA,820856,818853,2003,1113144,542428,570716,24.88321367226522,276986,33.743555507908816
50,C UDAI BHASKER,GEN,PALGHAT,147493,1,BJP,299,M,KERALA,820856,818853,2003,1113144,542428,570716,13.276988421983141,147792,18.00461956786574
34,KRISHNADAS,GEN,PALGHAT,7636,7,IND,1,M,KERALA,820856,818853,2003,1113144,542428,570716,0.6860747576234522,7637,0.9303702476439228
55,M SUBRAMANIAN,SC,PALGHAT,5018,4,BSP,3,M,KERALA,820856,818853,2003,1113144,542428,570716,0.45106473196639424,5021,0.6116785404504566
39,K KUTTIKRISHNAN,SC,PALGHAT,5006,6,IND,0,M,KERALA,820856,818853,2003,1113144,542428,570716,0.44971719741560845,5006,0.609851179744072
56,AMBAZHAKODE VELAYUDHAN,GEN,PALGHAT,3269,5,CPI(ML)(L),1,M,KERALA,820856,818853,2003,1113144,542428,570716,0.2937625320713223,3270,0.3983646339918329
39,S AJAYA KUMAR,SC,OTTAPALAM (SC),395039,1,CPM,889,M,KERALA,806835,805465,1370,1092142,513919,578223,36.25242871348232,395928,49.0717432932384
30,K A THULASI,SC,OTTAPALAM (SC),325104,2,INC,414,F,KERALA,806835,805465,1370,1092142,513919,578223,29.805464857133963,325518,40.34505196229713
50,P K VELAYUDHAN,SC,OTTAPALAM (SC),68134,4,BJP,59,M,KERALA,806835,805465,1370,1092142,513919,578223,6.243968275187658,68193,8.451913960103367
27,K AJAYAN,SC,OTTAPALAM (SC),9306,5,IND,1,M,KERALA,806835,805465,1370,1092142,513919,578223,0.8521785628608733,9307,1.1535196167741857
44,M VELAYUDHAN,SC,OTTAPALAM (SC),7882,3,BSP,7,M,KERALA,806835,805465,1370,1092142,513919,578223,0.722341966520837,7889,0.9777711675869293
65,C K CHANDRAPPAN,GEN,TRICHUR,319932,1,CPI,1028,M,KERALA,687705,686108,1597,990733,466350,524383,32.39621573118085,320960,46.67117441344762
67,A C JOSE,GEN,TRICHUR,274503,2,INC,496,M,KERALA,687705,686108,1597,990733,466350,524383,27.757125279969475,274999,39.98793087152195
63,P S SREERAMAN,GEN,TRICHUR,72042,4,BJP,66,M,KERALA,687705,686108,1597,990733,466350,524383,7.278247519765668,72108,10.485309834885598
37,M P RENJITH,GEN,TRICHUR,8779,8,IND,1,M,KERALA,687705,686108,1597,990733,466350,524383,0.8862125315296856,8780,1.2767102173170182
43,PROVIND P N,GEN,TRICHUR,4994,7,IND,3,M,KERALA,687705,686108,1597,990733,466350,524383,0.504374034174697,4997,0.7266196988534328
39,A K SIVARATNAN,SC,TRICHUR,2935,3,BSP,0,M,KERALA,687705,686108,1597,990733,466350,524383,0.2962453052436933,2935,0.4267818323263609
47,OUSEPH ANTO,GEN,TRICHUR,1703,5,JD(U),1,M,KERALA,687705,686108,1597,990733,466350,524383,0.17199386716703693,1704,0.2477806617663097
57,ABDUL MAJEED MASTER,GEN,TRICHUR,1220,6,IND,2,M,KERALA,687705,686108,1597,990733,466350,524383,0.12334301976415442,1222,0.177692469881708
68,LONAPPAN NAMBADAN,GEN,MUKUNDAPURAM,373770,4,CPM,1405,M,KERALA,723009,721208,1801,1024150,496412,527738,36.63281745838012,375175,51.890778676337355
43,PADMAJA VENUGOPAL,GEN,MUKUNDAPURAM,257729,1,INC,349,F,KERALA,723009,721208,1801,1024150,496412,527738,25.199238392813548,258078,35.69499134865541
64,PROF MATHEW PAILEE,GEN,MUKUNDAPURAM,62300,3,BJP,38,M,KERALA,723009,721208,1801,1024150,496412,527738,6.086803690865596,62338,8.622022685748034
44,RANI JOSE,GEN,MUKUNDAPURAM,7997,8,IND,2,F,KERALA,723009,721208,1801,1024150,496412,527738,0.781037933896402,7999,1.1063486070021258
35,SABU ALI,GEN,MUKUNDAPURAM,7070,7,IND,1,M,KERALA,723009,721208,1801,1024150,496412,527738,0.6904262070985695,7071,0.9779961245295702
64,D R PISHARODY,GEN,MUKUNDAPURAM,6019,5,IND,1,M,KERALA,723009,721208,1801,1024150,496412,527738,0.5878045208221452,6020,0.8326314056948116
33,ADV T K MANOJ,SC,MUKUNDAPURAM,4373,2,BSP,4,M,KERALA,723009,721208,1801,1024150,496412,527738,0.4273788019333105,4377,0.6053866549379053
46,MOHAMMED ASHARAF,GEN,MUKUNDAPURAM,1950,6,IND,1,M,KERALA,723009,721208,1801,1024150,496412,527738,0.19049943855880486,1951,0.2698444970947803
56,DR SEBASTIAN PAUL,GEN,ERNAKULAM,322255,9,IND,787,M,KERALA,658916,657891,1025,1069131,525442,543689,30.215380528672352,323042,49.02627952576656
46,DR EDWARD EDEZHATH,GEN,ERNAKULAM,252744,1,INC,199,M,KERALA,658916,657891,1025,1069131,525442,543689,23.658747150723343,252943,38.387745934231376
68,O G THANKAPPAN,GEN,ERNAKULAM,60663,2,BJP,34,M,KERALA,658916,657891,1025,1069131,525442,543689,5.67722758015622,60697,9.211644579885752
33,ADV T B MINI,GEN,ERNAKULAM,10418,8,IND,0,F,KERALA,658916,657891,1025,1069131,525442,543689,0.9744362477563554,10418,1.581081655324806
52,P S GANGADHARAN,GEN,ERNAKULAM,6182,4,IND,3,M,KERALA,658916,657891,1025,1069131,525442,543689,0.5785072175439679,6185,0.9386628948151207
38,THANKAPPAN,SC,ERNAKULAM,1835,5,IND,0,M,KERALA,658916,657891,1025,1069131,525442,543689,0.171634720160579,1835,0.27848769797667683
37,NAUSHAD MATHER,GEN,ERNAKULAM,1717,7,IND,1,M,KERALA,658916,657891,1025,1069131,525442,543689,0.1606912529895775,1718,0.2607312616479187
68,T E THOMAS,GEN,ERNAKULAM,1101,6,IND,1,M,KERALA,658916,657891,1025,1069131,525442,543689,0.10307436600379186,1102,0.16724438319907242
66,MUNAMBAM HAMZA,GEN,ERNAKULAM,976,3,JD(U),0,M,KERALA,658916,657891,1025,1069131,525442,543689,0.09128909366579026,976,0.1481220671527175
53,P C THOMAS (PULLOLIL),GEN,MUVATTUPUZHA,255982,3,IFDP,429,M,KERALA,745871,744192,1679,984053,493309,490744,26.05662499885677,256411,34.377392337280845
51,ADV P M ISMAIL,GEN,MUVATTUPUZHA,254965,1,CPM,917,M,KERALA,745871,744192,1679,984053,493309,490744,26.002867731717703,255882,34.3064685448288
39,JOSE K MANI,GEN,MUVATTUPUZHA,209554,2,KEC(M),326,M,KERALA,745871,744192,1679,984053,493309,490744,21.328119522017616,209880,28.13891410176827
37,P P SANTHOSH,SC,MUVATTUPUZHA,4603,16,IND,0,M,KERALA,745871,744192,1679,984053,493309,490744,0.46775935848983746,4603,0.617130844341716
69,K N RAJASEKHARAN NAIR,GEN,MUVATTUPUZHA,3155,15,IND,1,M,KERALA,745871,744192,1679,984053,493309,490744,0.32071443306407277,3156,0.42312946876872815
61,ADV P C THOMAS (PEEDIAKKAL),GEN,MUVATTUPUZHA,3116,11,IND,2,M,KERALA,745871,744192,1679,984053,493309,490744,0.316852852437826,3118,0.41803475399901596
44,K T MATHEW,GEN,MUVATTUPUZHA,2220,14,IND,0,M,KERALA,745871,744192,1679,984053,493309,490744,0.2255976050070474,2220,0.29763859970423845
57,P C THOMAS (PAZHIYANKAL),GEN,MUVATTUPUZHA,2071,10,IND,0,M,KERALA,745871,744192,1679,984053,493309,490744,0.21045614413044825,2071,0.2776619549493143
56,P APPUKKUTTAN,GEN,MUVATTUPUZHA,1998,4,IND,3,M,KERALA,745871,744192,1679,984053,493309,490744,0.20334270613473057,2001,0.2682769540577392
43,ISMAIL,GEN,MUVATTUPUZHA,1481,5,IND,0,M,KERALA,745871,744192,1679,984053,493309,490744,0.15050002388082756,1481,0.19855980457746716
27,MAHIN BADUSHA MOULAVY,GEN,MUVATTUPUZHA,1449,12,IND,0,M,KERALA,745871,744192,1679,984053,493309,490744,0.1472481665113566,1449,0.19426951845560425
25,P A ISMAIL,GEN,MUVATTUPUZHA,1246,7,IND,0,M,KERALA,745871,744192,1679,984053,493309,490744,0.12661919632377525,1246,0.16705301587003651
60,A M ISMAIL,GEN,MUVATTUPUZHA,842,6,IND,0,M,KERALA,745871,744192,1679,984053,493309,490744,0.08556449703420446,842,0.11288815358151745
67,K M MANI,GEN,MUVATTUPUZHA,647,13,IND,0,M,KERALA,745871,744192,1679,984053,493309,490744,0.06574849118899084,647,0.08674422252641543
39,JOHNY MANI,GEN,MUVATTUPUZHA,557,8,IND,0,M,KERALA,745871,744192,1679,984053,493309,490744,0.05660264233735378,557,0.07467779280867604
28,JOSE JOSEPH,GEN,MUVATTUPUZHA,306,9,IND,1,M,KERALA,745871,744192,1679,984053,493309,490744,0.031197506638361957,307,0.041159932481622155
48,K SURESH KURUP,GEN,KOTTAYAM,339697,4,CPM,1516,M,KERALA,705776,703376,2400,963886,478098,485788,35.399725693702365,341213,48.34579243272653
47,ANTO ANTONY,GEN,KOTTAYAM,297545,1,INC,754,M,KERALA,705776,703376,2400,963886,478098,485788,30.94753943931129,298299,42.26539298587654
39,B RADHAKRISHNA MENON,GEN,KOTTAYAM,52919,3,BJP,115,M,KERALA,705776,703376,2400,963886,478098,485788,5.502102945784046,53034,7.514282151844211
60,ADVOCATE JACOB JOHN,GEN,KOTTAYAM,5229,2,BSP,4,M,KERALA,705776,703376,2400,963886,478098,485788,0.5429065262904534,5233,0.7414533789757657
37,MINI K PHILIP,GEN,KOTTAYAM,2890,8,IND,7,F,KERALA,705776,703376,2400,963886,478098,485788,0.30055421491753176,2897,0.4104701775067444
41,JOSE AMBATTU,GEN,KOTTAYAM,2484,5,JD(U),0,M,KERALA,705776,703376,2400,963886,478098,485788,0.25770682425100067,2484,0.35195302758949015
34,M K DASAN,SC,KOTTAYAM,1350,7,IND,2,M,KERALA,705776,703376,2400,963886,478098,485788,0.14026555007542385,1352,0.19156219537076918
60,KUNJU PAZHANTHATTIL,GEN,KOTTAYAM,1262,6,IND,2,M,KERALA,705776,703376,2400,963886,478098,485788,0.13113583971548504,1264,0.1790936501099499
49,K FRANCIS GEORGE,GEN,IDUKKI,352961,2,KEC,944,M,KERALA,729426,727964,1462,1034338,515211,519127,34.2156045702662,353905,48.518286981818584
51,BENNY BEHANAN,GEN,IDUKKI,284101,3,INC,420,M,KERALA,729426,727964,1462,1034338,515211,519127,27.50754588925477,284521,39.00615004126532
51,S T B MOHANDAS,GEN,IDUKKI,58234,4,BJP,56,M,KERALA,729426,727964,1462,1034338,515211,519127,5.635488592703739,58290,7.9912150101586725
33,C K JANU,ST,IDUKKI,11588,7,IND,40,F,KERALA,729426,727964,1462,1034338,515211,519127,1.1241973126772873,11628,1.5941301790723117
38,VIJAYAN,SC,IDUKKI,7379,9,IND,0,M,KERALA,729426,727964,1462,1034338,515211,519127,0.7134031622158328,7379,1.0116173539193831
57,T C THANKAPPAN,SC,IDUKKI,5071,1,BSP,2,M,KERALA,729426,727964,1462,1034338,515211,519127,0.4904586315111694,5073,0.6954783624384105
34,P R SURESH KUMAR,SC,IDUKKI,2750,10,IND,0,M,KERALA,729426,727964,1462,1034338,515211,519127,0.26587053748387857,2750,0.3770087712804315
32,ARAVINDAN,SC,IDUKKI,2464,5,IND,0,M,KERALA,729426,727964,1462,1034338,515211,519127,0.23822000158555523,2464,0.33779985906726656
34,ASHRAF,GEN,IDUKKI,2195,6,IND,0,M,KERALA,729426,727964,1462,1034338,515211,519127,0.21221302900985944,2195,0.300921546531108
50,DR T A BABU,GEN,IDUKKI,1221,8,IND,0,M,KERALA,729426,727964,1462,1034338,515211,519127,0.11804651864284207,1221,0.16739189444851157
39,DR K S MANOJ,GEN,ALLEPPEY,334408,2,CPM,1086,M,KERALA,730096,728125,1971,971154,468073,503081,34.545911359063545,335494,45.95203918388815
55,V M SUDHEERAN,GEN,ALLEPPEY,333678,3,INC,807,M,KERALA,730096,728125,1971,971154,468073,503081,34.44201434581951,334485,45.813838180184526
59,ADVOCATE V PADMANABHAN,GEN,ALLEPPEY,43821,1,BJP,70,M,KERALA,730096,728125,1971,971154,468073,503081,4.519468590975273,43891,6.011675176963029
33,V S SUDHEERAN,GEN,ALLEPPEY,8281,8,IND,1,M,KERALA,730096,728125,1971,971154,468073,503081,0.8527998649029916,8282,1.1343713703403389
58,KURIAN,GEN,ALLEPPEY,2642,4,JD(U),0,M,KERALA,730096,728125,1971,971154,468073,503081,0.2720474816558445,2642,0.36187021980671036
57,V I BOSE,SC,ALLEPPEY,2290,7,IND,1,M,KERALA,730096,728125,1971,971154,468073,503081,0.23590491312397416,2291,0.31379435033201114
36,PARTHASARATHY VARMA,GEN,ALLEPPEY,2018,6,IND,6,M,KERALA,730096,728125,1971,971154,468073,503081,0.20841184817238048,2024,0.27722381714185534
53,T A KRISHNANKUTTY,SC,ALLEPPEY,987,5,IND,0,M,KERALA,730096,728125,1971,971154,468073,503081,0.10163166706825075,987,0.13518770134338498
38,C S SUJATHA,GEN,MAVELIKARA,277268,4,CPM,1013,F,KERALA,644614,642816,1798,871592,407826,463766,31.92789745660814,278281,43.17017626052181
47,RAMESH CHENNITHALA,GEN,MAVELIKARA,270233,2,INC,634,M,KERALA,644614,642816,1798,871592,407826,463766,31.077270098853592,270867,42.020030591951155
63,S KRISHNAKUMAR,GEN,MAVELIKARA,82875,1,BJP,138,M,KERALA,644614,642816,1798,871592,407826,463766,9.524295771415984,83013,12.877939355955656
33,ADV SAJI K CHERAMAN,GEN,MAVELIKARA,4909,3,BSP,9,M,KERALA,644614,642816,1798,871592,407826,463766,0.5642548348309759,4918,0.7629371996264431
58,ADV V C ZACHARIAH,GEN,MAVELIKARA,2987,5,SLAP,0,M,KERALA,644614,642816,1798,871592,407826,463766,0.34270622034162773,2987,0.4633780836283419
37,S RADHAMANI,GEN,MAVELIKARA,2351,8,IND,2,F,KERALA,644614,642816,1798,871592,407826,463766,0.26996576379774023,2353,0.36502465041094356
55,DR K KISHOREKUMAR,GEN,MAVELIKARA,1298,7,IND,0,M,KERALA,644614,642816,1798,871592,407826,463766,0.14892289052676022,1298,0.20136081437883757
32,R KAVITHA,SC,MAVELIKARA,895,6,IND,2,F,KERALA,644614,642816,1798,871592,407826,463766,0.10291512542565788,897,0.1391530435268238
36,CHENGARA SURENDRAN,SC,ADOOR (SC),330750,4,CPI,1466,M,KERALA,684434,682233,2201,960122,451859,508263,34.601436067499755,332216,48.538792637420116
41,KODIKUNNIL SURESH,SC,ADOOR (SC),277071,1,INC,611,M,KERALA,684434,682233,2201,960122,451859,508263,28.921532888528752,277682,40.57104118147257
52,P M VELAYUDHAN,SC,ADOOR (SC),61789,3,BJP,118,M,KERALA,684434,682233,2201,960122,451859,508263,6.4478264220588635,61907,9.044991920331253
49,P K REMANAN,SC,ADOOR (SC),4597,6,IND,6,M,KERALA,684434,682233,2201,960122,451859,508263,0.47941824059859056,4603,0.6725264963458858
34,ACHANKOVIL RAJAN,SC,ADOOR (SC),4541,2,BSP,0,M,KERALA,684434,682233,2201,960122,451859,508263,0.4729607279074951,4541,0.6634679165558696
33,SOMAN PAMPAYIKODE,SC,ADOOR (SC),3485,5,RLD,0,M,KERALA,684434,682233,2201,960122,451859,508263,0.3629747052978684,3485,0.509179847874302
53,P RAJENDRAN,GEN,QUILON,353200,2,CPM,2079,M,KERALA,705482,702388,3094,1031593,490115,541478,34.43984206949834,355279,50.35975404049997
55,SOORANAD RAJASEKHARAN,GEN,QUILON,243415,3,INC,793,M,KERALA,705482,702388,3094,1031593,490115,541478,23.67290200689613,244208,34.61576624208697
42,ADV KIZHAKKANELA SUDHAKARAN,GEN,QUILON,62096,4,BJP,87,M,KERALA,705482,702388,3094,1031593,490115,541478,6.0278617633116935,62183,8.81425748637102
34,KOLLOORVILA NASIMUDEEN,GEN,QUILON,26415,5,IND,8,M,KERALA,705482,702388,3094,1031593,490115,541478,2.561378373059918,26423,3.745382589492007
48,ADV S PRAHALADAN,GEN,QUILON,6224,1,BSP,8,M,KERALA,705482,702388,3094,1031593,490115,541478,0.6041142194644593,6232,0.8833676833710853
57,K P VISWAVALSALAN,GEN,QUILON,4809,7,IND,110,M,KERALA,705482,702388,3094,1031593,490115,541478,0.47683534106958847,4919,0.6972537924426138
35,SHYLA K JOHN,GEN,QUILON,3371,9,IND,7,F,KERALA,705482,702388,3094,1031593,490115,541478,0.32745472293821304,3378,0.4788215716347122
58,SIVAPRASAD RAGHAVAN,SC,QUILON,1603,8,IND,0,M,KERALA,705482,702388,3094,1031593,490115,541478,0.15539074034042494,1603,0.2272205385821325
44,K R MEENA,SC,QUILON,1255,6,IND,2,F,KERALA,705482,702388,3094,1031593,490115,541478,0.12185038091572936,1257,0.17817605551948879
76,VARKALA RADHAKRISHNAN,GEN,CHIRAYINKIL,312678,3,CPM,937,M,KERALA,669639,668280,1359,1020604,471620,548984,30.72837261072855,313615,46.833443093965556
52,M I SHANAVAS,GEN,CHIRAYINKIL,262525,4,INC,345,M,KERALA,669639,668280,1359,1020604,471620,548984,25.756316847670597,262870,39.25547944489494
42,ADVOCATE J R PADMAKUMAR,GEN,CHIRAYINKIL,71911,1,BJP,71,M,KERALA,669639,668280,1359,1020604,471620,548984,7.052882410807718,71982,10.74937391639376
41,DR P D RAJAN,SC,CHIRAYINKIL,6818,2,BSP,3,M,KERALA,669639,668280,1359,1020604,471620,548984,0.6683297341574205,6821,1.0186085338518216
32,A ANSARI,GEN,CHIRAYINKIL,4756,5,IND,0,M,KERALA,669639,668280,1359,1020604,471620,548984,0.4659985655552986,4756,0.7102334242778572
46,SANTHINAGAR SOMAN,SC,CHIRAYINKIL,3204,11,IND,0,M,KERALA,669639,668280,1359,1020604,471620,548984,0.31393175021849806,3204,0.4784667559685144
40,M MURALI KUMAR,GEN,CHIRAYINKIL,1662,9,IND,1,M,KERALA,669639,668280,1359,1020604,471620,548984,0.16294272803163617,1663,0.24834276378765274
37,B PADMAKUMAR,SC,CHIRAYINKIL,1448,8,IND,0,M,KERALA,669639,668280,1359,1020604,471620,548984,0.14187677101010773,1448,0.21623591218552085
71,M B THANKAPPAN,SC,CHIRAYINKIL,1406,6,IND,0,M,KERALA,669639,668280,1359,1020604,471620,548984,0.13776156080125102,1406,0.20996387605859276
57,SREENIVASA DAS,GEN,CHIRAYINKIL,1140,10,IND,1,M,KERALA,669639,668280,1359,1020604,471620,548984,0.11179654400727414,1141,0.17039031478154648
49,P DEVARAJAN,SC,CHIRAYINKIL,732,7,IND,1,M,KERALA,669639,668280,1359,1020604,471620,548984,0.0718202162640946,733,0.10946196383424502
78,P K VASUDEVAN NAIR,GEN,TRIVANDRUM,284545,3,CPI,1512,M,KERALA,763829,760622,3207,1112571,539461,573110,25.711347860046686,286057,37.450397929379484
43,V S SIVAKUMAR,GEN,TRIVANDRUM,230840,4,INC,614,M,KERALA,763829,760622,3207,1112571,539461,573110,20.803526246864244,231454,30.30180838905043
74,O RAJAGOPAL,GEN,TRIVANDRUM,226986,1,BJP,1066,M,KERALA,763829,760622,3207,1112571,539461,573110,20.49774800889112,228052,29.85642074338628
42,ADV K S RAJMOHAN,SC,TRIVANDRUM,3823,2,BSP,8,M,KERALA,763829,760622,3207,1112571,539461,573110,0.3443375748603909,3831,0.5015520489533652
55,ADV G MURALEEDHARAN NADAR,GEN,TRIVANDRUM,3037,13,IND,0,M,KERALA,763829,760622,3207,1112571,539461,573110,0.2729713429524947,3037,0.3976020810940669
69,SELVARAJ,GEN,TRIVANDRUM,2479,15,IND,1,M,KERALA,763829,760622,3207,1112571,539461,573110,0.22290712233196805,2480,0.3246800003665742
31,V S GIREESH KUMAR,GEN,TRIVANDRUM,2158,5,AKMDMP,0,M,KERALA,763829,760622,3207,1112571,539461,573110,0.19396514919047864,2158,0.2825239680609142
47,ADV B K RAJAGOPAL,GEN,TRIVANDRUM,1555,14,IND,3,M,KERALA,763829,760622,3207,1112571,539461,573110,0.14003600669080896,1558,0.20397235506900102
54,BABINGTON,GEN,TRIVANDRUM,1349,12,IND,1,M,KERALA,763829,760622,3207,1112571,539461,573110,0.1213405706242568,1350,0.1767411292318045
41,CHERIAN V T,GEN,TRIVANDRUM,1122,6,IND,0,M,KERALA,763829,760622,3207,1112571,539461,573110,0.1008474964743823,1122,0.1468915162948775
38,FRANCIS ALBERT,GEN,TRIVANDRUM,873,10,IND,0,M,KERALA,763829,760622,3207,1112571,539461,573110,0.07846690233701939,873,0.11429259690323358
45,ADV V PRATAP SINGH,GEN,TRIVANDRUM,617,9,IND,0,M,KERALA,763829,760622,3207,1112571,539461,573110,0.055457134870493655,617,0.08077724202668397
70,T C BALAKRISHNAN NAIR,GEN,TRIVANDRUM,532,11,IND,2,M,KERALA,763829,760622,3207,1112571,539461,573110,0.047996936824706016,534,0.06991093556280266
60,ADV I JUSTUS NADAR,GEN,TRIVANDRUM,382,7,IND,0,M,KERALA,763829,760622,3207,1112571,539461,573110,0.03433488739145636,382,0.050011193604851345
42,NOUSHAD,GEN,TRIVANDRUM,324,8,IND,0,M,KERALA,763829,760622,3207,1112571,539461,573110,0.02912173694982163,324,0.04241787101563308
34,ASHOK CHHAVIRAM ARGAL,SC,MORENA (SC),260939,1,BJP,398,M,MADHYA PRADESH,487443,486871,572,1434889,782368,652521,18.21304644470757,261337,53.613858440884364
48,BARELAL JATAV,SC,MORENA (SC),113919,3,INC,98,M,MADHYA PRADESH,487443,486871,572,1434889,782368,652521,7.946050182278908,114017,23.390837492794027
52,DR PRITAM PRASAD CHAUDHARY,SC,MORENA (SC),86074,2,BSP,63,M,MADHYA PRADESH,487443,486871,572,1434889,782368,652521,6.003042744072887,86137,17.6711943755475
61,DR K L RAY ( KISHANLAL),SC,MORENA (SC),9718,5,SMSP,5,M,MADHYA PRADESH,487443,486871,572,1434889,782368,652521,0.6776133903040583,9723,1.994694764310904
52,SHANKAR LAL MOURYA,SC,MORENA (SC),5606,4,SP,0,M,MADHYA PRADESH,487443,486871,572,1434889,782368,652521,0.39069224169953215,5606,1.1500831892139183
43,RAM DAYAL KORI,SC,MORENA (SC),3875,11,IND,5,M,MADHYA PRADESH,487443,486871,572,1434889,782368,652521,0.2704041915437361,3880,0.795990505556547
36,RAJESH JATAV,SC,MORENA (SC),1723,10,IND,0,M,MADHYA PRADESH,487443,486871,572,1434889,782368,652521,0.12007897474996324,1723,0.35347722708091
38,DR RAMESH CHANDRA ARGAL,SC,MORENA (SC),1643,9,IND,1,M,MADHYA PRADESH,487443,486871,572,1434889,782368,652521,0.11457332239636654,1644,0.3372702039007638
44,HAKIM NAGAR,SC,MORENA (SC),1327,7,LJNSP,2,M,MADHYA PRADESH,487443,486871,572,1434889,782368,652521,0.09262040478392405,1329,0.27264726337233275
33,"SHANKAR SINGH "" SAKHAWAR""",SC,MORENA (SC),1143,6,JD(S),0,M,MADHYA PRADESH,487443,486871,572,1434889,782368,652521,0.07965772962229134,1143,0.23448895563173539
29,AJAY KUMAR,SC,MORENA (SC),904,8,IND,0,M,MADHYA PRADESH,487443,486871,572,1434889,782368,652521,0.06300138895761274,904,0.18545758170698934
52,DR RAMLAKHAN SINGH,GEN,BHIND,234542,2,BJP,170,M,MADHYA PRADESH,606358,606013,345,1388299,753090,635209,16.906444505110212,234712,38.70848574604442
47,SATYADEV KATARE,GEN,BHIND,227629,4,INC,137,M,MADHYA PRADESH,606358,606013,345,1388299,753090,635209,16.406120007289495,227766,37.56295785657978
42,PHOOLSINGH BARAIYA,SC,BHIND,59663,6,SMSP,16,M,MADHYA PRADESH,606358,606013,345,1388299,753090,635209,4.298713749703774,59679,9.842205429795598
66,RAMSINGH DHAKRE,GEN,BHIND,43805,3,BSP,17,M,MADHYA PRADESH,606358,606013,345,1388299,753090,635209,3.1565246391447372,43822,7.227083670043109
68,NARENDRA SINGH BHADORIA ( DADDY),GEN,BHIND,17941,1,SP,2,M,MADHYA PRADESH,606358,606013,345,1388299,753090,635209,1.2924449272094845,17943,2.9591429485551437
60,LT COLONEL ( RETIRED) SHIVNATH SINGH,GEN,BHIND,4286,15,IND,1,M,MADHYA PRADESH,606358,606013,345,1388299,753090,635209,0.3087951514767352,4287,0.7070080711394918
54,SHAMBHOODAYAL BAGHEL ADVOCATE,GEN,BHIND,4262,7,LSWP,2,M,MADHYA PRADESH,606358,606013,345,1388299,753090,635209,0.3071384478415673,4264,0.7032149324326553
30,ASHOK KUMAR JATAV,SC,BHIND,3183,5,NLP,0,M,MADHYA PRADESH,606358,606013,345,1388299,753090,635209,0.22927337698867462,3183,0.5249374132113371
40,SHANTOSH SINGH,GEN,BHIND,2482,14,IND,0,M,MADHYA PRADESH,606358,606013,345,1388299,753090,635209,0.1787799314124695,2482,0.4093291421899274
28,DR RAMKUMAR TRIPATHI ( SEETI),GEN,BHIND,1830,13,IND,0,M,MADHYA PRADESH,606358,606013,345,1388299,753090,635209,0.1318159848851004,1830,0.3018019058048216
29,MANOJ SINGH,GEN,BHIND,1679,12,IND,0,M,MADHYA PRADESH,606358,606013,345,1388299,753090,635209,0.12093936536725879,1679,0.27689912559906854
28,PRADEEP,GEN,BHIND,1561,11,IND,0,M,MADHYA PRADESH,606358,606013,345,1388299,753090,635209,0.11243975541291897,1561,0.2574386748422549
28,CHAUDHARI ARUN KUMAR,GEN,BHIND,1149,8,IND,0,M,MADHYA PRADESH,606358,606013,345,1388299,753090,635209,0.08276315116556304,1149,0.1894920162676175
30,NARENDRA SINGH,GEN,BHIND,1102,10,IND,0,M,MADHYA PRADESH,606358,606013,345,1388299,753090,635209,0.0793777133023938,1102,0.18174081977973408
39,"ASHOK "" SHARMA""",GEN,BHIND,899,9,IND,0,M,MADHYA PRADESH,606358,606013,345,1388299,753090,635209,0.064755502957216,899,0.14826224771504623
52,RAMSEVAK SINGH ( BABUJI),GEN,GWALIOR,246419,4,INC,48,M,MADHYA PRADESH,564692,564497,195,1381464,742390,639074,17.841000561722925,246467,43.64627088749265
46,JAIBHAN SINGH PAWAIYA,GEN,GWALIOR,210469,2,BJP,134,M,MADHYA PRADESH,564692,564497,195,1381464,742390,639074,15.244914091138098,210603,37.295198090286384
40,SUKHLAL KUSHWAH,GEN,GWALIOR,40636,6,RSMD,3,M,MADHYA PRADESH,564692,564497,195,1381464,742390,639074,2.9417342761012955,40639,7.196666501384826
33,MADAN KUSHWAH,GEN,GWALIOR,30397,3,BSP,8,M,MADHYA PRADESH,564692,564497,195,1381464,742390,639074,2.2009259741839093,30405,5.3843511152982515
50,KHYALIRAM BAGHEL,GEN,GWALIOR,18624,1,SP,1,M,MADHYA PRADESH,564692,564497,195,1381464,742390,639074,1.348207408951663,18625,3.2982581655132357
39,RAM AUTAR,GEN,GWALIOR,6236,10,IND,0,M,MADHYA PRADESH,564692,564497,195,1381464,742390,639074,0.45140517595825874,6236,1.10431881450419
54,PD KAILASH NARAYAN SHARMA,GEN,GWALIOR,3786,5,ABHM,0,M,MADHYA PRADESH,564692,564497,195,1381464,742390,639074,0.27405708726394606,3786,0.6704539819937241
29,PREMVATI KUSHWAH,GEN,GWALIOR,3561,8,IND,0,F,MADHYA PRADESH,564692,564497,195,1381464,742390,639074,0.2577700178940602,3561,0.6306092524774568
57,BALDEV PRASAD CHAKKIWALE,SC,GWALIOR,2245,9,IND,0,M,MADHYA PRADESH,564692,564497,195,1381464,742390,639074,0.16250875882397225,2245,0.397561856728978
66,ANAND DIXIT,GEN,GWALIOR,2124,7,IND,1,M,MADHYA PRADESH,564692,564497,195,1381464,742390,639074,0.15382232182669978,2125,0.37631133432030206
32,JYOTIRADITYA MADHAVRAO SCINDIA,GEN,GUNA,333800,2,INC,154,M,MADHYA PRADESH,668393,667948,445,1422045,758620,663425,23.484066959906333,333954,49.96371894977955
57,HARIVALLABH SHUKLA,GEN,GUNA,247319,4,BJP,275,M,MADHYA PRADESH,668393,667948,445,1422045,758620,663425,17.411122714119454,247594,37.04317669395101
31,RAMVILAS KIRAR,GEN,GUNA,26367,3,BSP,13,M,MADHYA PRADESH,668393,667948,445,1422045,758620,663425,1.855074909725079,26380,3.946779813672495
32,USHA YADAV,GEN,GUNA,21288,1,SP,3,F,MADHYA PRADESH,668393,667948,445,1422045,758620,663425,1.49721000390283,21291,3.185401403066759
41,LAXMANSINGH DHAKAD SUJWAYAWALE,GEN,GUNA,12554,11,IND,0,M,MADHYA PRADESH,668393,667948,445,1422045,758620,663425,0.8828131317925946,12554,1.878236307082809
38,RAJEEV GUPTA,GEN,GUNA,5937,10,IND,0,M,MADHYA PRADESH,668393,667948,445,1422045,758620,663425,0.4174973365821757,5937,0.8882498769436544
35,HARBANSINGH KOLI,SC,GUNA,5795,5,RLD,0,M,MADHYA PRADESH,668393,667948,445,1422045,758620,663425,0.4075117172803955,5795,0.8670048908351822
50,JADO ADIWASI,ST,GUNA,5168,8,IND,0,M,MADHYA PRADESH,668393,667948,445,1422045,758620,663425,0.3634202855746478,5168,0.7731978042858019
31,MAHESH KUMAR ( M K ) BUDDA,GEN,GUNA,4239,9,IND,0,M,MADHYA PRADESH,668393,667948,445,1422045,758620,663425,0.29809183253694505,4239,0.6342077191113612
39,CHARANDAS JATAV,SC,GUNA,3083,7,IND,0,M,MADHYA PRADESH,668393,667948,445,1422045,758620,663425,0.2168004528689317,3083,0.4612555786790107
46,OMPRAKASH ( O P BHAIYA),GEN,GUNA,2398,6,IND,0,M,MADHYA PRADESH,668393,667948,445,1422045,758620,663425,0.1686303879272456,2398,0.35877096259236707
50,VIRENDRA KUMAR,SC,SAGAR (SC),290818,4,BJP,156,M,MADHYA PRADESH,479443,479246,197,1250751,673869,576882,23.263943023031764,290974,60.690009031313416
55,UTTAM KHATIK,SC,SAGAR (SC),142954,1,INC,29,M,MADHYA PRADESH,479443,479246,197,1250751,673869,576882,11.431771791507662,142983,29.822731795020474
30,NARESH AHIRWAR,SC,SAGAR (SC),17142,2,BSP,8,M,MADHYA PRADESH,479443,479246,197,1250751,673869,576882,1.3711761973406378,17150,3.5770675554758333
33,POORAN,SC,SAGAR (SC),7592,8,IND,0,M,MADHYA PRADESH,479443,479246,197,1250751,673869,576882,0.6069953172134182,7592,1.5835041913220134
43,NATHURAM AHIRWAR,SC,SAGAR (SC),6512,5,AD,1,M,MADHYA PRADESH,479443,479246,197,1250751,673869,576882,0.5207271471300042,6513,1.358451369610152
40,VIJAY SHANKAR GOWA,SC,SAGAR (SC),6348,7,GGP,3,M,MADHYA PRADESH,479443,479246,197,1250751,673869,576882,0.5077749288227633,6351,1.3246621600482227
48,PARVATI AHIRWAR,SC,SAGAR (SC),5201,3,SP,0,F,MADHYA PRADESH,479443,479246,197,1250751,673869,576882,0.41583016923432403,5201,1.084800487232059
43,RAMNARAYAN CHOUDHRY,SC,SAGAR (SC),2679,6,SSJP,0,M,MADHYA PRADESH,479443,479246,197,1250751,673869,576882,0.21419131385863374,2679,0.5587734099778284
61,"DR RAMKRISHNA KUSHMARIYA "" BABA JEE """,GEN,KHAJURAHO,332069,3,BJP,389,M,MADHYA PRADESH,772442,771830,612,1552876,831514,721362,21.40917883977858,332458,43.03986577633013
54,"SATYAVRAT CHATURVEDI "" VINOD BHAIYA """,GEN,KHAJURAHO,220507,4,INC,170,M,MADHYA PRADESH,772442,771830,612,1552876,831514,721362,14.210857789031447,220677,28.56874690915305
51,ASHOK VIR VIKRAM SINGH ( BHAIYA RAJA ),GEN,KHAJURAHO,117607,1,SP,32,M,MADHYA PRADESH,772442,771830,612,1552876,831514,721362,7.575556580177683,117639,15.229492958694632
43,AD BRIJMOHAN KUSHWAHA,GEN,KHAJURAHO,39176,2,BSP,18,M,MADHYA PRADESH,772442,771830,612,1552876,831514,721362,2.523961990525966,39194,5.074037921293767
42,VINOD,GEN,KHAJURAHO,22510,11,IND,1,M,MADHYA PRADESH,772442,771830,612,1552876,831514,721362,1.4496328103467373,22511,2.9142641130337292
27,PATEL RAMESHWAR,GEN,KHAJURAHO,10692,8,IND,0,M,MADHYA PRADESH,772442,771830,612,1552876,831514,721362,0.6885288973491767,10692,1.384181595511378
27,KASHIRAM,GEN,KHAJURAHO,7332,5,IND,0,M,MADHYA PRADESH,772442,771830,612,1552876,831514,721362,0.4721561798881559,7332,0.9491974801991605
40,RAMKISHORE KUSHWAH,GEN,KHAJURAHO,7257,9,IND,2,M,MADHYA PRADESH,772442,771830,612,1552876,831514,721362,0.4674552250147468,7259,0.9397469324557702
42,RAMPRASAD,SC,KHAJURAHO,6401,10,IND,0,M,MADHYA PRADESH,772442,771830,612,1552876,831514,721362,0.41220290609166477,6401,0.8286706315814003
54,DASAI ( DASAIYA ),GEN,KHAJURAHO,4707,7,IND,0,M,MADHYA PRADESH,772442,771830,612,1552876,831514,721362,0.30311499437173345,4707,0.6093661401114905
42,KUSHWAHA KARAN,GEN,KHAJURAHO,3572,6,IND,0,M,MADHYA PRADESH,772442,771830,612,1552876,831514,721362,0.23002480558653748,3572,0.4624295416354885
47,CHANDRABHAN BHAIYA,GEN,DAMOH,271734,2,BJP,135,M,MADHYA PRADESH,591218,591038,180,1398539,740413,658126,19.439500793327895,271869,45.98456068658262
40,TILAK SINGH LODHI,GEN,DAMOH,177246,3,INC,28,M,MADHYA PRADESH,591218,591038,180,1398539,740413,658126,12.675656524415837,177274,29.984540389500996
43,KUNVAR VIJAY BAHADUR SINGH BUNDELA,GEN,DAMOH,40235,5,SP,6,M,MADHYA PRADESH,591218,591038,180,1398539,740413,658126,2.8773598734107524,40241,6.806457178232056
40,RAMKISHORE YADAV,GEN,DAMOH,37138,4,BSP,9,M,MADHYA PRADESH,591218,591038,180,1398539,740413,658126,2.6561290031954776,37147,6.283130757182629
29,ANIL TIWARI,GEN,DAMOH,26116,1,CPI,0,M,MADHYA PRADESH,591218,591038,180,1398539,740413,658126,1.8673773130388212,26116,4.4173215294527575
41,MAKUNDIRAM KUSHWAHA,GEN,DAMOH,14229,9,IND,1,M,MADHYA PRADESH,591218,591038,180,1398539,740413,658126,1.0174903953339878,14230,2.4068955951950044
58,DASHRATH SINGH LODHI,GEN,DAMOH,13116,6,GGP,1,M,MADHYA PRADESH,591218,591038,180,1398539,740413,658126,0.9379073447361854,13117,2.218640163188536
28,DEO RAJ AHIRWAR,SC,DAMOH,6868,8,IND,0,M,MADHYA PRADESH,591218,591038,180,1398539,740413,658126,0.49108390970863164,6868,1.1616696379338924
33,ASHOK BHARTI SUMAN,SC,DAMOH,4356,7,IND,0,M,MADHYA PRADESH,591218,591038,180,1398539,740413,658126,0.31146789614018633,4356,0.7367840627315136
42,GANESH SINGH,GEN,SATNA,239117,1,BJP,589,M,MADHYA PRADESH,610602,609727,875,1324818,689758,635060,18.093504164345592,239706,39.25732310080871
53,"RAJENDRA KUMAR SINGH "" DADA BHAI""",GEN,SATNA,155955,4,INC,161,M,MADHYA PRADESH,610602,609727,875,1324818,689758,635060,11.783958249359534,156116,25.567554642795145
30,KU NARENDRA SINGH,GEN,SATNA,78644,2,BSP,43,M,MADHYA PRADESH,610602,609727,875,1324818,689758,635060,5.93945734432956,78687,12.886790413395305
42,NARAYAN TRIPATHI,GEN,SATNA,50778,3,SP,63,M,MADHYA PRADESH,610602,609727,875,1324818,689758,635060,3.83758372848195,50841,8.326372989279433
41,JUG LAL KOL,ST,SATNA,47069,5,RSMD,15,M,MADHYA PRADESH,610602,609727,875,1324818,689758,635060,3.55399760570886,47084,7.711078574914593
27,SUNIL,GEN,SATNA,17957,13,IND,0,M,MADHYA PRADESH,610602,609727,875,1324818,689758,635060,1.3554314630386965,17957,2.9408681923740834
66,VANSH GOPAL,GEN,SATNA,4986,12,IND,0,M,MADHYA PRADESH,610602,609727,875,1324818,689758,635060,0.3763535821524164,4986,0.8165711871235273
37,RAMROOP PATEL,GEN,SATNA,3223,11,IND,3,M,MADHYA PRADESH,610602,609727,875,1324818,689758,635060,0.24350514561245393,3226,0.5283310568913957
60,RAMESH PRASAD,GEN,SATNA,3118,10,IND,0,M,MADHYA PRADESH,610602,609727,875,1324818,689758,635060,0.23535308246113804,3118,0.510643594354424
30,BED PRAKASH PANDEY,GEN,SATNA,2620,9,IND,0,M,MADHYA PRADESH,610602,609727,875,1324818,689758,635060,0.19776301348562597,2620,0.4290847393228322
26,RAVENDRA PRATAP,GEN,SATNA,2618,6,AD,1,M,MADHYA PRADESH,610602,609727,875,1324818,689758,635060,0.1976875314194101,2619,0.428920966521564
42,MOHD KHALIL,GEN,SATNA,2170,8,IND,0,M,MADHYA PRADESH,610602,609727,875,1324818,689758,635060,0.16379608368847645,2170,0.3553869787521168
31,ASHOK KUMAR PANDEY,GEN,SATNA,1472,7,IND,0,M,MADHYA PRADESH,610602,609727,875,1324818,689758,635060,0.1111096014697868,1472,0.24107356346687367
56,CHANDRAMANI TRIPATHI,GEN,REWA,231732,2,BJP,289,M,MADHYA PRADESH,630747,630272,475,1461014,760309,700705,15.880819759427355,232021,36.785113524122984
31,PRADEEP KUMAR PATEL,GEN,REWA,187208,3,BSP,61,M,MADHYA PRADESH,630747,630272,475,1461014,760309,700705,12.817741650661802,187269,29.690034197546716
47,SUNDAR LAL TIWARI,GEN,REWA,145786,4,INC,121,M,MADHYA PRADESH,630747,630272,475,1461014,760309,700705,9.986694172677332,145907,23.13241283747683
39,INDRABHAN YADAV,GEN,REWA,17921,1,SP,0,M,MADHYA PRADESH,630747,630272,475,1461014,760309,700705,1.2266138449049768,17921,2.841234282525323
29,DR RAMSAKHA VERMA,SC,REWA,10537,12,IND,0,M,MADHYA PRADESH,630747,630272,475,1461014,760309,700705,0.7212114326077642,10537,1.6705588770140802
32,SHIVNARAYAN KOL,ST,REWA,7429,7,AD,1,M,MADHYA PRADESH,630747,630272,475,1461014,760309,700705,0.5085509105320004,7430,1.1779683454697367
48,VIMALA SONDHIYA,GEN,REWA,7051,6,LJNSP,2,F,MADHYA PRADESH,630747,630272,475,1461014,760309,700705,0.4827469141295018,7053,1.118197946244691
32,ENGINEER MEWALAL SAKET,SC,REWA,6219,11,IND,0,M,MADHYA PRADESH,630747,630272,475,1461014,760309,700705,0.4256632722205263,6219,0.9859737739537405
56,K P GUPTA,GEN,REWA,5930,5,JD(S),1,M,MADHYA PRADESH,630747,630272,475,1461014,760309,700705,0.4059509354462038,5931,0.9403136281266499
42,ISHWARDEEN KORI,SC,REWA,4547,10,IND,0,M,MADHYA PRADESH,630747,630272,475,1461014,760309,700705,0.31122220594737626,4547,0.7208912606797971
39,HARISH KUMAR TIWARI,GEN,REWA,3422,9,GGP,0,M,MADHYA PRADESH,630747,630272,475,1461014,760309,700705,0.23422089042267905,3422,0.542531316042724
45,MD SIDDIQUE ANSARI,GEN,REWA,2490,8,SAP,0,M,MADHYA PRADESH,630747,630272,475,1461014,760309,700705,0.17042957836132988,2490,0.39477001079672197
45,CHANDRAPRATAP SINGH,ST,SIDHI (ST),210074,1,BJP,124,M,MADHYA PRADESH,457209,457032,177,1083701,564542,519159,19.396309498653228,210198,45.974160613636215
38,TILAKRAJ SINGH,ST,SIDHI (ST),160589,2,INC,44,M,MADHYA PRADESH,457209,457032,177,1083701,564542,519159,14.822630965552305,160633,35.13338538830163
57,PATIRAJ,ST,SIDHI (ST),32918,3,SP,4,M,MADHYA PRADESH,457209,457032,177,1083701,564542,519159,3.0379228218853727,32922,7.200645656581563
34,DR HARIKRISHNA PRASAD PANIKA,ST,SIDHI (ST),17534,4,BSP,5,M,MADHYA PRADESH,457209,457032,177,1083701,564542,519159,1.6184353433280951,17539,3.836101214105584
57,GURUPRASAD,ST,SIDHI (ST),13543,8,IND,0,M,MADHYA PRADESH,457209,457032,177,1083701,564542,519159,1.2496989483261527,13543,2.962102670769823
77,DALPRATAP SINGH,ST,SIDHI (ST),9998,6,GGP,0,M,MADHYA PRADESH,457209,457032,177,1083701,564542,519159,0.922579198505861,9998,2.1867461051729076
25,KHOOBCHAND MAJHI,ST,SIDHI (ST),7633,7,IND,0,M,MADHYA PRADESH,457209,457032,177,1083701,564542,519159,0.7043455713337904,7633,1.669477197517984
59,KALICHARAN,ST,SIDHI (ST),4743,5,SVSP,0,M,MADHYA PRADESH,457209,457032,177,1083701,564542,519159,0.43766684722077404,4743,1.037381153914293
53,DALPAT SINGH PARASTE,ST,SHAHDOL (ST),209876,2,BJP,158,M,MADHYA PRADESH,509340,509124,216,1305252,671395,633857,16.09145207209029,210034,41.23650214002434
44,RAJESH NANDANI SINGH,ST,SHAHDOL (ST),180638,5,INC,47,F,MADHYA PRADESH,509340,509124,216,1305252,671395,633857,13.842920753999993,180685,35.4743393411081
28,RAMLAL,ST,SHAHDOL (ST),25762,6,BSP,2,M,MADHYA PRADESH,509340,509124,216,1305252,671395,633857,1.973871712129152,25764,5.058310755094829
32,THANESHWAR SINGH DHURVE,ST,SHAHDOL (ST),24220,8,GGP,7,M,MADHYA PRADESH,509340,509124,216,1305252,671395,633857,1.8561166732554326,24227,4.756547689166372
47,CHHOTELAL SINGH,ST,SHAHDOL (ST),18850,1,SP,2,M,MADHYA PRADESH,509340,509124,216,1305252,671395,633857,1.4443187982090815,18852,3.70126045470609
36,BHUPAL DAS KULDEEP,ST,SHAHDOL (ST),17346,4,CPI,0,M,MADHYA PRADESH,509340,509124,216,1305252,671395,633857,1.3289387796379548,17346,3.4055836965484745
38,MANSINGH SEMALIYA,ST,SHAHDOL (ST),16869,9,AD,0,M,MADHYA PRADESH,509340,509124,216,1305252,671395,633857,1.2923941124012834,16869,3.3119330898810224
45,BUDDHSEN SINGH,ST,SHAHDOL (ST),9936,3,CPM,0,M,MADHYA PRADESH,509340,509124,216,1305252,671395,633857,0.7612323137601015,9936,1.9507598068088112
32,ANAND PRATAP SINGH,ST,SHAHDOL (ST),5627,7,LJNSP,0,M,MADHYA PRADESH,509340,509124,216,1305252,671395,633857,0.43110449169968706,5627,1.1047630266619546
52,GAURI SHANKAR CHATURBHUJ BISEN,GEN,BALAGHAT,193719,3,BJP,263,M,MADHYA PRADESH,609321,608865,456,1000341,500140,500201,19.391587468673183,193982,31.835764728279507
47,KANKAR MUNJARE,GEN,BALAGHAT,105853,5,JP,40,M,MADHYA PRADESH,609321,608865,456,1000341,500140,500201,10.585690279614651,105893,17.378852854242673
40,HIRASAN UIKEY,ST,BALAGHAT,97147,8,GGP,50,F,MADHYA PRADESH,609321,608865,456,1000341,500140,500201,9.716386712131163,97197,15.951690488264806
45,PUSHPA BISEN,GEN,BALAGHAT,85104,4,INC,38,F,MADHYA PRADESH,609321,608865,456,1000341,500140,500201,8.511297647502202,85142,13.97325875851973
53,UDAYSINGH PANCHESHWAR,GEN,BALAGHAT,72332,1,BSP,59,M,MADHYA PRADESH,609321,608865,456,1000341,500140,500201,7.236632308382841,72391,11.880601522022054
72,DR BHIKKHOO R D K PRAGYASHEEL,SC,BALAGHAT,16486,10,IND,0,M,MADHYA PRADESH,609321,608865,456,1000341,500140,500201,1.6480380190355088,16486,2.7056346326484726
38,KISHOR SAMRITE,GEN,BALAGHAT,15514,2,SP,2,M,MADHYA PRADESH,609321,608865,456,1000341,500140,500201,1.5510710847600968,15516,2.5464410384674085
40,GOVARDHAN S/O KUNWARLAL MOHARE,GEN,BALAGHAT,8903,6,RLD,2,M,MADHYA PRADESH,609321,608865,456,1000341,500140,500201,0.8901964430129327,8905,1.4614628414251274
27,SIDDHARTH GAJBHIYE ( ADHIVAKTA ),SC,BALAGHAT,7416,7,RPI,2,M,MADHYA PRADESH,609321,608865,456,1000341,500140,500201,0.7415471324278421,7418,1.2174207027166306
35,DHANESHAWAR LILHARE,GEN,BALAGHAT,6391,9,IND,0,M,MADHYA PRADESH,609321,608865,456,1000341,500140,500201,0.6388821411898542,6391,1.0488724334135866
42,FAGGAN SINGH KULASTE,ST,MANDLA (ST),238010,2,BJP,63,M,MADHYA PRADESH,588269,588178,91,1095134,547160,547974,21.739166165966907,238073,40.47009106378204
70,HEERA SINGH MARKAM,ST,MANDLA (ST),173159,5,GGP,17,M,MADHYA PRADESH,588269,588178,91,1095134,547160,547974,15.81322468300683,173176,29.438233189238254
40,SAVITRI DHUMKETI,ST,MANDLA (ST),99887,4,INC,11,F,MADHYA PRADESH,588269,588178,91,1095134,547160,547974,9.121988724667483,99898,16.981686949337803
42,INDER SINGH UIKEY,ST,MANDLA (ST),22708,1,BSP,0,M,MADHYA PRADESH,588269,588178,91,1095134,547160,547974,2.073536206528151,22708,3.8601388140459556
48,SHAMBHU LAL MARAVI,ST,MANDLA (ST),21239,9,IND,0,M,MADHYA PRADESH,588269,588178,91,1095134,547160,547974,1.9393973705500878,21239,3.610423122755066
33,BARATI LAL MASRAM,ST,MANDLA (ST),10677,8,IND,0,M,MADHYA PRADESH,588269,588178,91,1095134,547160,547974,0.974949184300734,10677,1.8149860013021255
35,MANOJ GOTHIYA,ST,MANDLA (ST),9467,3,SP,0,M,MADHYA PRADESH,588269,588178,91,1095134,547160,547974,0.8644604221949095,9467,1.6092977872367913
53,KISHAN LAL KARYAM,ST,MANDLA (ST),6692,6,IND,0,M,MADHYA PRADESH,588269,588178,91,1095134,547160,547974,0.611066773563783,6692,1.137574816962988
52,CHAMBAL SINGH MARAVI,ST,MANDLA (ST),6339,7,IND,0,M,MADHYA PRADESH,588269,588178,91,1095134,547160,547974,0.578833275197373,6339,1.077568255338969
42,RAKESH SINGH,GEN,JABALPUR,311563,2,BJP,83,M,MADHYA PRADESH,571395,571290,105,1347885,710919,636966,23.121111964299626,311646,54.54125429869004
64,VISHWANATH DUBEY,GEN,JABALPUR,212097,4,INC,18,M,MADHYA PRADESH,571395,571290,105,1347885,710919,636966,15.736876662326535,212115,37.12230593547371
35,BRAJ KISHORE KEWAT ( MANJHI),GEN,JABALPUR,16943,1,BSP,3,M,MADHYA PRADESH,571395,571290,105,1347885,710919,636966,1.2572289178972984,16946,2.9657242362988825
45,SWAMI SURESH VERMA,GEN,JABALPUR,6857,14,IND,0,M,MADHYA PRADESH,571395,571290,105,1347885,710919,636966,0.5087229251753673,6857,1.2000455026732821
47,RAJESH DIXIT,GEN,JABALPUR,5528,3,SP,0,M,MADHYA PRADESH,571395,571290,105,1347885,710919,636966,0.41012400909573143,5528,0.9674568380892378
60,SHAIL BHARTI,GEN,JABALPUR,4595,13,IND,0,F,MADHYA PRADESH,571395,571290,105,1347885,710919,636966,0.34090445401499386,4595,0.8041722451194007
43,AD SUNIL SHUKLA,GEN,JABALPUR,3682,5,GGP,1,M,MADHYA PRADESH,571395,571290,105,1347885,710919,636966,0.2732428953508645,3683,0.644562868068499
33,BHAI RAKESH ( PRAMUKH DHAI AKSHAR),SC,JABALPUR,2858,11,IND,0,M,MADHYA PRADESH,571395,571290,105,1347885,710919,636966,0.21203589326982641,2858,0.5001793855389004
35,RIYAZ KHAN,GEN,JABALPUR,2718,12,IND,0,M,MADHYA PRADESH,571395,571290,105,1347885,710919,636966,0.20164925049243812,2718,0.47567794607933217
63,ADVOCATE PREM PRAKASH AMBEDKAR,SC,JABALPUR,1324,10,IND,0,M,MADHYA PRADESH,571395,571290,105,1347885,710919,636966,0.09822796455187201,1324,0.23171361317477404
45,GURUCHARAN SINGH BEDI ( TEETU BHAI ),GEN,JABALPUR,1073,8,IND,0,M,MADHYA PRADESH,571395,571290,105,1347885,710919,636966,0.07960619785812588,1073,0.18778603242940523
31,PRAVEEN,GEN,JABALPUR,864,9,IND,0,M,MADHYA PRADESH,571395,571290,105,1347885,710919,636966,0.06410042399759623,864,0.15120888352190692
71,PT SURAJ PRASAD MISHR ( RTD SHI ),GEN,JABALPUR,640,6,SVSP,0,M,MADHYA PRADESH,571395,571290,105,1347885,710919,636966,0.04748179555377499,640,0.11200658038659772
28,ARVIND MAHOBIYA,GEN,JABALPUR,548,7,IND,0,M,MADHYA PRADESH,571395,571290,105,1347885,710919,636966,0.04065628744291983,548,0.09590563445602429
41,NEETA PATERIYA,GEN,SEONI,267608,3,BJP,587,F,MADHYA PRADESH,599553,598745,808,1203918,620115,583803,22.276849419977108,268195,44.73249237348491
44,KALYANI PANDEY,GEN,SEONI,173259,1,INC,135,F,MADHYA PRADESH,599553,598745,808,1203918,620115,583803,14.402475916133822,173394,28.920545806625935
36,RAJESHWARI UIKEY,ST,SEONI,102958,6,GGP,73,F,MADHYA PRADESH,599553,598745,808,1203918,620115,583803,8.55797487868775,103031,17.1846358870692
54,DR L K DESHBHARTAR,SC,SEONI,15811,2,BSP,9,M,MADHYA PRADESH,599553,598745,808,1203918,620115,583803,1.3140429829938582,15820,2.638632447840308
30,DEVENDRA DAHERIYA ADVOCATE,SC,SEONI,14615,9,IND,1,M,MADHYA PRADESH,599553,598745,808,1203918,620115,583803,1.2140361718987505,14616,2.437816173048921
50,"AHMAD SHAEED QURESHI "" ADVOCATE """,GEN,SEONI,7497,8,IND,2,M,MADHYA PRADESH,599553,598745,808,1203918,620115,583803,0.6228829538224364,7499,1.2507651533725959
34,HARI PRASAD SANODIYA,GEN,SEONI,6623,7,RLD,0,M,MADHYA PRADESH,599553,598745,808,1203918,620115,583803,0.550120523158554,6623,1.104656302278531
37,SAWITRI RAO,GEN,SEONI,6305,4,SP,0,F,MADHYA PRADESH,599553,598745,808,1203918,620115,583803,0.5237067640819392,6305,1.0516167878402742
25,GANPAT JHARIYA,SC,SEONI,4069,5,RPI(A),1,M,MADHYA PRADESH,599553,598745,808,1203918,620115,583803,0.3380628913264857,4070,0.6788390684393206
57,KAMALNATH,GEN,CHHINDWARA,307819,1,INC,744,M,MADHYA PRADESH,754637,752439,2198,1145107,589756,555351,26.946215506498522,308563,40.8889307044314
44,PRAHLAD SINGH PATEL,GEN,CHHINDWARA,243642,4,BJP,1213,M,MADHYA PRADESH,754637,752439,2198,1145107,589756,555351,21.38271794688182,244855,32.44672604179228
41,MAN MOHAN SHAH BATTI,ST,CHHINDWARA,85117,6,GGP,213,M,MADHYA PRADESH,754637,752439,2198,1145107,589756,555351,7.4517053864835345,85330,11.30742330418466
32,DHANRAJ,SC,CHHINDWARA,23403,16,IND,0,M,MADHYA PRADESH,754637,752439,2198,1145107,589756,555351,2.043739144027589,23403,3.101226152441505
25,SUNIL YUVNATI,ST,CHHINDWARA,9234,27,IND,0,M,MADHYA PRADESH,754637,752439,2198,1145107,589756,555351,0.8063875253578924,9234,1.2236346746846496
28,NARESH IVANATI,ST,CHHINDWARA,8812,17,IND,0,M,MADHYA PRADESH,754637,752439,2198,1145107,589756,555351,0.7695350740149174,8812,1.1677137484644935
27,SACHIN SADSHIV,GEN,CHHINDWARA,8268,26,IND,0,M,MADHYA PRADESH,754637,752439,2198,1145107,589756,555351,0.7220285964543052,8268,1.0956261089768988
40,DALCHAND PAL,GEN,CHHINDWARA,7098,3,BSP,19,M,MADHYA PRADESH,754637,752439,2198,1145107,589756,555351,0.6215139720567597,7117,0.9431024452816387
33,DINESH SAHU,GEN,CHHINDWARA,7087,13,IND,1,M,MADHYA PRADESH,754637,752439,2198,1145107,589756,555351,0.6189814576279772,7088,0.9392595380295428
38,JAYDEEP ALIAS DEEPA YADAV,GEN,CHHINDWARA,6422,2,SP,0,F,MADHYA PRADESH,754637,752439,2198,1145107,589756,555351,0.5608209538497275,6422,0.8510051852745094
29,DWARKA PRASAD PAHADE,SC,CHHINDWARA,5498,15,IND,0,M,MADHYA PRADESH,754637,752439,2198,1145107,589756,555351,0.48012980446368764,5498,0.728562209380139
48,DILIP RAMRAO THAKRE,GEN,CHHINDWARA,5263,14,IND,2,M,MADHYA PRADESH,754637,752439,2198,1145107,589756,555351,0.45978236094967545,5265,0.6976864373201951
68,AMART LAL RAGHUWAR,GEN,CHHINDWARA,5136,5,SVSP,2,M,MADHYA PRADESH,754637,752439,2198,1145107,589756,555351,0.4486916943132825,5138,0.6808571538368778
50,JAGADESH KAOYALARE,SC,CHHINDWARA,3974,12,IND,0,M,MADHYA PRADESH,754637,752439,2198,1145107,589756,555351,0.3470418048269725,3974,0.5266108075803333
28,MUKESH WADIWA,ST,CHHINDWARA,3177,20,IND,0,M,MADHYA PRADESH,754637,752439,2198,1145107,589756,555351,0.2774413220773255,3177,0.42099711516928007
32,GORU PRASAD DHURVE,ST,CHHINDWARA,2864,10,IND,0,M,MADHYA PRADESH,754637,752439,2198,1145107,589756,555351,0.25010763186322327,2864,0.379520219655278
35,GANGARAM,SC,CHHINDWARA,2376,11,IND,0,M,MADHYA PRADESH,754637,752439,2198,1145107,589756,555351,0.20749152699267404,2376,0.3148533665855239
40,LAXMI WASNIK,SC,CHHINDWARA,2352,7,RPI(A),4,F,MADHYA PRADESH,754637,752439,2198,1145107,589756,555351,0.20574496531765152,2356,0.3122030857220094
26,LAXMIPRASAD BANSKAR,SC,CHHINDWARA,2253,24,IND,0,M,MADHYA PRADESH,754637,752439,2198,1145107,589756,555351,0.19675017269128564,2253,0.29855413927490965
63,SHALIGRAM SIDAM,ST,CHHINDWARA,2232,25,IND,0,M,MADHYA PRADESH,754637,752439,2198,1145107,589756,555351,0.19491628293251198,2232,0.2957713443682194
29,BIRESH MARASCOLA,ST,CHHINDWARA,1600,18,IND,0,M,MADHYA PRADESH,754637,752439,2198,1145107,589756,555351,0.1397249340018007,1600,0.21202246908116087
29,KRISHNA KANOJE,SC,CHHINDWARA,1557,9,IND,0,M,MADHYA PRADESH,754637,752439,2198,1145107,589756,555351,0.1359698264005023,1557,0.20632436522460468
75,BHARAT LAL DEHARIYA,SC,CHHINDWARA,1552,19,IND,0,M,MADHYA PRADESH,754637,752439,2198,1145107,589756,555351,0.13553318598174668,1552,0.20566179500872603
28,AADIL KHAN,GEN,CHHINDWARA,1498,8,IND,0,M,MADHYA PRADESH,754637,752439,2198,1145107,589756,555351,0.1308174694591859,1498,0.19850603667723687
47,RAM KUMAR PANDRAM,ST,CHHINDWARA,1483,23,IND,0,M,MADHYA PRADESH,754637,752439,2198,1145107,589756,555351,0.12950754820291904,1483,0.19651832602960098
58,RAMKISHAN PAL,GEN,CHHINDWARA,1387,22,IND,0,M,MADHYA PRADESH,754637,752439,2198,1145107,589756,555351,0.12112405216281098,1387,0.18379697788473134
35,"RAJENDRA ZHOD "" BABLU """,SC,CHHINDWARA,1335,21,IND,0,M,MADHYA PRADESH,754637,752439,2198,1145107,589756,555351,0.11658299180775246,1335,0.1769062476395936
68,KHANDELWAL VIJAY KUMAR (MUNNI BHAIA),GEN,BETUL,287710,1,BJP,297,M,MADHYA PRADESH,547702,547321,381,1122830,581447,541383,25.650098412048127,288007,52.58461718233638
52,RAJENDRA JAISWAL,GEN,BETUL,130428,3,INC,39,M,MADHYA PRADESH,547702,547321,381,1122830,581447,541383,11.61947935128203,130467,23.820800362240778
42,DR SUNILAM,GEN,BETUL,74368,4,SP,23,M,MADHYA PRADESH,547702,547321,381,1122830,581447,541383,6.6253128256281,74391,13.582386042044762
37,GUNTA LOKHANDE,SC,BETUL,15648,8,IND,1,F,MADHYA PRADESH,547702,547321,381,1122830,581447,541383,1.393710534987487,15649,2.857210672957192
30,BINDIYA DASHRYAMKAR,ST,BETUL,13909,2,BSP,13,F,MADHYA PRADESH,547702,547321,381,1122830,581447,541383,1.239902745740673,13922,2.541893219305389
34,MEERA UIKEY,ST,BETUL,11360,5,GGP,8,F,MADHYA PRADESH,547702,547321,381,1122830,581447,541383,1.0124417765823857,11368,2.075581246736364
41,SHAMIM MODI,GEN,BETUL,9428,6,SWJP,0,F,MADHYA PRADESH,547702,547321,381,1122830,581447,541383,0.8396640631262079,9428,1.721374031864043
36,ASHOK SAHU ( MAHARAJ),GEN,BETUL,4470,7,IND,0,M,MADHYA PRADESH,547702,547321,381,1122830,581447,541383,0.39810122636552286,4470,0.8161372425150902
62,SARTAJ SINGH,GEN,HOSHANGABAD,354166,4,BJP,493,M,MADHYA PRADESH,634343,633736,607,1287203,682485,604718,27.55268593997994,354659,55.90965770884206
48,OMPRAKASH HAJARILAL RAGHUVANSHI,GEN,HOSHANGABAD,218149,1,INC,101,M,MADHYA PRADESH,634343,633736,607,1287203,682485,604718,16.955367568285656,218250,34.40567642426889
39,"OMPRAKASH RADHESHYAM RAGHUVANSHI,",GEN,HOSHANGABAD,14847,9,IND,1,M,MADHYA PRADESH,634343,633736,607,1287203,682485,604718,1.1535088094107921,14848,2.3406895007905817
35,RAJENDRA RAGHUVANSHI,GEN,HOSHANGABAD,11744,3,BSP,9,M,MADHYA PRADESH,634343,633736,607,1287203,682485,604718,0.913064994410361,11753,1.8527831157591397
59,BRAJLAL DHURVE,ST,HOSHANGABAD,8574,6,GGP,2,M,MADHYA PRADESH,634343,633736,607,1287203,682485,604718,0.6662507778493368,8576,1.3519499702842153
44,BHAI SUNIL,GEN,HOSHANGABAD,8289,8,SWJP,0,M,MADHYA PRADESH,634343,633736,607,1287203,682485,604718,0.6439543723872614,8289,1.3067063087320268
33,PREMSHANKAR PATEL ( CHHOTE BHAIYA),GEN,HOSHANGABAD,7351,5,LJNSP,0,M,MADHYA PRADESH,634343,633736,607,1287203,682485,604718,0.5710831935599902,7351,1.1588367807321907
42,PADMINI YADAV MADHUSUDANSINGH,GEN,HOSHANGABAD,7100,2,SP,1,F,MADHYA PRADESH,634343,633736,607,1287203,682485,604718,0.5516612375825725,7101,1.1194259257215733
30,ER LALIT GAUR,GEN,HOSHANGABAD,3516,7,AD,0,M,MADHYA PRADESH,634343,633736,607,1287203,682485,604718,0.2731503888664026,3516,0.5542742648693215
73,KAILASH JOSHI,GEN,BHOPAL,561099,1,BJP,464,M,MADHYA PRADESH,858463,857893,570,1847544,967734,879810,30.395108316770802,561563,65.41493343335706
53,SAJID ALI,GEN,BHOPAL,255472,4,INC,86,M,MADHYA PRADESH,858463,857893,570,1847544,967734,879810,13.832309271118849,255558,29.769250392853273
65,G S CHAWALA,GEN,BHOPAL,16699,2,BSP,13,M,MADHYA PRADESH,858463,857893,570,1847544,967734,879810,0.9045522055225748,16712,1.9467350369206362
67,BRIJ BASI LAL SHARMA,GEN,BHOPAL,7965,10,IND,0,M,MADHYA PRADESH,858463,857893,570,1847544,967734,879810,0.43111287200737847,7965,0.9278210010215933
36,ARCHANA SHRIVASTAVA,GEN,BHOPAL,4315,5,SVSP,2,F,MADHYA PRADESH,858463,857893,570,1847544,967734,879810,0.23366155285070345,4317,0.5028754879359972
28,PRAMOD GUPTA,GEN,BHOPAL,3964,3,SP,1,M,MADHYA PRADESH,858463,857893,570,1847544,967734,879810,0.21460923258119968,3965,0.4618719735154573
25,ALTAF AHMED,GEN,BHOPAL,2454,9,IND,0,M,MADHYA PRADESH,858463,857893,570,1847544,967734,879810,0.13282498278796068,2454,0.2858597283750144
30,REVTI SINGH MARAVI,ST,BHOPAL,2272,8,GGP,3,M,MADHYA PRADESH,858463,857893,570,1847544,967734,879810,0.12313644492363915,2275,0.2650085093941148
35,UPENDRA TIWARI,GEN,BHOPAL,2043,7,RSGP,0,M,MADHYA PRADESH,858463,857893,570,1847544,967734,879810,0.11057923383692081,2043,0.23798346579875893
27,ANIL KUMAR BHARTI,GEN,BHOPAL,1610,6,ABHM,1,M,MADHYA PRADESH,858463,857893,570,1847544,967734,879810,0.0871968407788935,1611,0.18766097082809624
45,SHIVRAJ SINGH,GEN,VIDISHA,427715,4,BJP,315,M,MADHYA PRADESH,656555,656181,374,1313048,702385,610663,32.5981989995796,428030,65.1933196761886
52,NARBADA PRASAD SHARMA,GEN,VIDISHA,167258,2,INC,46,M,MADHYA PRADESH,656555,656181,374,1313048,702385,610663,12.741651485703493,167304,25.48209974792668
47,CH MUNAVVAR SALIM,GEN,VIDISHA,21538,3,SP,5,M,MADHYA PRADESH,656555,656181,374,1313048,702385,610663,1.6406864029342414,21543,3.281217872074693
37,KHUMAN SINGH KUSHWAH,GEN,VIDISHA,15631,1,BSP,7,M,MADHYA PRADESH,656555,656181,374,1313048,702385,610663,1.1909694085821692,15638,2.3818263511815463
32,MOHAN BABU SHARMA,GEN,VIDISHA,10867,7,IND,0,M,MADHYA PRADESH,656555,656181,374,1313048,702385,610663,0.8276163552284456,10867,1.655154556739344
36,ER AJAY SINGH ( KIRAR),GEN,VIDISHA,8279,5,GGP,1,M,MADHYA PRADESH,656555,656181,374,1313048,702385,610663,0.6305938549085791,8280,1.2611281613878502
42,ABDUL JABBAR,GEN,VIDISHA,4893,6,IND,0,M,MADHYA PRADESH,656555,656181,374,1313048,702385,610663,0.37264441208546834,4893,0.7452536345012984
49,LAKSHMAN SINGH,GEN,RAJGARH,282951,2,BJP,184,M,MADHYA PRADESH,599229,598957,272,1278429,664543,613886,22.14710398465617,283135,47.24988276602101
64,SHAMBHOO SINGH,GEN,RAJGARH,246344,4,INC,79,M,MADHYA PRADESH,599229,598957,272,1278429,664543,613886,19.27545448358884,246423,41.12334349639287
42,PANDIT PRAKASH PALIWAL,GEN,RAJGARH,16128,1,SP,1,M,MADHYA PRADESH,599229,598957,272,1278429,664543,613886,1.2616265744910355,16129,2.691625405312493
39,SHOBHNA YADAV,GEN,RAJGARH,13962,3,BSP,5,F,MADHYA PRADESH,599229,598957,272,1278429,664543,613886,1.0925127637123377,13967,2.3308284478888703
37,HEERALAL DANGI,GEN,RAJGARH,10865,11,IND,0,M,MADHYA PRADESH,599229,598957,272,1278429,664543,613886,0.8498712091168145,10865,1.8131632481071511
47,LAKSHMAN SINGH ( LIMBODA),GEN,RAJGARH,7299,8,IND,0,M,MADHYA PRADESH,599229,598957,272,1278429,664543,613886,0.5709351086372415,7299,1.2180652137997328
62,AHAMAD KHAN,GEN,RAJGARH,6350,5,IND,0,M,MADHYA PRADESH,599229,598957,272,1278429,664543,613886,0.49670337578387225,6350,1.0596950414616115
37,VINEETA ASHOK TRIPATHI,GEN,RAJGARH,6019,10,IND,3,F,MADHYA PRADESH,599229,598957,272,1278429,664543,613886,0.47104688645204384,6022,1.0049580377451692
42,LAKSHMAN SINGH ( SAMELI ),GEN,RAJGARH,4283,9,IND,0,M,MADHYA PRADESH,599229,598957,272,1278429,664543,613886,0.33502056039091727,4283,0.7147517893826901
29,DR RAJNI SHARMA ( SAMAJ SEVIKA),GEN,RAJGARH,2552,7,IND,0,F,MADHYA PRADESH,599229,598957,272,1278429,664543,613886,0.1996200023622743,2552,0.4258805898913437
48,DR BADRI PRASAD BIRMAL,GEN,RAJGARH,2204,6,IND,0,M,MADHYA PRADESH,599229,598957,272,1278429,664543,613886,0.17239909294923692,2204,0.3678059639970696
56,THAWARCHAND GEHLOT,SC,SHAJAPUR (SC),423631,1,BJP,373,M,MADHYA PRADESH,720241,719744,497,1328841,682847,645994,31.907805373253833,424004,58.8697394344393
49,SHYAM BAPULAL MALVIYA,SC,SHAJAPUR (SC),255700,4,INC,117,M,MADHYA PRADESH,720241,719744,497,1328841,682847,645994,19.25113689297666,255817,35.518250141272155
50,BALRAM SUKHRAM KALYANE,SC,SHAJAPUR (SC),11731,7,IND,0,M,MADHYA PRADESH,720241,719744,497,1328841,682847,645994,0.8827993717833811,11731,1.6287603732639493
45,MOHANLAL BHAIYYA ADVOCATE,SC,SHAJAPUR (SC),8899,3,BSP,6,M,MADHYA PRADESH,720241,719744,497,1328841,682847,645994,0.6701328450883138,8905,1.236391707775592
69,MOTILAL MALVIYA,SC,SHAJAPUR (SC),8484,2,SP,0,M,MADHYA PRADESH,720241,719744,497,1328841,682847,645994,0.638451101373302,8484,1.1779390509565548
67,THAWARCHAND GEHLAUTA,SC,SHAJAPUR (SC),6870,5,IND,1,M,MADHYA PRADESH,720241,719744,497,1328841,682847,645994,0.5170671284224373,6871,0.9539862351629523
39,THAWARCHAND GEHLAUT,SC,SHAJAPUR (SC),4429,6,IND,0,M,MADHYA PRADESH,720241,719744,497,1328841,682847,645994,0.3332979641657655,4429,0.6149330571294886
47,NAND KUMAR SINGH CHAUHAN ( NANDU,GEN,KHANDWA,336572,2,BJP,152,M,MADHYA PRADESH,605295,605099,196,1217726,627521,590205,27.651869139691527,336724,55.62973426180623
39,AMITABH MANDLOI,GEN,KHANDWA,233947,1,INC,40,M,MADHYA PRADESH,605295,605099,196,1217726,627521,590205,19.215077940357684,233987,38.6566880611933
34,UTTAM SALWE,SC,KHANDWA,13645,5,GGP,0,M,MADHYA PRADESH,605295,605099,196,1217726,627521,590205,1.1205312196668216,13645,2.2542727100009086
48,RAMGOPAL YADAV,GEN,KHANDWA,12590,3,BSP,2,M,MADHYA PRADESH,605295,605099,196,1217726,627521,590205,1.034058564898836,12592,2.080307949016595
44,SONIA SHARMA,GEN,KHANDWA,8345,4,SP,2,F,MADHYA PRADESH,605295,605099,196,1217726,627521,590205,0.6854579765891506,8347,1.3789970179829671
53,KRISHNA MURARI MOGHE,GEN,KHARGONE,321367,2,BJP,395,M,MADHYA PRADESH,652254,651747,507,1287299,655223,632076,24.99512545259493,321762,49.3307821799483
60,TARACHAND SHIVAJI PATEL,GEN,KHARGONE,263045,3,INC,100,M,MADHYA PRADESH,652254,651747,507,1287299,655223,632076,20.441637879000915,263145,40.34394576346025
42,KASHIRAM YADAV,GEN,KHARGONE,17994,1,SP,2,M,MADHYA PRADESH,652254,651747,507,1287299,655223,632076,1.397965818353001,17996,2.75904785559
31,SURESH CHOUHAN,ST,KHARGONE,14503,10,IND,0,M,MADHYA PRADESH,652254,651747,507,1287299,655223,632076,1.1266224863066001,14503,2.22352028504233
45,BHAGWAN-BADOLE,SC,KHARGONE,11584,4,BSP,10,M,MADHYA PRADESH,652254,651747,507,1287299,655223,632076,0.9006454599902587,11594,1.7775283861808437
39,REMSINGH KIRADE ( REMA),ST,KHARGONE,8282,9,IND,0,M,MADHYA PRADESH,652254,651747,507,1287299,655223,632076,0.6433625754389618,8282,1.269750741275638
51,YASHWANT KUMAR KUMRAWAT,GEN,KHARGONE,6357,8,IND,0,M,MADHYA PRADESH,652254,651747,507,1287299,655223,632076,0.49382466699655636,6357,0.9746203166251185
37,ASHOK PRAJAPATI,GEN,KHARGONE,3700,5,IND,0,M,MADHYA PRADESH,652254,651747,507,1287299,655223,632076,0.2874235123308571,3700,0.5672636733542454
66,MANGILAL MANDLOI,GEN,KHARGONE,2579,7,IND,0,M,MADHYA PRADESH,652254,651747,507,1287299,655223,632076,0.20034195629764334,2579,0.3953981117785403
35,PRATIBHA RATHOR,GEN,KHARGONE,2336,6,IND,0,F,MADHYA PRADESH,652254,651747,507,1287299,655223,632076,0.18146522292023842,2336,0.3581426867447344
50,CHHATAR SINGH DARBAR,ST,DHAR (ST),345161,2,BJP,307,M,MADHYA PRADESH,703372,702989,383,1325680,671362,654318,26.059682577997705,345468,49.11597277116519
30,UMANG SINGHAR,ST,DHAR (ST),312786,1,INC,71,M,MADHYA PRADESH,703372,702989,383,1325680,671362,654318,23.59973749321103,312857,44.47959259111821
62,RAM SINGH PATEL,ST,DHAR (ST),22326,5,IND,0,M,MADHYA PRADESH,703372,702989,383,1325680,671362,654318,1.6841168306076884,22326,3.1741382938189178
47,SHRIPAL SINGH DARBAR,ST,DHAR (ST),11456,4,BSP,4,M,MADHYA PRADESH,703372,702989,383,1325680,671362,654318,0.8644620119485849,11460,1.6292943136775417
33,MOHAN SINGH DAWAR,ST,DHAR (ST),11260,3,SP,1,M,MADHYA PRADESH,703372,702989,383,1325680,671362,654318,0.8494508478667552,11261,1.6010020302201395
61,SUMITRA MAHAJAN,GEN,INDORE,507894,4,BJP,213,F,MADHYA PRADESH,854503,854240,263,1678030,872209,805821,30.279971156653936,508107,59.4622839241056
58,RAMESHWAR PATEL,GEN,INDORE,314122,3,INC,49,M,MADHYA PRADESH,854503,854240,263,1678030,872209,805821,18.722609250132596,314171,36.76651808127063
47,KAILASHCHANDER KANWARLAL SAHU,GEN,INDORE,10330,1,BSP,1,M,MADHYA PRADESH,854503,854240,263,1678030,872209,805821,0.6156624136636413,10331,1.209006873001031
33,RAJU SONI,GEN,INDORE,5635,10,IND,0,M,MADHYA PRADESH,854503,854240,263,1678030,872209,805821,0.33581044439014796,5635,0.6594476555377805
55,AJIT KUMAR JAIN ( PATWA),GEN,INDORE,4453,5,IND,0,M,MADHYA PRADESH,854503,854240,263,1678030,872209,805821,0.265370702550014,4453,0.5211216344471582
45,RAJENDRA YADAV ( ADVOCATE),GEN,INDORE,4142,2,SP,0,M,MADHYA PRADESH,854503,854240,263,1678030,872209,805821,0.2468370648915693,4142,0.484726209270184
43,PARMANAND TOLANI,GEN,INDORE,2211,8,IND,0,M,MADHYA PRADESH,854503,854240,263,1678030,872209,805821,0.13176164907659577,2211,0.2587468973192604
55,NANDKISHOR AGRAWAL,GEN,INDORE,2075,7,IND,0,M,MADHYA PRADESH,854503,854240,263,1678030,872209,805821,0.12365690720666496,2075,0.2428312129974968
43,MOOLCHAND RATHORE,GEN,INDORE,1933,9,IND,0,M,MADHYA PRADESH,854503,854240,263,1678030,872209,805821,0.11519460319541366,1933,0.22621336613212595
47,GHANSHYAM CHANDEL,SC,INDORE,1445,6,IND,0,M,MADHYA PRADESH,854503,854240,263,1678030,872209,805821,0.08611288236801488,1445,0.16910414591873874
58,DR SATYANARAYAN JATIYA,SC,UJJAIN (SC),369090,3,BJP,654,M,MADHYA PRADESH,720780,719800,980,1243447,638111,605336,29.735404886577392,369744,51.29776075917756
43,PREMCHAND GUDDU,SC,UJJAIN (SC),299034,1,INC,307,M,MADHYA PRADESH,720780,719800,980,1243447,638111,605336,24.073482826368956,299341,41.53014789533561
33,HUKUMCHAND,SC,UJJAIN (SC),18797,11,IND,0,M,MADHYA PRADESH,720780,719800,980,1243447,638111,605336,1.511684856692726,18797,2.607869252753961
37,BABULAL THAWLIA,SC,UJJAIN (SC),9486,2,BSP,9,M,MADHYA PRADESH,720780,719800,980,1243447,638111,605336,0.7636031129593782,9495,1.3173229001914593
51,SITARAM GUJRATI,SC,UJJAIN (SC),6179,4,SP,2,M,MADHYA PRADESH,720780,719800,980,1243447,638111,605336,0.49708592324401446,6181,0.8575432170703958
47,MANGILAL,SC,UJJAIN (SC),5494,9,IND,1,M,MADHYA PRADESH,720780,719800,980,1243447,638111,605336,0.4419167041297297,5495,0.7623685451871584
37,VIKRAM SINGH CHANDRAVANSHI,SC,UJJAIN (SC),4824,10,IND,0,M,MADHYA PRADESH,720780,719800,980,1243447,638111,605336,0.38795380904855614,4824,0.669274952135187
35,PREMCHAND GUNDDU,SC,UJJAIN (SC),2651,8,IND,6,M,MADHYA PRADESH,720780,719800,980,1243447,638111,605336,0.21368019706509406,2657,0.3686284303116069
36,PRAKASH SOLANKI,SC,UJJAIN (SC),1527,7,IND,0,M,MADHYA PRADESH,720780,719800,980,1243447,638111,605336,0.12280378657071835,1527,0.21185382502289188
25,ANIL KUMAR,SC,UJJAIN (SC),1467,5,IND,0,M,MADHYA PRADESH,720780,719800,980,1243447,638111,605336,0.11797849043827362,1467,0.20352950969782735
40,DECEMBER BAIRWA,SC,UJJAIN (SC),1251,6,IND,1,M,MADHYA PRADESH,720780,719800,980,1243447,638111,605336,0.10068784596367998,1252,0.1737007131163462
55,KANTILAL BHURIA,ST,JHABUA (ST),322085,1,INC,172,M,MADHYA PRADESH,628903,628135,768,1290101,646870,643231,24.979207054331404,322257,51.24112939515315
43,RELAM CHAUHAN,ST,JHABUA (ST),241390,3,BJP,585,F,MADHYA PRADESH,628903,628135,768,1290101,646870,643231,18.756283422770775,241975,38.475726781395544
35,UDAYSINGH MACHHAR,ST,JHABUA (ST),19473,6,IND,0,M,MADHYA PRADESH,628903,628135,768,1290101,646870,643231,1.5094167045835947,19473,3.096343951292966
44,NARAYANSINGH KHARADI,ST,JHABUA (ST),18332,5,JD(U),2,M,MADHYA PRADESH,628903,628135,768,1290101,646870,643231,1.4211290433849753,18334,2.9152349408414335
34,JALAMSINGH PATEL,ST,JHABUA (ST),16018,2,BSP,8,M,MADHYA PRADESH,628903,628135,768,1290101,646870,643231,1.2422283216585368,16026,2.548246708951937
34,SUSHEELA MAIDA,ST,JHABUA (ST),10837,4,SP,1,F,MADHYA PRADESH,628903,628135,768,1290101,646870,643231,0.8400892643289168,10838,1.7233182223649752
76,DR LAXMINARAYAN PANDEYA,GEN,MANDSAUR,423208,4,BJP,270,M,MADHYA PRADESH,776538,776188,350,1373890,699066,674824,30.823282795565877,423478,54.534098782029986
50,RAJENDRA SINGH GAUTAM,GEN,MANDSAUR,283771,2,INC,74,M,MADHYA PRADESH,776538,776188,350,1373890,699066,674824,20.65995094221517,283845,36.55262202236079
50,DR KALPANA PARULEKAR,GEN,MANDSAUR,24565,1,NCP,5,F,MADHYA PRADESH,776538,776188,350,1373890,699066,674824,1.7883527793345904,24570,3.164043485315593
27,SARID ALIAS@ RASHID KHAN MAWATI,GEN,MANDSAUR,10984,9,IND,0,M,MADHYA PRADESH,776538,776188,350,1373890,699066,674824,0.7994817634599567,10984,1.4144832577414113
63,RAMSINGH GUJARBARDIYA,GEN,MANDSAUR,9392,3,SP,0,M,MADHYA PRADESH,776538,776188,350,1373890,699066,674824,0.6836064022592784,9392,1.2094707535239744
31,M RAFIK DAGRIA,GEN,MANDSAUR,7917,5,IND,1,M,MADHYA PRADESH,776538,776188,350,1373890,699066,674824,0.576319792705384,7918,1.0196538997447646
32,SATYANARAYAN VYAS,GEN,MANDSAUR,5661,8,IND,0,M,MADHYA PRADESH,776538,776188,350,1373890,699066,674824,0.4120417209529147,5661,0.7290048909390139
46,DR RAMESHCHANDRA SONI,GEN,MANDSAUR,5348,6,IND,0,M,MADHYA PRADESH,776538,776188,350,1373890,699066,674824,0.38925969327966575,5348,0.6886977842681233
53,LAKSHMINARAYAN PANDY,GEN,MANDSAUR,5342,7,IND,0,M,MADHYA PRADESH,776538,776188,350,1373890,699066,674824,0.3888229770942361,5342,0.6879251240763491
50,SURESH PRABHAKAR PRABHU,GEN,RAJAPUR,263814,3,SHS,187,M,MAHARASHTRA,480535,480238,297,835714,379898,455816,31.58987404782019,264001,54.93897426826349
49,SUDHIR SAWANT,GEN,RAJAPUR,183008,2,INC,94,M,MAHARASHTRA,480535,480238,297,835714,379898,455816,21.90964851611915,183102,38.10378016169478
50,MOHAN GOVIND PARAB,GEN,RAJAPUR,12605,1,BSP,11,M,MAHARASHTRA,480535,480238,297,835714,379898,455816,1.509607353711916,12616,2.6254070983383104
56,SURENDRA BORKAR,GEN,RAJAPUR,11511,4,BBM,2,M,MAHARASHTRA,480535,480238,297,835714,379898,455816,1.3776244026066333,11513,2.3958712684820043
64,PRIN MAHENDRA NATEKAR,GEN,RAJAPUR,9300,5,IND,3,M,MAHARASHTRA,480535,480238,297,835714,379898,455816,1.113179867753801,9303,1.9359672032214095
52,ANANT GEETE,GEN,RATNAGIRI,334355,1,SHS,335,M,MAHARASHTRA,560976,560475,501,914770,413019,501751,36.58733889392962,334690,59.66208893072075
69,GOVINDRAO NIKAM,GEN,RATNAGIRI,185574,3,NCP,148,M,MAHARASHTRA,560976,560475,501,914770,413019,501751,20.302589722006626,185722,33.106942186475
41,ADV PANKAJ KOWLI,GEN,RATNAGIRI,25945,4,PWPI,6,M,MAHARASHTRA,560976,560475,501,914770,413019,501751,2.8368879609082067,25951,4.626044607968968
41,AYARE RAJENDRA LAHU,SC,RATNAGIRI,14601,2,BSP,12,M,MAHARASHTRA,560976,560475,501,914770,413019,501751,1.5974507253189325,14613,2.604924274835287
75,A R ANTULAY,GEN,KOLABA,311744,1,INC,481,M,MAHARASHTRA,793445,791914,1531,1250272,629972,620300,24.972565969645004,312225,39.3505535985481
48,VIVEK PATIL,GEN,KOLABA,279552,4,PWPI,803,M,MAHARASHTRA,793445,791914,1531,1250272,629972,620300,22.423520641908322,280355,35.33389207821588
51,SHYAM SAWANT,GEN,KOLABA,164009,3,SHS,233,M,MAHARASHTRA,793445,791914,1531,1250272,629972,620300,13.136501497274194,164242,20.699859473561492
52,A R ANTULAY,GEN,KOLABA,23769,5,IND,2,M,MAHARASHTRA,793445,791914,1531,1250272,629972,620300,1.9012662844565023,23771,2.995922842793136
47,KUNDLIK NAMDEO THORE,GEN,KOLABA,12840,2,BSP,12,M,MAHARASHTRA,793445,791914,1531,1250272,629972,620300,1.027936321056538,12852,1.6197720068813841
27,MILIND MURLI DEORA,GEN,MUMBAI SOUTH,137952,3,INC,4,M,MAHARASHTRA,274358,274343,15,620431,353569,266862,22.235510475782156,137956,50.283206613257136
65,JAYAWANTIBEN MEHTA,GEN,MUMBAI SOUTH,127699,2,BJP,11,F,MAHARASHTRA,274358,274343,15,620431,353569,266862,20.58407784266099,127710,46.54866998593079
47,ADV AMIN SOLKAR,GEN,MUMBAI SOUTH,3957,4,SP,0,M,MAHARASHTRA,274358,274343,15,620431,353569,266862,0.6377824447843515,3957,1.4422761501395986
50,AZIZ LALANI,GEN,MUMBAI SOUTH,1701,1,BSP,0,M,MAHARASHTRA,274358,274343,15,620431,353569,266862,0.2741642503356538,1701,0.6199928560493952
36,SUHAIL DIL NAWAZ,GEN,MUMBAI SOUTH,1693,7,JP,0,M,MAHARASHTRA,274358,274343,15,620431,353569,266862,0.2728748241142045,1693,0.6170769578434018
31,MAHESH GAJANAN KULKARNI,GEN,MUMBAI SOUTH,690,5,ABHM,0,M,MAHARASHTRA,274358,274343,15,620431,353569,266862,0.11121301160000065,690,0.25149622026695045
38,RAMNAYAK TIWARI,GEN,MUMBAI SOUTH,651,6,ABJS,0,M,MAHARASHTRA,274358,274343,15,620431,353569,266862,0.10492705877043539,651,0.2372812165127315
55,MOHAN RAWALE,GEN,MUMBAI SOUTH CENTRAL,128511,3,SHS,25,M,MAHARASHTRA,347972,347937,35,704452,405543,298909,18.246239630237405,128536,36.93860425551481
32,AHIR SACHIN,GEN,MUMBAI SOUTH CENTRAL,106341,2,NCP,7,M,MAHARASHTRA,347972,347937,35,704452,405543,298909,15.096557323990847,106348,30.562229144873726
52,ARUN GULAB GAWLI ALIES DADY,GEN,MUMBAI SOUTH CENTRAL,92209,5,ABHS,1,M,MAHARASHTRA,347972,347937,35,704452,405543,298909,13.08960724080562,92210,26.499258561033646
60,T K CHOUDHARY,GEN,MUMBAI SOUTH CENTRAL,10104,6,SP,0,M,MAHARASHTRA,347972,347937,35,704452,405543,298909,1.4343063828337488,10104,2.9036819054406675
33,ABDUL MALIK CHOUDHRY,GEN,MUMBAI SOUTH CENTRAL,4688,1,BSP,2,M,MAHARASHTRA,347972,347937,35,704452,405543,298909,0.6657657299574705,4690,1.3478095938753694
48,PUKHRAJ CHUNNILAL JAIN,GEN,MUMBAI SOUTH CENTRAL,2677,8,IND,0,M,MAHARASHTRA,347972,347937,35,704452,405543,298909,0.3800116970354261,2677,0.769314772452956
50,ANSARI HUSAIN AHMED,GEN,MUMBAI SOUTH CENTRAL,1921,4,MUL,0,M,MAHARASHTRA,347972,347937,35,704452,405543,298909,0.27269423608705773,1921,0.5520559125446874
31,YASHWANT ( PRAKASH) SHINDE,GEN,MUMBAI SOUTH CENTRAL,1486,7,ABJS,0,M,MAHARASHTRA,347972,347937,35,704452,405543,298909,0.2109441097477188,1486,0.4270458542641362
64,EKNATH M GAIKWAD,SC,MUMBAI NORTH CENTRAL,256278,1,INC,4,M,MAHARASHTRA,514593,514561,32,1117487,627054,490433,22.93377909541677,256282,49.80285390590233
66,MANOHAR GAJANAN JOSHI,GEN,MUMBAI NORTH CENTRAL,242925,3,SHS,28,M,MAHARASHTRA,514593,514561,32,1117487,627054,490433,21.74101354199199,242953,47.212651551808904
37,JASWAR SATYARAM BALLIKARAN,GEN,MUMBAI NORTH CENTRAL,7292,2,BSP,0,M,MAHARASHTRA,514593,514561,32,1117487,627054,490433,0.6525355552234612,7292,1.4170422061707018
30,SHAIKH SAMAD ABDUL SALAM,GEN,MUMBAI NORTH CENTRAL,3475,7,IND,0,M,MAHARASHTRA,514593,514561,32,1117487,627054,490433,0.31096558617684145,3475,0.6752909580969815
33,KHAN AKRAM ALI,GEN,MUMBAI NORTH CENTRAL,2404,4,NLP,0,M,MAHARASHTRA,514593,514561,32,1117487,627054,490433,0.2151255450846408,2404,0.4671653131698255
49,KHAN MOHAMMAD BASHEER,GEN,MUMBAI NORTH CENTRAL,1117,5,IND,0,M,MAHARASHTRA,514593,514561,32,1117487,627054,490433,0.09995642007468543,1117,0.2170647482573607
35,KHAN MOHD MERAZ,GEN,MUMBAI NORTH CENTRAL,1070,6,IND,0,M,MAHARASHTRA,514593,514561,32,1117487,627054,490433,0.09575055459258139,1070,0.2079313165938907
49,KAMAT GURUDAS,GEN,MUMBAI NORTH EAST,493413,1,INC,7,M,MAHARASHTRA,925659,925623,36,1974560,1107338,867222,24.988858277287093,493420,53.304726686609214
50,KIRIT SOMAIYA,GEN,MUMBAI NORTH EAST,393992,2,BJP,28,M,MAHARASHTRA,925659,925623,36,1974560,1107338,867222,19.954825378818573,394020,42.56643105074331
44,DR SUNIL TUKARAM TORNE,SC,MUMBAI NORTH EAST,9422,3,BSP,0,M,MAHARASHTRA,925659,925623,36,1974560,1107338,867222,0.47716959727736813,9422,1.0178694313996839
63,RAJA DHALE,GEN,MUMBAI NORTH EAST,9159,8,BBM,0,M,MAHARASHTRA,925659,925623,36,1974560,1107338,867222,0.4638501742160279,9159,0.9894572407333586
40,SHAHAJI DHONDIBA THORAT,SC,MUMBAI NORTH EAST,7208,14,IND,0,M,MAHARASHTRA,925659,925623,36,1974560,1107338,867222,0.365043351430192,7208,0.7786884803151053
48,ADVOCATE S K DUBEY,GEN,MUMBAI NORTH EAST,2623,6,SP,0,M,MAHARASHTRA,925659,925623,36,1974560,1107338,867222,0.1328397212543554,2623,0.2833656886607271
28,WARE JYOTI MARUTI,GEN,MUMBAI NORTH EAST,1890,13,IND,0,F,MAHARASHTRA,925659,925623,36,1974560,1107338,867222,0.0957175269427113,1890,0.2041788606819574
54,VITHALRAO JADHAV,SC,MUMBAI NORTH EAST,1399,9,MRRC,0,M,MAHARASHTRA,925659,925623,36,1974560,1107338,867222,0.07085122761526619,1399,0.15113556936193567
49,ABDUL SATTAR MOHAMMEDSAB ATTAR,GEN,MUMBAI NORTH EAST,1353,4,KKJHS,0,M,MAHARASHTRA,925659,925623,36,1974560,1107338,867222,0.06852159468438539,1353,0.14616613677390916
33,PIUS VARGHESE PULLIKOTTIL,GEN,MUMBAI NORTH EAST,1243,12,IND,0,M,MAHARASHTRA,925659,925623,36,1974560,1107338,867222,0.06295073332793129,1243,0.1342827110199328
40,MAHESH MADHUKAR SAWANT-PATEL,GEN,MUMBAI NORTH EAST,1057,7,ABHM,1,M,MAHARASHTRA,925659,925623,36,1974560,1107338,867222,0.05358155741025848,1058,0.11429694952460895
36,KHAN RAIS AHMAD,GEN,MUMBAI NORTH EAST,1012,5,NLP,0,M,MAHARASHTRA,925659,925623,36,1974560,1107338,867222,0.05125192447937769,1012,0.10932751693658249
63,THAPAR MADAN LAL,GEN,MUMBAI NORTH EAST,1004,11,IND,0,M,MAHARASHTRA,925659,925623,36,1974560,1107338,867222,0.05084677092618103,1004,0.10846326779083874
40,UMESH SHRIRANG DHENDE,SC,MUMBAI NORTH EAST,848,10,IND,0,M,MAHARASHTRA,925659,925623,36,1974560,1107338,867222,0.04294627663884613,848,0.09161040944883592
74,SUNIL DUTT,GEN,MUMBAI NORTH WEST,385738,2,INC,17,M,MAHARASHTRA,747687,747653,34,1515745,825728,690017,25.44986128933297,385755,51.593113160988494
39,SANJAY NIRUPAM,GEN,MUMBAI NORTH WEST,338380,3,SHS,17,M,MAHARASHTRA,747687,747653,34,1515745,825728,690017,22.325457118446703,338397,45.25917930898892
52,ISMAIL MAKWANA,GEN,MUMBAI NORTH WEST,6867,1,BSP,0,M,MAHARASHTRA,747687,747653,34,1515745,825728,690017,0.4530445424527213,6867,0.9184324456624229
34,SHEKHAR VAISHNAV,GEN,MUMBAI NORTH WEST,4019,14,IND,0,M,MAHARASHTRA,747687,747653,34,1515745,825728,690017,0.2651501406898918,4019,0.5375243918912592
48,KHARE JAYAWANT MAHADEV,GEN,MUMBAI NORTH WEST,2851,4,LRP,0,M,MAHARASHTRA,747687,747653,34,1515745,825728,690017,0.18809232423659653,2851,0.3813092911873551
55,PERIMAL JOHN BABURAO,GEN,MUMBAI NORTH WEST,1949,12,IND,0,M,MAHARASHTRA,747687,747653,34,1515745,825728,690017,0.1285836337906442,1949,0.2606705747191004
25,RAJ SINGH,GEN,MUMBAI NORTH WEST,1582,13,IND,0,M,MAHARASHTRA,747687,747653,34,1515745,825728,690017,0.10437111783314476,1582,0.21158586413833597
73,KRISHNAN K K,GEN,MUMBAI NORTH WEST,1194,9,IND,0,M,MAHARASHTRA,747687,747653,34,1515745,825728,690017,0.07877314455927613,1194,0.1596924916442308
45,AARTI MEHTA,GEN,MUMBAI NORTH WEST,1113,8,IND,0,F,MAHARASHTRA,747687,747653,34,1515745,825728,690017,0.07342923776756644,1113,0.14885908140705936
69,DUBEY SATYADEV,GEN,MUMBAI NORTH WEST,840,10,IND,0,M,MAHARASHTRA,747687,747653,34,1515745,825728,690017,0.05541829265476712,840,0.11234647653362972
39,DILIPRAO D PATIL,GEN,MUMBAI NORTH WEST,829,5,BMSM,0,M,MAHARASHTRA,747687,747653,34,1515745,825728,690017,0.05469257691762137,829,0.11087527267426074
56,ANAND RAVINDER SINGH,GEN,MUMBAI NORTH WEST,796,7,IND,0,M,MAHARASHTRA,747687,747653,34,1515745,825728,690017,0.052515429706184086,796,0.10646166109615388
36,RAMCHANDRA NARAYAN KACHAVE,GEN,MUMBAI NORTH WEST,762,6,KKJHS,0,M,MAHARASHTRA,747687,747653,34,1515745,825728,690017,0.050272308336824466,762,0.10191430371264981
38,PATEL SAIRABANO MOHAMMED,GEN,MUMBAI NORTH WEST,733,11,IND,0,F,MAHARASHTRA,747687,747653,34,1515745,825728,690017,0.04835905775707655,733,0.09803567535613164
41,GOVINDA,GEN,MUMBAI NORTH,559727,2,INC,36,M,MAHARASHTRA,1119342,1119246,96,2377866,1295493,1082373,23.540561158618694,559763,50.00821911444402
69,RAM NAIK,GEN,MUMBAI NORTH,511433,3,BJP,59,M,MAHARASHTRA,1119342,1119246,96,2377866,1295493,1082373,21.510547692763176,511492,45.695774839146566
48,VIDYA CHAVAN,GEN,MUMBAI NORTH,14183,11,IND,0,F,MAHARASHTRA,1119342,1119246,96,2377866,1295493,1082373,0.5964591781033919,14183,1.2670836973865003
38,AKHILESHWAR NANDLAL CHOUBEY,GEN,MUMBAI NORTH,9313,1,BSP,0,M,MAHARASHTRA,1119342,1119246,96,2377866,1295493,1082373,0.3916536928489663,9313,0.8320066610562277
34,SHYAM TIPANNA KURHADE,ST,MUMBAI NORTH,7216,13,IND,0,M,MAHARASHTRA,1119342,1119246,96,2377866,1295493,1082373,0.30346537609772795,7216,0.6446644546528228
42,ANITA NAIK,GEN,MUMBAI NORTH,4648,4,NSTP,1,F,MAHARASHTRA,1119342,1119246,96,2377866,1295493,1082373,0.19551143756628844,4649,0.4153332940245251
58,AGRAWAL B R KUMAR,GEN,MUMBAI NORTH,3955,5,SP,0,M,MAHARASHTRA,1119342,1119246,96,2377866,1295493,1082373,0.16632560455467213,3955,0.35333258289244934
45,SHAIKH FATEH MOHAMMAD,GEN,MUMBAI NORTH,2734,12,IND,0,M,MAHARASHTRA,1119342,1119246,96,2377866,1295493,1082373,0.11497704244057487,2734,0.24425064010820643
43,RAJESH B DHARIA,GEN,MUMBAI NORTH,1340,10,IND,0,M,MAHARASHTRA,1119342,1119246,96,2377866,1295493,1082373,0.05635304933078652,1340,0.11971318864118384
40,RAMASARE (BACHHAN) YADAV,GEN,MUMBAI NORTH,1278,6,KKJHS,0,M,MAHARASHTRA,1119342,1119246,96,2377866,1295493,1082373,0.053745669436376986,1278,0.11417422021151713
64,MAHANT SHRIRAMSWRUP DAS MAHARAJ,GEN,MUMBAI NORTH,1249,7,ABHM,0,M,MAHARASHTRA,1119342,1119246,96,2377866,1295493,1082373,0.05252608851802414,1249,0.11158341239764075
60,BABUBHAI GALA,GEN,MUMBAI NORTH,1228,8,IND,0,M,MAHARASHTRA,1119342,1119246,96,2377866,1295493,1082373,0.051642943715078986,1228,0.10970731018759236
40,MOHAMMED PATEL,GEN,MUMBAI NORTH,942,9,IND,0,M,MAHARASHTRA,1119342,1119246,96,2377866,1295493,1082373,0.039615352589254395,942,0.08415658485074268
56,PARANJAPE PRAKASH VISHVANATH,GEN,THANE,631299,2,SHS,115,M,MAHARASHTRA,1313252,1313006,246,3240342,1746876,1493466,19.486029561077196,631414,48.08018567647336
54,DAVKHARE VASANT SHANKARRAO,GEN,THANE,609029,1,NCP,127,M,MAHARASHTRA,1313252,1313006,246,3240342,1746876,1493466,18.79912675884212,609156,46.38530914097218
48,PAWAR SAMBHAJI MARUTI,GEN,THANE,24825,3,BSP,3,M,MAHARASHTRA,1313252,1313006,246,3240342,1746876,1493466,0.7662154180021739,24828,1.8905739340202794
48,KARMAVEER RAMNARAYAN YADAV,GEN,THANE,22412,5,SP,0,M,MAHARASHTRA,1313252,1313006,246,3240342,1746876,1493466,0.6916553869931014,22412,1.7066031500427945
49,VADHVINDE MAHENDRA KERU,SC,THANE,11658,10,IND,0,M,MAHARASHTRA,1313252,1313006,246,3240342,1746876,1493466,0.3597768383707646,11658,0.8877199501695028
31,RAMSING BOOTPOLISHWALA,SC,THANE,3894,9,IND,0,M,MAHARASHTRA,1313252,1313006,246,3240342,1746876,1493466,0.12017250031015245,3894,0.29651582483788336
53,DHOTRE BHANUDAS SAKHARAM,GEN,THANE,2957,4,HJP,0,M,MAHARASHTRA,1313252,1313006,246,3240342,1746876,1493466,0.0912557995421471,2957,0.2251662285684697
34,LANDGE SANTOSH GOVIND,SC,THANE,2394,6,PRCP,0,M,MAHARASHTRA,1313252,1313006,246,3240342,1746876,1493466,0.07388109032935412,2394,0.1822955533286833
42,COM ARUN VELASKAR,GEN,THANE,2338,7,IND,1,M,MAHARASHTRA,1313252,1313006,246,3240342,1746876,1493466,0.07218373863005818,2339,0.1781074767066793
40,RAJPUT MANGALSING UKHARDU,GEN,THANE,2200,8,IND,0,M,MAHARASHTRA,1313252,1313006,246,3240342,1746876,1493466,0.06789406797183754,2200,0.1675230648801601
50,SHINGADA DAMODAR BARKU,ST,DAHANU (ST),285972,4,INC,32,M,MAHARASHTRA,683353,683263,90,1605119,860538,744581,17.8182427595711,286004,41.85303935155037
53,ADV CHINTAMAN WANGA,ST,DAHANU (ST),222595,2,BJP,46,M,MAHARASHTRA,683353,683263,90,1605119,860538,744581,13.870684977250908,222641,32.58067206846242
49,VARATHA RAMJI MAHADU,ST,DAHANU (ST),118086,3,CPM,4,M,MAHARASHTRA,683353,683263,90,1605119,860538,744581,7.357086920035212,118090,17.280966060001198
43,HAJI D ABDULLAH,ST,DAHANU (ST),29018,1,BSP,6,M,MAHARASHTRA,683353,683263,90,1605119,860538,744581,1.8082148426378355,29024,4.247292394999364
59,A RASHEED MAMU,ST,DAHANU (ST),27592,5,RSNP,2,M,MAHARASHTRA,683353,683263,90,1605119,860538,744581,1.7191248748535157,27594,4.038030124986647
43,PINGALE DEVIDAS ANANDRAO,GEN,NASHIK,307401,4,NCP,212,M,MAHARASHTRA,656525,656071,454,1522672,794591,728081,20.202184055397353,307613,46.854727542743994
39,PATIL DASHARATH DHARMAJI,GEN,NASHIK,292332,3,SHS,223,M,MAHARASHTRA,656525,656071,454,1522672,794591,728081,19.213264577006736,292555,44.561136285746926
44,GUNJAL RADHESHYAM SHIVRAM,GEN,NASHIK,17824,1,CPI,7,M,MAHARASHTRA,656525,656071,454,1522672,794591,728081,1.1710335515462293,17831,2.7159666425497884
51,PAWAR GAJIRAM LAHANU,GEN,NASHIK,15447,2,BSP,10,M,MAHARASHTRA,656525,656071,454,1522672,794591,728081,1.0151234146290207,15457,2.354365789573893
55,VIMALTAI NIVUTTIRAO AVHAD,SC,NASHIK,7917,9,IND,0,F,MAHARASHTRA,656525,656071,454,1522672,794591,728081,0.5199412611514496,7917,1.205894672708579
39,ANSARI MOHAMMED ISMAIL MOHAMMED,GEN,NASHIK,5245,5,BMSM,0,M,MAHARASHTRA,656525,656071,454,1522672,794591,728081,0.34446026458751455,5245,0.7989033167053806
37,LATA BHIKA BARDE,ST,NASHIK,3952,8,IND,0,F,MAHARASHTRA,656525,656071,454,1522672,794591,728081,0.25954374940893377,3952,0.6019572750466471
28,NAVALE SOMNATH NANASAHEB,GEN,NASHIK,3611,6,SVRP,2,M,MAHARASHTRA,656525,656071,454,1522672,794591,728081,0.23728025471014114,3613,0.5503217699249838
45,BHASKAR GANPAT SIRSAT,GEN,NASHIK,2342,7,IND,0,M,MAHARASHTRA,656525,656071,454,1522672,794591,728081,0.15380856809608373,2342,0.35672670499980963
52,HARISCHANDRA DEVRAM CHAVAN,ST,MALEGAON (ST),218129,3,BJP,130,M,MAHARASHTRA,590772,590436,336,1222363,628347,594016,17.855497916739953,218259,36.94470963417359
66,MAHALE HARIBHAU SHANKAR,ST,MALEGAON (ST),213579,5,JD(S),152,M,MAHARASHTRA,590772,590436,336,1222363,628347,594016,17.485067856275098,213731,36.17825489359685
55,GAVIT JIVA PANDU,ST,MALEGAON (ST),113386,2,CPM,50,M,MAHARASHTRA,590772,590436,336,1222363,628347,594016,9.280058378730377,113436,19.201316243830107
36,GAZI AMANULLA MUBIN KHAN,ST,MALEGAON (ST),18936,1,BSP,4,M,MAHARASHTRA,590772,590436,336,1222363,628347,594016,1.5494578942589068,18940,3.205974555327605
75,BHIKA HARISINGH BARDE,ST,MALEGAON (ST),14426,6,IND,0,M,MAHARASHTRA,590772,590436,336,1222363,628347,594016,1.180173156419165,14426,2.441889595309189
50,GAZI ATEJAAD AH KHAN MUBIN AHMED,ST,MALEGAON (ST),11980,4,NLP,0,M,MAHARASHTRA,590772,590436,336,1222363,628347,594016,0.9800689320602799,11980,2.0278550777626565
55,CHAURE BAPU HARI,ST,DHULE (ST),210620,2,INC,94,M,MAHARASHTRA,455571,455308,263,1226114,628624,597490,17.185514560636285,210714,46.25272460275127
64,GAVIT RAMDAS RUPLA,ST,DHULE (ST),202795,1,BJP,154,M,MAHARASHTRA,455571,455308,263,1226114,628624,597490,16.552212926367368,202949,44.54827019279102
40,DR BARDE MACHHINDRANATH SURYABHAN,ST,DHULE (ST),23773,4,IND,3,M,MAHARASHTRA,455571,455308,263,1226114,628624,597490,1.9391345339829738,23776,5.2189450162543265
59,ENGG JADHAV GOVIND SHANKAR,ST,DHULE (ST),18120,3,BSP,12,M,MAHARASHTRA,455571,455308,263,1226114,628624,597490,1.4788184459193843,18132,3.9800601882033755
67,GAVIT MANIKRAO HODLYA,ST,NANDURBAR (ST),351788,1,INC,123,M,MAHARASHTRA,639907,639614,293,1218524,609102,609422,28.880104125975357,351911,54.9940850779879
43,DR NATAWADKAR SUHAS JAYANT,ST,NANDURBAR (ST),244124,2,BJP,166,M,MAHARASHTRA,639907,639614,293,1218524,609102,609422,20.04802531587396,244290,38.17585992964603
39,THAKRE TUKARAM BHAMATA,ST,NANDURBAR (ST),23477,5,BBM,2,M,MAHARASHTRA,639907,639614,293,1218524,609102,609422,1.9268393564673327,23479,3.669126920005563
40,NAIK BABULAL RUPSING,ST,NANDURBAR (ST),11688,3,BSP,2,M,MAHARASHTRA,639907,639614,293,1218524,609102,609422,0.9593573864774104,11690,1.8268279609380738
50,GAVIT SOBAJI DEVALYA,ST,NANDURBAR (ST),8537,4,LRP,0,M,MAHARASHTRA,639907,639614,293,1218524,609102,609422,0.7006017115789266,8537,1.3341001114224411
64,ANNASAHEB M K PATIL,GEN,ERANDOL,289349,2,BJP,210,M,MAHARASHTRA,609800,609393,407,1214861,625341,589520,23.834743233999607,289559,47.48425713348639
58,ADV VASANTRAO JEEVANRAO MORE,GEN,ERANDOL,281242,3,NCP,176,M,MAHARASHTRA,609800,609393,407,1214861,625341,589520,23.164625418051944,281418,46.14922925549361
39,GAUTAM SOMAJI MORE,SC,ERANDOL,18476,1,BSP,15,M,MAHARASHTRA,609800,609393,407,1214861,625341,589520,1.5220671336062315,18491,3.032305673991473
48,DEORE RAJENDRASING BHIMSING,GEN,ERANDOL,10280,4,SP,4,M,MAHARASHTRA,609800,609393,407,1214861,625341,589520,0.846516597372045,10284,1.6864545752705806
44,PATIL SURESH PANDURANG,GEN,ERANDOL,10046,5,HJP,2,M,MAHARASHTRA,609800,609393,407,1214861,625341,589520,0.8270905066505552,10048,1.6477533617579536
63,Y G MAHAJAN (SIR),GEN,JALGAON,298419,3,BJP,446,M,MAHARASHTRA,616969,616073,896,1239241,643911,595330,24.11677793100777,298865,48.44084548818498
44,DR ULHAS VASUDEO PATIL,GEN,JALGAON,277788,1,INC,431,M,MAHARASHTRA,616969,616073,896,1239241,643911,595330,22.450758165683673,278219,45.094486108702384
39,GAWAI RAVINDRA TULSHIRAM,SC,JALGAON,16770,2,BSP,15,M,MAHARASHTRA,616969,616073,896,1239241,643911,595330,1.3544580916867663,16785,2.7205580831451823
29,D D WANI PHOTOGRAPHER,GEN,JALGAON,12252,6,IND,2,M,MAHARASHTRA,616969,616073,896,1239241,643911,595330,0.9888310667577976,12254,1.9861613792589254
63,DADASO P E TATYA PATIL,GEN,JALGAON,7680,4,SP,2,M,MAHARASHTRA,616969,616073,896,1239241,643911,595330,0.6198955651079976,7682,1.245119284761471
45,DAGADU KITAB TADAVI,ST,JALGAON,3164,5,IND,0,M,MAHARASHTRA,616969,616073,896,1239241,643911,595330,0.255317569383195,3164,0.5128296559470573
56,ADSUL ANANDRAO VITHOBA,SC,BULDHANA (SC),369336,1,SHS,639,M,MAHARASHTRA,761264,760202,1062,1196627,620708,575919,30.918155782879715,369975,48.60009142689001
44,MUKUL BALKRUSHNA WASNIK,SC,BULDHANA (SC),309695,3,INC,373,M,MAHARASHTRA,761264,760202,1062,1196627,620708,575919,25.911833846302983,310068,40.73067950146073
59,BHIMRAO SENU JADHAO,SC,BULDHANA (SC),21184,6,BBM,13,M,MAHARASHTRA,761264,760202,1062,1196627,620708,575919,1.7713957649292553,21197,2.7844479707433956
53,KANKAL SITARAM KERUJI,SC,BULDHANA (SC),18223,2,BSP,18,M,MAHARASHTRA,761264,760202,1062,1196627,620708,575919,1.5243680779390736,18241,2.3961464091300786
30,DEVIDAS PIRAJI SARKATE,SC,BULDHANA (SC),17452,10,IND,3,M,MAHARASHTRA,761264,760202,1062,1196627,620708,575919,1.4586834493956764,17455,2.292897076441287
34,SAU ANITA PARMESHWAR GAWAI,SC,BULDHANA (SC),8980,4,ARP,9,F,MAHARASHTRA,761264,760202,1062,1196627,620708,575919,0.7511948167641211,8989,1.1807993022131613
37,KASTURE DIPAK PARASHRAM,SC,BULDHANA (SC),6041,8,IND,4,M,MAHARASHTRA,761264,760202,1062,1196627,620708,575919,0.5051699485303273,6045,0.7940740662897497
26,GHULE SUNITA SUDHAKAR,SC,BULDHANA (SC),3629,9,IND,2,F,MAHARASHTRA,761264,760202,1062,1196627,620708,575919,0.3034362420369923,3631,0.4769698816704849
59,ANANDRAO CHINDHAJI LAHANE,SC,BULDHANA (SC),3101,5,RLD,1,M,MAHARASHTRA,761264,760202,1062,1196627,620708,575919,0.25922864852623245,3102,0.40748019084049686
39,ANIL GULABRAO WANKHEDE,SC,BULDHANA (SC),2561,7,IND,0,M,MAHARASHTRA,761264,760202,1062,1196627,620708,575919,0.21401823625908492,2561,0.33641417432060366
43,DHOTRE SANJAY SHAMRAO,GEN,AKOLA,312599,2,BJP,724,M,MAHARASHTRA,735372,733965,1407,1271055,662274,608781,24.650624874612035,313323,42.60741502260081
63,LAXMANRAO TAYADE,GEN,AKOLA,206525,3,INC,427,M,MAHARASHTRA,735372,733965,1407,1271055,662274,608781,16.28190754924059,206952,28.142491147337672
49,AMBEDKAR PRAKASH YASHWANT,SC,AKOLA,186968,4,BBM,234,M,MAHARASHTRA,735372,733965,1407,1271055,662274,608781,14.728080216827754,187202,25.456775618326503
60,TAYADE VISHRAM NATTHUJI,SC,AKOLA,9937,1,BSP,14,M,MAHARASHTRA,735372,733965,1407,1271055,662274,608781,0.7828929511311469,9951,1.3531926698324113
40,RAJA MOTIRAMJI SHAMBHARKAR,SC,AKOLA,8625,7,IND,3,M,MAHARASHTRA,735372,733965,1407,1271055,662274,608781,0.678806188559897,8628,1.1732837257877646
72,JOSHI SHALIGRAM MOHANLAL,GEN,AKOLA,5755,5,ABHM,1,M,MAHARASHTRA,735372,733965,1407,1271055,662274,608781,0.45285215824649605,5756,0.7827330929107988
37,SHAIKH MUKIM AHEMAD ABDUL RASHID,GEN,AKOLA,3556,6,SP,4,M,MAHARASHTRA,735372,733965,1407,1271055,662274,608781,0.28008229384251665,3560,0.48410872320403825
29,GAWALI (PATIL) KU BHAVANA PUNDLIKRAO,GEN,WASHIM,358072,1,SHS,610,F,MAHARASHTRA,720723,719643,1080,1151886,593720,558166,31.138671708832298,358682,49.76697011195702
59,NAIK MANOHAR RAJUSING,GEN,WASHIM,297338,3,NCP,446,M,MAHARASHTRA,720723,719643,1080,1151886,593720,558166,25.85186381291204,297784,41.31739933372461
57,DR JADHAV RAVI SAMPATRAO,GEN,WASHIM,21927,2,BSP,16,M,MAHARASHTRA,720723,719643,1080,1151886,593720,558166,1.9049628175010374,21943,3.0445816215106216
39,S WAHIDDODDIN S KARIMODDIN,GEN,WASHIM,14085,12,IND,0,M,MAHARASHTRA,720723,719643,1080,1151886,593720,558166,1.2227772539990938,14085,1.9542875695655615
47,JAGIRDAR SHAMSHODDIN AINNODDIN,GEN,WASHIM,6842,4,LRP,0,M,MAHARASHTRA,720723,719643,1080,1151886,593720,558166,0.5939823906185161,6842,0.9493244977612758
36,KAMBLE SHILANAND LAXMANRAO,SC,WASHIM,5226,8,IND,0,M,MAHARASHTRA,720723,719643,1080,1151886,593720,558166,0.4536907298118043,5226,0.7251052068547833
46,PATHAK MOHAN DATTATRAYA,GEN,WASHIM,3826,10,IND,1,M,MAHARASHTRA,720723,719643,1080,1151886,593720,558166,0.33223773880401364,3827,0.53099457072967
37,SHEKH MUKIM AHAMAD ABDUL RASHID,GEN,WASHIM,3515,6,SP,0,M,MAHARASHTRA,720723,719643,1080,1151886,593720,558166,0.30515172508390587,3515,0.4877047076338621
30,BENIWALE SALIM GANGUBHAI,GEN,WASHIM,2668,11,IND,0,M,MAHARASHTRA,720723,719643,1080,1151886,593720,558166,0.2316201429655365,2668,0.37018382929363985
35,YASHWANT SUKHDEV PATIL,SC,WASHIM,2430,5,ARP,6,M,MAHARASHTRA,720723,719643,1080,1151886,593720,558166,0.21147926096853334,2436,0.3379939310941929
33,KAMBLE UTTAM BHAGAJI,SC,WASHIM,1962,7,IND,1,M,MAHARASHTRA,720723,719643,1080,1151886,593720,558166,0.17041616965567774,1963,0.2723653886444584
52,DEBAJE ABUJI ALIES PRALHADRAO ASHRUJI,SC,WASHIM,1752,9,IND,0,M,MAHARASHTRA,720723,719643,1080,1151886,593720,558166,0.1520983847359895,1752,0.24308923123030624
48,ANANT GUDHE,GEN,AMRAVATI,202889,1,SHS,327,M,MAHARASHTRA,676421,675653,768,1204881,632275,572606,16.86606395154376,203216,30.042828356896074
33,OMPRAKASH ALIAS BACCHU BABARAOJI,GEN,AMRAVATI,188778,6,IND,204,M,MAHARASHTRA,676421,675653,768,1204881,632275,572606,15.684702472692324,188982,27.93851758002782
74,DADASAHEB R S GAWAI,SC,AMRAVATI,150728,3,RPI,174,M,MAHARASHTRA,676421,675653,768,1204881,632275,572606,12.524224383984809,150902,22.308887512362862
49,HAJI RAFIQUE SETH,GEN,AMRAVATI,78572,10,IND,34,M,MAHARASHTRA,676421,675653,768,1204881,632275,572606,6.523963777335687,78606,11.620869251546004
51,SEMALKAR RONYA CHHOTELAL,ST,AMRAVATI,31548,2,BSP,25,M,MAHARASHTRA,676421,675653,768,1204881,632275,572606,2.6204247556397684,31573,4.6676552028987865
49,JAWARKAR NAMDEORAO SHALIGRAMJI,GEN,AMRAVATI,8324,4,BBM,3,M,MAHARASHTRA,676421,675653,768,1204881,632275,572606,0.6911055946603856,8327,1.2310380665295726
42,DNYANESHWAR RAURALE,SC,AMRAVATI,4132,5,ARP,0,M,MAHARASHTRA,676421,675653,768,1204881,632275,572606,0.34293843126416634,4132,0.6108621701573429
37,BANDU SAMPATRAO SANE (BANDYA),GEN,AMRAVATI,4029,9,IND,0,M,MAHARASHTRA,676421,675653,768,1204881,632275,572606,0.33438986920700053,4029,0.595634966980623
63,KALMEGH NAMDEO MOTIRAM,GEN,AMRAVATI,3336,7,IND,1,M,MAHARASHTRA,676421,675653,768,1204881,632275,572606,0.2769568115025467,3337,0.49333181554091315
43,GAJANAN NAGORAO LONDE,GEN,AMRAVATI,3317,8,IND,0,M,MAHARASHTRA,676421,675653,768,1204881,632275,572606,0.27529689653999023,3317,0.49037507705999667
42,MOHITE SUBODH BABURAO,GEN,RAMTEK,276598,2,SHS,122,M,MAHARASHTRA,647483,647268,215,1148759,606230,542529,24.088603440756504,276720,42.73780161023532
49,DR SHRIKANT JICHKAR,GEN,RAMTEK,262550,3,INC,68,M,MAHARASHTRA,647483,647268,215,1148759,606230,542529,22.861017846214914,262618,40.55982937003751
46,PROF CHANDANSINGH PREMSINGH ROTELE,GEN,RAMTEK,55423,1,BSP,19,M,MAHARASHTRA,647483,647268,215,1148759,606230,542529,4.826251633284266,55442,8.562695854562977
55,TEKAM VASUDEORAO ZITUJI,ST,RAMTEK,15643,5,GGP,4,M,MAHARASHTRA,647483,647268,215,1148759,606230,542529,1.3620785560766009,15647,2.4165885436374395
37,SOFI MAHAMMAD JUNEDBABA,GEN,RAMTEK,12109,10,IND,0,M,MAHARASHTRA,647483,647268,215,1148759,606230,542529,1.054094026684448,12109,1.8701649309711608
69,KESHAORAO SHENDE,GEN,RAMTEK,9046,4,VRP,0,M,MAHARASHTRA,647483,647268,215,1148759,606230,542529,0.7874584660490146,9046,1.3971023177442496
27,CHANDRASHEKHAR NAMDEORAO BHIMATE,SC,RAMTEK,4671,8,IND,0,M,MAHARASHTRA,647483,647268,215,1148759,606230,542529,0.40661270118449566,4671,0.7214089018553382
36,TIWARI DINESH SHIVSHANKAR,GEN,RAMTEK,4664,9,IND,0,M,MAHARASHTRA,647483,647268,215,1148759,606230,542529,0.4060033479607124,4664,0.7203277923899161
30,BABAN PARASRAM TAYWADE,GEN,RAMTEK,3584,7,ARP,2,M,MAHARASHTRA,647483,647268,215,1148759,606230,542529,0.31216295149809486,3586,0.5538369347148883
38,NAYANA DHAWAD (PANDE),GEN,RAMTEK,2980,6,VJC,0,F,MAHARASHTRA,647483,647268,215,1148759,606230,542529,0.25941037241057524,2980,0.46024374385118993
55,VILAS MUTTEMWAR,GEN,NAGPUR,373682,3,INC,87,M,MAHARASHTRA,792451,792180,271,1630894,851771,779123,22.91804372325853,373769,47.16619702669313
62,ATALBAHADURSINGH,GEN,NAGPUR,274158,1,BJP,128,M,MAHARASHTRA,792451,792180,271,1630894,851771,779123,16.81813778209988,274286,34.61236089045253
30,JAYANTA ANANT DALVI,GEN,NAGPUR,57011,2,BSP,16,M,MAHARASHTRA,792451,792180,271,1630894,851771,779123,3.496671150914774,57027,7.196280905696377
47,PRAKASH NIMAJE,ST,NAGPUR,37056,13,IND,17,M,MAHARASHTRA,792451,792180,271,1630894,851771,779123,2.273170420640459,37073,4.678270328386234
63,BANWARILAL BHAGWANDAS PUROHIT,GEN,NAGPUR,27911,5,VRP,17,M,MAHARASHTRA,792451,792180,271,1630894,851771,779123,1.7124350203017484,27928,3.524255758400204
61,DR BANMALA GOLPELWAR,GEN,NAGPUR,8086,14,IND,0,F,MAHARASHTRA,792451,792180,271,1630894,851771,779123,0.4958016891349162,8086,1.0203785470647395
49,DIWAKAR DHONDBAJI PATNE,GEN,NAGPUR,6117,4,VJC,0,M,MAHARASHTRA,792451,792180,271,1630894,851771,779123,0.37507036018282,6117,0.7719089255991853
55,DIWARE RAMDAS RAJERAM,GEN,NAGPUR,2520,12,IND,0,M,MAHARASHTRA,792451,792180,271,1630894,851771,779123,0.15451647991837605,2520,0.3180007344302676
37,RAMMURTI KESHVRAO CHIMOTE,ST,NAGPUR,1550,6,GGP,0,M,MAHARASHTRA,792451,792180,271,1630894,851771,779123,0.09503989836249321,1550,0.1955956898281408
61,DR K H JAMBHULKAR,SC,NAGPUR,1158,11,IND,0,M,MAHARASHTRA,792451,792180,271,1630894,851771,779123,0.07100400148630139,1158,0.14612890891676583
39,SANJAY SAOJI DESHPANDE,SC,NAGPUR,816,7,HJP,0,M,MAHARASHTRA,792451,792180,271,1630894,851771,779123,0.0500339077830932,816,0.10297166638694379
38,IQBALSINGH HAJARASINGH SALHOTRA,SC,NAGPUR,811,9,IND,0,M,MAHARASHTRA,792451,792180,271,1630894,851771,779123,0.04972732746579483,811,0.10234071254878851
60,HAJARE BHAJANDAS DAYARAM,SC,NAGPUR,669,8,ARP,6,M,MAHARASHTRA,792451,792180,271,1630894,851771,779123,0.0413883428352793,675,0.08517876815096453
43,KURVE SIDDARTHA ASARAM,SC,NAGPUR,635,10,IND,0,M,MAHARASHTRA,792451,792180,271,1630894,851771,779123,0.038935700296892375,635,0.08013113744572219
37,PATLE SHISHUPAL NATTHU,GEN,BHANDARA,277034,2,BJP,354,M,MAHARASHTRA,680476,679727,749,1006061,505131,500930,27.57168799903783,277388,40.7638182683886
47,PRAFUL PATEL,GEN,BHANDARA,274054,3,NCP,325,M,MAHARASHTRA,680476,679727,749,1006061,505131,500930,27.272600766752713,274379,40.32162780171527
30,AJABLAL,GEN,BHANDARA,90605,1,BSP,67,M,MAHARASHTRA,680476,679727,749,1006061,505131,500930,9.012574784232767,90672,13.324790293853125
34,AMKAR GYANIRAM BAJIRAO,GEN,BHANDARA,14574,6,IND,1,M,MAHARASHTRA,680476,679727,749,1006061,505131,500930,1.448719312248462,14575,2.1418830348168045
70,DR SALAM HARISHCHANDRA BHIVRAM,ST,BHANDARA,12706,5,GGP,1,M,MAHARASHTRA,680476,679727,749,1006061,505131,500930,1.2630446861572011,12707,1.8673693120697863
49,JAYASWAL VIRENDRAKUMAR,GEN,BHANDARA,10754,4,BBM,1,M,MAHARASHTRA,680476,679727,749,1006061,505131,500930,1.06902066574492,10755,1.5805112891564141
64,SHIVANKAR MAHADEORAO SUKAJI,GEN,CHIMUR,336274,2,BJP,437,M,MAHARASHTRA,775523,774689,834,1113832,572972,540860,30.22996286693146,336711,43.417280983284826
60,PROF JOGENDRA KAWADE,GEN,CHIMUR,237641,6,PRBP,296,M,MAHARASHTRA,775523,774689,834,1113832,572972,540860,21.36201868863527,237937,30.68084376607786
37,ER KUTHE YOGRAJ KRISHNAJI,GEN,CHIMUR,75022,1,BSP,77,M,MAHARASHTRA,775523,774689,834,1113832,572972,540860,6.742399212807676,75099,9.68365864068506
25,JITENDRA ADKU RAUT,SC,CHIMUR,28591,12,IND,0,M,MAHARASHTRA,775523,774689,834,1113832,572972,540860,2.5669041650805506,28591,3.6866733804155385
58,ADV DADASAHEB ALIAS BHIKAJI WALTHARE,GEN,CHIMUR,22357,8,BBM,6,M,MAHARASHTRA,775523,774689,834,1113832,572972,540860,2.0077534134411654,22363,2.8836024205600608
52,RAUT DEORAO JAGANNATH,GEN,CHIMUR,16864,15,IND,0,M,MAHARASHTRA,775523,774689,834,1113832,572972,540860,1.5140523885110142,16864,2.174532541265701
61,UIKE SAKHARAM KAWADUJI,ST,CHIMUR,11363,3,GGP,3,M,MAHARASHTRA,775523,774689,834,1113832,572972,540860,1.0204411437272407,11366,1.4655916072121653
40,ADV EKNATH BAVANKAR,GEN,CHIMUR,10283,4,SP,6,M,MAHARASHTRA,775523,774689,834,1113832,572972,540860,0.9237479260786188,10289,1.3267175828440936
52,KATAKWAR JAYANT KRISHNAMURARI,GEN,CHIMUR,6858,9,IND,6,M,MAHARASHTRA,775523,774689,834,1113832,572972,540860,0.6162509247355077,6864,0.8850801330199104
31,BHOYAR VINOD NARENDRA,SC,CHIMUR,6134,14,IND,0,M,MAHARASHTRA,775523,774689,834,1113832,572972,540860,0.5507114178798957,6134,0.7909501072179679
46,QURESHI MOHAMMAD IKHALAK MO YUSUF,GEN,CHIMUR,5646,10,IND,0,M,MAHARASHTRA,775523,774689,834,1113832,572972,540860,0.506898706447651,5646,0.7280248296955733
55,CHARANDAS JANGLUJI MESHRAM,SC,CHIMUR,4703,11,IND,0,M,MAHARASHTRA,775523,774689,834,1113832,572972,540860,0.42223602841362073,4703,0.6064294675979951
36,GAUTAM RAMCHNADRA JANBANDHU,SC,CHIMUR,4693,5,PRCP,0,M,MAHARASHTRA,775523,774689,834,1113832,572972,540860,0.4213382269498452,4693,0.6051400151897494
67,ADV THENGRI NATTHUJI NARAYAN,GEN,CHIMUR,4523,7,RLD,3,M,MAHARASHTRA,775523,774689,834,1113832,572972,540860,0.40634494250479425,4526,0.5836061599720447
78,DAMODAR LAXMANRAO KALE,GEN,CHIMUR,3737,13,IND,0,M,MAHARASHTRA,775523,774689,834,1113832,572972,540860,0.3355084070129068,3737,0.4818683649614518
49,AHIR HANSRAJ GANGARAM,GEN,CHANDRAPUR,365619,1,BJP,395,M,MAHARASHTRA,841144,840271,873,1329746,690511,639235,27.525106298496105,366014,43.51383354098704
55,NARESH PUGLIA,GEN,CHANDRAPUR,305841,2,INC,350,M,MAHARASHTRA,841144,840271,873,1329746,690511,639235,23.02627719880338,306191,36.40173382916599
42,RAJENDRA VAIDYA,GEN,CHANDRAPUR,104299,3,BSP,117,M,MAHARASHTRA,841144,840271,873,1329746,690511,639235,7.852326684945847,104416,12.413570090258029
36,DIWAKAR GULAB PENDAM,GEN,CHANDRAPUR,26834,11,IND,3,M,MAHARASHTRA,841144,840271,873,1329746,690511,639235,2.0182049805000357,26837,3.1905357465546924
59,DR VASANT RUSHI MAHESHKAR (MASRAM),ST,CHANDRAPUR,9272,6,BBM,5,M,MAHARASHTRA,841144,840271,873,1329746,690511,639235,0.6976520327942328,9277,1.1029027134474
30,TAYARA CHHOTU SHEIKH (PASHA),GEN,CHANDRAPUR,8805,10,IND,0,F,MAHARASHTRA,841144,840271,873,1329746,690511,639235,0.6621565321497489,8805,1.046788659254539
64,GURUDAS KAMBLE GURUJI,SC,CHANDRAPUR,5114,9,IND,0,M,MAHARASHTRA,841144,840271,873,1329746,690511,639235,0.38458472520315906,5114,0.6079815108946862
49,DEOTALE CHANDRASHEKHAR DIGAMBAR,GEN,CHANDRAPUR,4656,4,ARP,2,M,MAHARASHTRA,841144,840271,873,1329746,690511,639235,0.3502924618686576,4658,0.5537696280303966
50,KHARTAD LOMESH MAROTI,SC,CHANDRAPUR,3528,8,IND,0,M,MAHARASHTRA,841144,840271,873,1329746,690511,639235,0.26531382685114296,3528,0.41942877795003
49,DR ARUN GOPALRAO DESHPANDE,GEN,CHANDRAPUR,3454,7,IND,0,M,MAHARASHTRA,841144,840271,873,1329746,690511,639235,0.2597488542924739,3454,0.4106312355553865
36,NAGDEOTE SEOCHANDRA SHALIKRAM,SC,CHANDRAPUR,2849,5,PRCP,1,M,MAHARASHTRA,841144,840271,873,1329746,690511,639235,0.21432664584063424,2850,0.3388242679018099
42,WAGMARE SURESH GANAPAT,GEN,WARDHA,268894,3,BJP,151,M,MAHARASHTRA,626105,625843,262,1144924,599009,545915,23.498939667611126,269045,42.97122687089227
69,PRABHATAI RAU,GEN,WARDHA,265772,1,INC,85,F,MAHARASHTRA,626105,625843,262,1144924,599009,545915,23.220493237979113,265857,42.46204710072592
35,SOMRAJ SHESHRAOJI TELKHEDE (PATIL),GEN,WARDHA,53996,4,BSP,13,M,MAHARASHTRA,626105,625843,262,1144924,599009,545915,4.717256341905664,54009,8.626188898028285
41,YESHWANT NAMDEORAO ZADE,GEN,WARDHA,14817,2,CPM,6,M,MAHARASHTRA,626105,625843,262,1144924,599009,545915,1.2946710873385483,14823,2.3674942701304094
44,RAUT JAGANNATHRAO NILKANTHRAO,GEN,WARDHA,9845,7,SVRP,0,M,MAHARASHTRA,626105,625843,262,1144924,599009,545915,0.8598824026747627,9845,1.5724199615080536
55,UBALE SHRIKRUSHNA CHAMPATRAO,GEN,WARDHA,6986,5,ARP,5,M,MAHARASHTRA,626105,625843,262,1144924,599009,545915,0.6106082150430946,6991,1.11658587617093
59,CHIDAM NARAYANRAO RAMJI,ST,WARDHA,5533,6,GGP,2,M,MAHARASHTRA,626105,625843,262,1144924,599009,545915,0.48343820201166193,5535,0.884037022544142
50,RATHOD HARISING NASARU,GEN,YAVATMAL,298037,3,BJP,476,M,MAHARASHTRA,663978,663001,977,1133605,586109,547496,26.33307016112314,298513,44.95826668955899
59,PATIL UTTAMRAO DEORAOJI,GEN,YAVATMAL,241300,2,INC,409,M,MAHARASHTRA,663978,663001,977,1133605,586109,547496,21.322153660225563,241709,36.403163960251696
47,AGARWAL RAMESH PANDURANG,GEN,YAVATMAL,30086,1,BSP,51,M,MAHARASHTRA,663978,663001,977,1133605,586109,547496,2.6585097983865635,30137,4.538855203033836
46,KISHORBHAU TIWARI,GEN,YAVATMAL,26906,5,SP,21,M,MAHARASHTRA,663978,663001,977,1133605,586109,547496,2.375342381164515,26927,4.0554054501805785
58,SHITAL KAWADU MARKAM,ST,YAVATMAL,23985,6,GGP,10,M,MAHARASHTRA,663978,663001,977,1133605,586109,547496,2.116698497271978,23995,3.6138245544280077
43,ANAND BALIRAM GAIKWAD,GEN,YAVATMAL,15263,4,BBM,10,M,MAHARASHTRA,663978,663001,977,1133605,586109,547496,1.3472946925957454,15273,2.300226814743862
49,KUMBHEKAR DAMADU NAGORAO,ST,YAVATMAL,12297,7,IND,0,M,MAHARASHTRA,663978,663001,977,1133605,586109,547496,1.0847693861618464,12297,1.8520191934070105
43,PURUSHOTTAM DOMAJI BHAJGAWARE,ST,YAVATMAL,10865,9,IND,0,M,MAHARASHTRA,663978,663001,977,1133605,586109,547496,0.958446725270266,10865,1.6363493971185792
34,GULHANE SANJAY MAHADEORAO,GEN,YAVATMAL,4262,8,IND,0,M,MAHARASHTRA,663978,663001,977,1133605,586109,547496,0.37596870162005286,4262,0.6418887372774399
55,SURYAKANTA PATIL,GEN,HINGOLI,327667,3,NCP,277,F,MAHARASHTRA,728325,727547,778,1189303,607488,581815,27.574470088783094,327944,45.02715134040435
44,SHIVAJI GYANBARAO MANE,GEN,HINGOLI,314928,2,SHS,471,M,MAHARASHTRA,728325,727547,778,1189303,607488,581815,26.51965058525876,315399,43.30470600350119
30,RATHOD MADHAVI PARSHURAM,GEN,HINGOLI,29640,1,BSP,22,F,MAHARASHTRA,728325,727547,778,1189303,607488,581815,2.4940658520158445,29662,4.072632409981808
26,RATHOD SANJAYKUMAR TULSHIRAM,GEN,HINGOLI,24964,5,BBM,7,M,MAHARASHTRA,728325,727547,778,1189303,607488,581815,2.0996331464731863,24971,3.428551814093983
25,ADV PUNJABRAO RAMDHAN CHAVAN,GEN,HINGOLI,12651,7,IND,0,M,MAHARASHTRA,728325,727547,778,1189303,607488,581815,1.0637322868940884,12651,1.7369992791679538
58,UTTAMRAO DAGDUJI BHAGAT,SC,HINGOLI,11039,4,PRCP,1,M,MAHARASHTRA,728325,727547,778,1189303,607488,581815,0.9282747962462047,11040,1.515806817011636
44,CHAVAN GOVIND BHIKU,GEN,HINGOLI,6658,6,IND,0,M,MAHARASHTRA,728325,727547,778,1189303,607488,581815,0.5598236950550028,6658,0.9141523358390827
52,D B PATIL,GEN,NANDED,360454,2,BJP,828,M,MAHARASHTRA,800145,798771,1374,1445611,738647,706964,24.99164713052128,361282,45.152066188003424
60,KHATGAONKAR BHASKARRAO BAPURAO,GEN,NANDED,336450,1,INC,497,M,MAHARASHTRA,800145,798771,1374,1445611,738647,706964,23.308275877812218,336947,42.11074242793494
46,GAIKWAD SURESH DNYANOBA,SC,NANDED,42273,5,BBM,34,M,MAHARASHTRA,800145,798771,1374,1445611,738647,706964,2.92658260071347,42307,5.287416655731149
37,SHAIKH (TAMBOLI) WAHIDA,GEN,NANDED,23826,3,BSP,6,F,MAHARASHTRA,800145,798771,1374,1445611,738647,706964,1.6485762767438819,23832,2.97846015409707
37,YADAV MANOHAR SAHEBRAO,GEN,NANDED,13009,13,IND,0,M,MAHARASHTRA,800145,798771,1374,1445611,738647,706964,0.8998963068211296,13009,1.6258303182548162
51,BORGAONKAR NIVRUTI VITHALRAO,SC,NANDED,4120,12,IND,0,M,MAHARASHTRA,800145,798771,1374,1445611,738647,706964,0.28500059836290675,4120,0.5149066731654888
32,(NAIK) DEVKATTE VENKATRAO NARSINGRAO,GEN,NANDED,3660,6,RSPS,3,M,MAHARASHTRA,800145,798771,1374,1445611,738647,706964,0.253387667913429,3663,0.4577920251954333
44,ALTAF AHMED SAANI SK AMIR,GEN,NANDED,3303,4,LRP,1,M,MAHARASHTRA,800145,798771,1374,1445611,738647,706964,0.22855387791044757,3304,0.4129251573152366
35,"""AIDS MAN"" PRAKASH TATERAO LANDGE",SC,NANDED,2786,11,IND,1,M,MAHARASHTRA,800145,798771,1374,1445611,738647,706964,0.19279045331005365,2787,0.3483118684738391
58,NARAYAN SATVAJI SURESHI,SC,NANDED,2432,10,IND,2,M,MAHARASHTRA,800145,798771,1374,1445611,738647,706964,0.16837171272216386,2434,0.3041948646807766
36,ADV C S BAHETI,GEN,NANDED,2373,7,JP,0,M,MAHARASHTRA,800145,798771,1374,1445611,738647,706964,0.16415204366873246,2373,0.29657124646157884
36,ADV DEELIP PRABHAKARRAO KULKARNI,GEN,NANDED,2309,9,IND,1,M,MAHARASHTRA,800145,798771,1374,1445611,738647,706964,0.15979402481027055,2310,0.28869767354666964
35,JADHAV VISHNU MAROTI,SC,NANDED,1776,8,IND,1,M,MAHARASHTRA,800145,798771,1374,1445611,738647,706964,0.12292380176963234,1777,0.22208474713958098
46,TUKARAM GANPATRAO RENGE PATIL,GEN,PARBHANI,338978,1,SHS,340,M,MAHARASHTRA,675985,675418,567,1155668,584538,571130,29.361200621631816,339318,50.19608423263829
52,SURESH AMBADASRAO WARPUDKAR,GEN,PARBHANI,282926,2,NCP,221,M,MAHARASHTRA,675985,675418,567,1155668,584538,571130,24.50072166054611,283147,41.88658032352789
42,GAFFAR MASTER,GEN,PARBHANI,17731,3,SP,5,M,MAHARASHTRA,675985,675418,567,1155668,584538,571130,1.534696816040593,17736,2.623726857844479
33,SONWANE RAJESH NAMDEV,SC,PARBHANI,17083,8,IND,0,M,MAHARASHTRA,675985,675418,567,1155668,584538,571130,1.4781926989412184,17083,2.527127081222216
48,SHAIKH MOIN SHAIKH JAFAR,GEN,PARBHANI,5692,7,IND,0,M,MAHARASHTRA,675985,675418,567,1155668,584538,571130,0.4925289962169066,5692,0.8420305184286634
39,CHAUDHARI TUKARAM NAMDEVRAO,GEN,PARBHANI,5607,6,IND,0,M,MAHARASHTRA,675985,675418,567,1155668,584538,571130,0.48517394268942293,5607,0.8294562749173429
45,RUMALE TUKARAM DHONDIBA,SC,PARBHANI,3772,4,PRCP,1,M,MAHARASHTRA,675985,675418,567,1155668,584538,571130,0.3264778465787752,3773,0.5581484796260272
36,SHAIKH AKHIL SHAIKH RAHIM,GEN,PARBHANI,3629,5,NLP,0,M,MAHARASHTRA,675985,675418,567,1155668,584538,571130,0.31401752060280286,3629,0.5368462317950842
49,DANVE RAOSAHEB DADARAO PATIL,GEN,JALNA,369353,2,BJP,277,M,MAHARASHTRA,756365,755991,374,1242929,634182,608747,29.738625456482225,369630,48.869262855896295
52,PAWAR UTTAMSINGH RAJDHARSINGH,GEN,JALNA,308224,3,INC,74,M,MAHARASHTRA,756365,755991,374,1242929,634182,608747,24.80415212775629,308298,40.76047939817416
43,SHAIKH FEROJ ALI,GEN,JALNA,17572,14,IND,0,M,MAHARASHTRA,756365,755991,374,1242929,634182,608747,1.4137573425352534,17572,2.3232169653540287
28,SOW ARCHANA MILIND KHILLARE,SC,JALNA,17104,1,BSP,11,F,MAHARASHTRA,756365,755991,374,1242929,634182,608747,1.376989353374167,17115,2.262796401208411
33,GADEKAR RAMU,GEN,JALNA,11992,4,BBM,1,M,MAHARASHTRA,756365,755991,374,1242929,634182,608747,0.9648982363433471,11993,1.5856101220971357
67,SHAIKH USMAN HUSSAIN,GEN,JALNA,8174,13,IND,0,M,MAHARASHTRA,756365,755991,374,1242929,634182,608747,0.6576401387368064,8174,1.0806951670159248
45,SHINDE BABASAHEB,GEN,JALNA,5787,12,IND,2,M,MAHARASHTRA,756365,755991,374,1242929,634182,608747,0.465754681079933,5789,0.7653712162778553
49,TANPURE SHIVAJI ARJUNRAO,GEN,JALNA,3490,5,SVRP,3,M,MAHARASHTRA,756365,755991,374,1242929,634182,608747,0.2810297289708422,3493,0.46181407124866963
41,PACHARE PANDIT,SC,JALNA,3087,11,IND,0,M,MAHARASHTRA,756365,755991,374,1242929,634182,608747,0.24836495085399085,3087,0.4081362834081429
39,GARBADE PARMESHWAR,SC,JALNA,2555,7,IND,0,M,MAHARASHTRA,756365,755991,374,1242929,634182,608747,0.2055628278043235,2555,0.3377998717550389
45,CHECHANI RAJENDRAKUMAR,GEN,JALNA,2412,8,IND,4,M,MAHARASHTRA,756365,755991,374,1242929,634182,608747,0.19437956633082018,2416,0.319422501041164
28,NADE DYANESHWAR DAGDU,SC,JALNA,2326,10,IND,2,M,MAHARASHTRA,756365,755991,374,1242929,634182,608747,0.1872995159015519,2328,0.30778790663237987
54,SHAIKH YAKUB SK HUSSAIN ANSARI,GEN,JALNA,2126,6,BMSM,0,M,MAHARASHTRA,756365,755991,374,1242929,634182,608747,0.1710475819616406,2126,0.2810812240122163
34,DHABE BHAGWAN NAMDEV,SC,JALNA,1789,9,IND,0,M,MAHARASHTRA,756365,755991,374,1242929,634182,608747,0.14393420702228366,1789,0.23652601587857716
52,CHANDRAKANT KHAIRE,GEN,AURANGABAD,477191,1,SHS,709,M,MAHARASHTRA,912571,911541,1030,1636117,847300,788817,29.209402506055497,477900,52.36852803781843
65,RAMKRUSHNA BABA PATIL,GEN,AURANGABAD,355703,3,INC,274,M,MAHARASHTRA,912571,911541,1030,1636117,847300,788817,21.757429328098173,355977,39.008142928057104
52,MADHAVRAO HARIBHAU BAORDE,SC,AURANGABAD,22499,2,BSP,28,M,MAHARASHTRA,912571,911541,1030,1636117,847300,788817,1.3768575230255538,22527,2.4685202576018743
48,SHAIKH SALIM KHAIRODIN,GEN,AURANGABAD,18994,11,IND,2,M,MAHARASHTRA,912571,911541,1030,1636117,847300,788817,1.1610416614459724,18996,2.081591459732996
28,NASER NAHADI MAHMAD YAHYA NAHADI,GEN,AURANGABAD,8952,6,SP,3,M,MAHARASHTRA,912571,911541,1030,1636117,847300,788817,0.5473324951699664,8955,0.9812935103131701
37,ABDUL MAJED QURESHI ALIAS KAISER,GEN,AURANGABAD,7425,4,NLP,4,M,MAHARASHTRA,912571,911541,1030,1636117,847300,788817,0.45406288181101967,7429,0.8140736446807975
37,LAHU HANUMANTRAO SHEWALE,GEN,AURANGABAD,5923,8,LRP,1,M,MAHARASHTRA,912571,911541,1030,1636117,847300,788817,0.3620767952414161,5924,0.6491549698598794
43,PRAKASH BHAURAO NIKALJE,SC,AURANGABAD,4556,9,IND,1,M,MAHARASHTRA,912571,911541,1030,1636117,847300,788817,0.27852531328749713,4557,0.49935840608566345
52,MORE GANGADHAR LAKHAJI,SC,AURANGABAD,4551,10,IND,1,M,MAHARASHTRA,912571,911541,1030,1636117,847300,788817,0.27821971167098686,4552,0.49881050351150763
51,BIRAJDAR SHARNAPPA KALAPPA ALIAS,GEN,AURANGABAD,3584,7,HJP,5,M,MAHARASHTRA,912571,911541,1030,1636117,847300,788817,0.219360840331101,3589,0.39328446772908626
39,ENGI DUSHYANT ATHAWALE,SC,AURANGABAD,2163,5,PRP,2,M,MAHARASHTRA,912571,911541,1030,1636117,847300,788817,0.13232549994896453,2165,0.23724181460949342
53,JAISINGRAO GAIKWAD PATIL,GEN,BEED,424327,1,NCP,724,M,MAHARASHTRA,884234,882534,1700,1319891,676447,643444,32.20349256112816,425051,48.069967904423486
50,SOLANKE PRAKASH SUNDARRAO,GEN,BEED,376681,3,BJP,958,M,MAHARASHTRA,884234,882534,1700,1319891,676447,643444,28.611377757708777,377639,42.7080388223027
67,MIRZA ABDUL BAIG AMIR BAIG,GEN,BEED,22815,6,IND,1,M,MAHARASHTRA,884234,882534,1700,1319891,676447,643444,1.7286275912177598,22816,2.580312451228973
38,SOLANKE PRAKASH BHAGWANRAO,GEN,BEED,19139,8,IND,1,M,MAHARASHTRA,884234,882534,1700,1319891,676447,643444,1.4501197447364973,19140,2.1645853925544594
50,SYED MOINODDIN SYED BASHIRODDIN,GEN,BEED,17395,2,BSP,13,M,MAHARASHTRA,884234,882534,1700,1319891,676447,643444,1.3188967876892865,17408,1.968709640208361
29,DODTALE BALASAHEB PRABHAKAR,GEN,BEED,12241,4,RSPS,3,M,MAHARASHTRA,884234,882534,1700,1319891,676447,643444,0.9276523591720832,12244,1.3847013347145665
39,SHAIKH AKHIL USMAN,GEN,BEED,5487,7,IND,0,M,MAHARASHTRA,884234,882534,1700,1319891,676447,643444,0.4157161462575319,5487,0.6205370976460982
35,KIRVALE PRAMOD SOMNATH,SC,BEED,4449,5,IND,0,M,MAHARASHTRA,884234,882534,1700,1319891,676447,643444,0.33707328862762154,4449,0.5031473569213579
47,PATIL RUPATAI DILIPRAO NILANGEKAR,GEN,LATUR,403541,1,BJP,959,F,MAHARASHTRA,822355,820749,1606,1293202,674423,618779,31.278949460331795,404500,49.18800274820485
68,PATIL SHIVRAJ VISHWANATH,GEN,LATUR,372990,2,INC,619,M,MAHARASHTRA,822355,820749,1606,1293202,674423,618779,28.890227512793825,373609,45.43159584364417
36,ADV LAXMAN NARHARI SHINDE,GEN,LATUR,13458,3,BSP,7,M,MAHARASHTRA,822355,820749,1606,1293202,674423,618779,1.0412139789452846,13465,1.6373707218901812
57,DNYOSO KONDEKAR ALIAS VIJAYPRAKASH,GEN,LATUR,12459,12,IND,0,M,MAHARASHTRA,822355,820749,1606,1293202,674423,618779,0.9634225743541999,12459,1.5150391254385271
28,SHAIKH KALIM ALLAHBAKSHA,GEN,LATUR,4588,11,IND,1,M,MAHARASHTRA,822355,820749,1606,1293202,674423,618779,0.35485562193686676,4589,0.5580315070741955
49,ADV BABURAO BANDGAR,GEN,LATUR,3292,8,LRP,5,M,MAHARASHTRA,822355,820749,1606,1293202,674423,618779,0.25494856951968836,3297,0.40092174304284645
49,T M KAMBLE,SC,LATUR,2363,4,RPI(D),7,M,MAHARASHTRA,822355,820749,1606,1293202,674423,618779,0.18326603268476233,2370,0.288196703370199
38,MANOHAR ANANDRAO PATIL,GEN,LATUR,1880,9,IND,1,M,MAHARASHTRA,822355,820749,1606,1293202,674423,618779,0.1454529145485392,1881,0.2287333329279934
49,MANE GAJANAN PANDURANG,SC,LATUR,1782,10,IND,1,M,MAHARASHTRA,822355,820749,1606,1293202,674423,618779,0.13787482543330432,1783,0.21681633844264336
35,DR NITIN SOPANRAO WAGHE,GEN,LATUR,1591,6,RSPS,0,M,MAHARASHTRA,822355,820749,1606,1293202,674423,618779,0.12302795696264002,1591,0.19346875741012093
41,BAGDURE VINAYAK VISHWANATHRAO,GEN,LATUR,1420,7,SVRP,3,M,MAHARASHTRA,822355,820749,1606,1293202,674423,618779,0.11003694705080877,1423,0.17303962400666378
62,GODBOLE MANDAKINI GYANU,SC,LATUR,1385,5,PRCP,3,F,MAHARASHTRA,822355,820749,1606,1293202,674423,618779,0.1073304866525106,1388,0.1687835545476102
34,NARHIRE KALPANA RAMESH,SC,OSMANABAD (SC),293882,3,SHS,554,F,MAHARASHTRA,637933,636897,1036,1072645,560090,512555,27.449528968111537,294436,46.15469022608957
51,DHOBALE LAXMAN KONDIBA,SC,OSMANABAD (SC),292320,1,NCP,467,M,MAHARASHTRA,637933,636897,1036,1072645,560090,512555,27.295796838655846,292787,45.896199130629704
33,TUPSUNDARE BALAJI BAPURAO,SC,OSMANABAD (SC),11844,4,LRP,2,M,MAHARASHTRA,637933,636897,1036,1072645,560090,512555,1.1043728353742386,11846,1.8569348191738004
43,DEKULE KANIFNATH DULHA,SC,OSMANABAD (SC),10909,2,BSP,9,M,MAHARASHTRA,637933,636897,1036,1072645,560090,512555,1.0178577255289494,10918,1.7114649971078466
60,RAUT VITTHAL KUNDLIK,SC,OSMANABAD (SC),9827,8,IND,0,M,MAHARASHTRA,637933,636897,1036,1072645,560090,512555,0.9161465349673005,9827,1.5404439024160843
52,NAVNATH DASHRATH UPLEKAR,SC,OSMANABAD (SC),7374,7,IND,0,M,MAHARASHTRA,637933,636897,1036,1072645,560090,512555,0.6874595043094407,7374,1.1559207628387307
60,KADAPPA GADE,SC,OSMANABAD (SC),5781,5,IND,4,M,MAHARASHTRA,637933,636897,1036,1072645,560090,512555,0.5393210241971947,5785,0.9068350438055407
36,ZOMBADE SANDIPAN RAMA,SC,OSMANABAD (SC),4960,6,IND,0,M,MAHARASHTRA,637933,636897,1036,1072645,560090,512555,0.46240834572482037,4960,0.7775111179387177
46,DESHMUKH SUBHASH SURESHCHANDRA,GEN,SHOLAPUR,315815,2,BJP,373,M,MAHARASHTRA,656801,656136,665,1187231,618326,568905,26.632390832112705,316188,48.14060879931669
55,UJWALATAI SUSHILKUMAR SHINDE,GEN,SHOLAPUR,310101,1,INC,289,F,MAHARASHTRA,656801,656136,665,1187231,618326,568905,26.144027573403996,310390,47.257845222525546
42,SARVADE RAHUL VITTHALRAO,SC,SHOLAPUR,12064,3,BSP,3,M,MAHARASHTRA,656801,656136,665,1187231,618326,568905,1.0163986620969296,12067,1.8372383720487637
42,NAGMANI KISAN JAKKAN,GEN,SHOLAPUR,8503,6,IND,0,F,MAHARASHTRA,656801,656136,665,1187231,618326,568905,0.716204344394646,8503,1.2946082603406512
30,SALGAR PRABHAKAR SIDRAM,GEN,SHOLAPUR,6396,4,RSPS,0,M,MAHARASHTRA,656801,656136,665,1187231,618326,568905,0.5387325634185764,6396,0.9738109412135487
40,AVAR PRAMOD DATTATRAYA,GEN,SHOLAPUR,3257,5,IND,0,M,MAHARASHTRA,656801,656136,665,1187231,618326,568905,0.27433582849504434,3257,0.4958884045548043
43,ATHAWALE RAMDAS BANDU,SC,PANDHARPUR (SC),346761,3,RPI(A),454,M,MAHARASHTRA,689127,688282,845,1294407,668563,625844,26.824252341033382,347215,50.384762170107976
52,KSHIRSAGAR NAGNATH DATTATRAY,SC,PANDHARPUR (SC),247170,2,BJP,352,M,MAHARASHTRA,689127,688282,845,1294407,668563,625844,19.12242439974444,247522,35.91819795190146
50,LANKESHWAR KALYAN BHAGWAN,SC,PANDHARPUR (SC),33249,8,IND,16,M,MAHARASHTRA,689127,688282,845,1294407,668563,625844,2.5699026658539394,33265,4.827121851269795
57,ADV NAIKNAVARE PURUSHOTTAM BHAGVAN,SC,PANDHARPUR (SC),20678,4,RSPS,6,M,MAHARASHTRA,689127,688282,845,1294407,668563,625844,1.5979518034126825,20684,3.0014786824489534
32,DR SHARDA HARIDAS SONAVANE,SC,PANDHARPUR (SC),12891,9,IND,4,F,MAHARASHTRA,689127,688282,845,1294407,668563,625844,0.9962090748891193,12895,1.8712080646963478
38,RAMESH ROHIDAS NIRMAL,SC,PANDHARPUR (SC),11049,1,BSP,10,M,MAHARASHTRA,689127,688282,845,1294407,668563,625844,0.8543680619774152,11059,1.6047840238446613
56,TEXASDADA GAIKWAD,SC,PANDHARPUR (SC),8134,7,IND,1,M,MAHARASHTRA,689127,688282,845,1294407,668563,625844,0.6284731154884051,8135,1.1804790698956795
40,KALE AVINASH TATYASAHEB,SC,PANDHARPUR (SC),4696,6,IND,2,M,MAHARASHTRA,689127,688282,845,1294407,668563,625844,0.362946121274066,4698,0.6817321045322561
36,WAGHMARE SUNIL TARACHAND,SC,PANDHARPUR (SC),3654,5,PRCP,0,M,MAHARASHTRA,689127,688282,845,1294407,668563,625844,0.2822914276576069,3654,0.5302360813028658
51,GADAKH TUKARAM GANGADHAR,GEN,AHMEDNAGAR,362411,1,NCP,527,M,MAHARASHTRA,687722,686554,1168,1295593,673744,621849,28.013272686715656,362938,52.77394063298833
64,PROF N S PHARANDE,GEN,AHMEDNAGAR,287255,2,BJP,606,M,MAHARASHTRA,687722,686554,1168,1295593,673744,621849,22.218474474622816,287861,41.8571748468131
28,SAYYAD MUSHTAK AHMED,GEN,AHMEDNAGAR,11112,7,IND,3,M,MAHARASHTRA,687722,686554,1168,1295593,673744,621849,0.8579083091680798,11115,1.6162053853155782
37,DR BHISE INDRAKUMAR DEVRAO,GEN,AHMEDNAGAR,8778,4,RSPS,8,M,MAHARASHTRA,687722,686554,1168,1295593,673744,621849,0.6781450656186009,8786,1.2775511034982159
41,WAGHMARE RAJU RATNAKAR,SC,AHMEDNAGAR,8703,3,BSP,19,M,MAHARASHTRA,687722,686554,1168,1295593,673744,621849,0.6732052426958157,8722,1.2682450176088595
38,RAMNATH GAHININATH GOLHAR,GEN,AHMEDNAGAR,5041,6,IND,1,M,MAHARASHTRA,687722,686554,1168,1295593,673744,621849,0.3891654246356688,5042,0.7331450789708632
53,AWARE RADHAKISAN BABU,GEN,AHMEDNAGAR,3254,5,IND,4,M,MAHARASHTRA,687722,686554,1168,1295593,673744,621849,0.2514678606630323,3258,0.47373793480505205
72,E V ALIAS BALASAHEB VIKHE PATIL,GEN,KOPARGAON,355600,2,INC,1088,M,MAHARASHTRA,668700,666950,1750,1077519,558436,519083,33.102710949876524,356688,53.340511440107676
61,MURKUTE BHANUDAS KASHINATH,GEN,KOPARGAON,268718,3,SHS,639,M,MAHARASHTRA,668700,666950,1750,1077519,558436,519083,24.997888668320467,269357,40.28069388365485
49,NIKALE VINAYAKRAO MARUTRAO,SC,KOPARGAON,10816,1,BSP,20,M,MAHARASHTRA,668700,666950,1750,1077519,558436,519083,1.0056435199750537,10836,1.6204576043068641
50,SHAIKH RIYAJ FAJALODDIN,GEN,KOPARGAON,7897,11,IND,0,M,MAHARASHTRA,668700,666950,1750,1077519,558436,519083,0.73288730871567,7897,1.1809481082697773
37,DR BHISE INDRAKUMAR DEVRAO,GEN,KOPARGAON,6000,4,RSPS,0,M,MAHARASHTRA,668700,666950,1750,1077519,558436,519083,0.5568347286683576,6000,0.8972633467922835
68,DESHMUKH BHAGWAN RANGANATH,GEN,KOPARGAON,4955,7,IND,2,M,MAHARASHTRA,668700,666950,1750,1077519,558436,519083,0.4600382916681748,4957,0.7412890683415582
46,VIKHE BALASAHEB JAGGANNATH,GEN,KOPARGAON,4947,10,IND,0,M,MAHARASHTRA,668700,666950,1750,1077519,558436,519083,0.4591102337870608,4947,0.7397936294302377
33,MUSMADE BHAUSAHEB JAGANNATH,GEN,KOPARGAON,2813,8,IND,0,M,MAHARASHTRA,668700,666950,1750,1077519,558436,519083,0.26106268195734833,2813,0.4206669657544489
32,WAGHMARE SHANKAR SADASHIV,SC,KOPARGAON,2591,9,IND,0,M,MAHARASHTRA,668700,666950,1750,1077519,558436,519083,0.24045979699661907,2591,0.38746822192313446
41,KHULE DATTATRAYA NIVRUTTI,GEN,KOPARGAON,1320,6,IND,1,M,MAHARASHTRA,668700,666950,1750,1077519,558436,519083,0.12259644609515007,1321,0.19754748018543442
45,KOLSE ASHOK EKNATH,GEN,KOPARGAON,1293,5,IND,0,M,MAHARASHTRA,668700,666950,1750,1077519,558436,519083,0.11999788402803106,1293,0.1933602512337371
48,ADHALARAO PATIL SHIVAJIRAO,GEN,KHED,360242,1,SHS,259,M,MAHARASHTRA,732045,731602,443,1319319,679137,640182,27.324778920033744,360501,49.245743089564165
62,ASHOK NAMDEVRAO MOHOL,GEN,KHED,339512,2,NCP,179,M,MAHARASHTRA,732045,731602,443,1319319,679137,640182,25.747450010194655,339691,46.40302167216496
42,ARBUJ SHIVAJI JIJABA,GEN,KHED,12054,6,IND,1,M,MAHARASHTRA,732045,731602,443,1319319,679137,640182,0.9137289768433563,12055,1.6467566884549447
35,KUDALE VIVEK ANANT,GEN,KHED,11213,3,BSP,3,M,MAHARASHTRA,732045,731602,443,1319319,679137,640182,0.8501355623620974,11216,1.5321462478399552
56,BHOSALE LAXMAN DHARMAJI,SC,KHED,5273,5,BBM,1,M,MAHARASHTRA,732045,731602,443,1319319,679137,640182,0.39975169007647127,5274,0.7204475134725324
56,GADAGE GANPATRAO MARUTI,GEN,KHED,3308,4,RSPS,0,M,MAHARASHTRA,732045,731602,443,1319319,679137,640182,0.250735417287252,3308,0.451884788503439
59,KALMADI SURESH,GEN,PUNE,373704,1,INC,70,M,MAHARASHTRA,769018,768827,191,1608614,839584,769030,23.23577937280168,373774,48.604063884070335
47,PRADIP TRIMBAK RAWAT,GEN,PUNE,300507,3,BJP,91,M,MAHARASHTRA,769018,768827,191,1608614,839584,769030,18.686770101466234,300598,39.088551893453726
61,ARUN BHATIA,GEN,PUNE,60213,10,IND,24,M,MAHARASHTRA,769018,768827,191,1608614,839584,769030,3.7446522285644663,60237,7.832976601327927
35,GAIKWAD JAYAWNT DHARMAJI,GEN,PUNE,9099,2,BSP,2,M,MAHARASHTRA,769018,768827,191,1608614,839584,769030,0.5657665543132162,9101,1.1834573443014338
42,JADHAV GANESH DEVRAM,SC,PUNE,5321,5,BBM,0,M,MAHARASHTRA,769018,768827,191,1608614,839584,769030,0.33078165426883016,5321,0.6919213854552169
82,JAGDALE SHANKARRAO RAMCHANDRA,GEN,PUNE,4679,16,IND,0,M,MAHARASHTRA,769018,768827,191,1608614,839584,769030,0.2908715204517678,4679,0.6084382940321293
55,THYAGARAJAN BENEDIC,GEN,PUNE,3350,17,IND,0,M,MAHARASHTRA,769018,768827,191,1608614,839584,769030,0.20825381353140032,3350,0.43562049262826097
30,PROF ANANDRAO BHANUDAS DADAS,GEN,PUNE,2417,4,RSPS,1,M,MAHARASHTRA,769018,768827,191,1608614,839584,769030,0.15031573764744058,2418,0.3144269705000403
44,RAWAT PRAMILA,GEN,PUNE,1616,19,IND,0,F,MAHARASHTRA,769018,768827,191,1608614,839584,769030,0.10045915303484862,1616,0.21013812420515512
51,SARODE ARUN KONDIBA,SC,PUNE,967,22,IND,0,M,MAHARASHTRA,769018,768827,191,1608614,839584,769030,0.060113861995481827,967,0.1257447810064264
38,ANWAR ISMAIL BAGWAN,GEN,PUNE,844,9,IND,0,M,MAHARASHTRA,769018,768827,191,1608614,839584,769030,0.05246752794641847,844,0.10975035694873203
75,CHAVAN POPATRAO KISANRAO,SC,PUNE,801,15,IND,0,M,MAHARASHTRA,769018,768827,191,1608614,839584,769030,0.0497944192951199,801,0.10415881032693644
41,GAIKWAD VITTHAL BABURAO,SC,PUNE,795,14,IND,0,M,MAHARASHTRA,769018,768827,191,1608614,839584,769030,0.04942142739028754,795,0.10337859451924403
41,RAJIV DESHPANDE,GEN,PUNE,620,7,HEAP,0,M,MAHARASHTRA,769018,768827,191,1608614,839584,769030,0.038542496832677076,620,0.08062230012821546
76,KAMBLE SADANAND BHIMRAO,SC,PUNE,619,13,IND,0,M,MAHARASHTRA,769018,768827,191,1608614,839584,769030,0.03848033151520502,619,0.08049226416026672
35,SHINDE SACHIN NANA,GEN,PUNE,592,20,IND,0,M,MAHARASHTRA,769018,768827,191,1608614,839584,769030,0.036801867943459396,592,0.07698129302565089
42,PROF TRIBHUVAN SAMPAT,SC,PUNE,511,6,IJP,0,M,MAHARASHTRA,769018,768827,191,1608614,839584,769030,0.03176647722822256,511,0.06644837962180339
44,KANCHWALA NURUDDIN ALTAF HUSSEIN,GEN,PUNE,500,12,IND,0,M,MAHARASHTRA,769018,768827,191,1608614,839584,769030,0.031082658736029903,500,0.06501798397436731
43,ADAGALE BHAU RAMCHANDRA,SC,PUNE,485,8,IND,0,M,MAHARASHTRA,769018,768827,191,1608614,839584,769030,0.030150178973949004,485,0.06306744445513629
44,NITIN DATTATRAYA JAGTAP,GEN,PUNE,474,18,IND,1,M,MAHARASHTRA,769018,768827,191,1608614,839584,769030,0.029528525799228406,475,0.06176708477564894
49,AMTE VINOD RAMCHANDRA,GEN,PUNE,461,11,IND,0,M,MAHARASHTRA,769018,768827,191,1608614,839584,769030,0.02865821135461957,461,0.05994658122436666
55,SHAIKH IBRAHIM HUSAIN,GEN,PUNE,252,21,IND,2,M,MAHARASHTRA,769018,768827,191,1608614,839584,769030,0.01578999063790319,254,0.03302913585897859
63,PAWAR SHARADCHANDRA GOVINDRAO,GEN,BARAMATI,634176,1,NCP,379,M,MAHARASHTRA,893331,892726,605,1846635,971786,874849,34.36277336885741,634555,71.03246165195208
46,PRITHVIRAJ SAHEBRAO JACHAK,GEN,BARAMATI,211378,2,BJP,202,M,MAHARASHTRA,893331,892726,605,1846635,971786,874849,11.457597197063848,211580,23.684390220422216
46,KOLEKAR BALASAHEB BAPURAO,GEN,BARAMATI,30217,4,RSPS,13,M,MAHARASHTRA,893331,892726,605,1846635,971786,874849,1.637031681951225,30230,3.383964062592701
49,VISHWAKARMA PRALHAD RAMBICH,GEN,BARAMATI,16955,3,BSP,11,M,MAHARASHTRA,893331,892726,605,1846635,971786,874849,0.9187522168701449,16966,1.8991840650330056
66,LAXMANRAO PANDURANG JADHAV (PATIL),GEN,SATARA,280781,2,NCP,796,M,MAHARASHTRA,675012,673093,1919,1149290,571705,577585,24.50008265972905,281577,41.71436952231961
56,HINDURAO N NAIK NIMBALKAR,GEN,SATARA,276738,3,SHS,882,M,MAHARASHTRA,675012,673093,1919,1149290,571705,577585,24.15578313567507,277620,41.1281577216405
64,KADAM SURYAJIRAO ALIAS CHIMANRAO,GEN,SATARA,62313,6,IND,179,M,MAHARASHTRA,675012,673093,1919,1149290,571705,577585,5.437443987157288,62492,9.257909489016491
38,KHATAKE BAJARANG SUBHEDAR,GEN,SATARA,28304,4,RSPS,21,M,MAHARASHTRA,675012,673093,1919,1149290,571705,577585,2.464565079309835,28325,4.196221696799465
37,AMAR RAGHUNATH GAIKWAD,SC,SATARA,13473,1,BSP,29,M,MAHARASHTRA,675012,673093,1919,1149290,571705,577585,1.1748122754048151,13502,2.000260736105432
43,DR BHAGAWAN KHANDERAO ALIAS DR B K,GEN,SATARA,11484,5,LRP,12,M,MAHARASHTRA,675012,673093,1919,1149290,571705,577585,1.0002697317474267,11496,1.7030808341185046
63,PATIL SHRINIWAS DADASAHEB,GEN,KARAD,436333,2,NCP,399,M,MAHARASHTRA,714523,713822,701,1181744,589936,591808,36.956565889058886,436732,61.122175213394115
43,MANKUMARE VASANT DNYANDEV,GEN,KARAD,239717,3,SHS,285,M,MAHARASHTRA,714523,713822,701,1181744,589936,591808,20.309136327326392,240002,33.58912169377333
36,ADV KAMBLE PRABHAKAR MANSING,SC,KARAD,17351,1,BSP,10,M,MAHARASHTRA,714523,713822,701,1181744,589936,591808,1.4690999065787513,17361,2.4297328427496385
41,ANANDRAO TUKARAM THORAT,GEN,KARAD,12037,5,IND,3,M,MAHARASHTRA,714523,713822,701,1181744,589936,591808,1.0188331821443561,12040,1.6850402296357152
27,JADHAV BALIKRISHNA ALIAS BALASAHEB,GEN,KARAD,8384,4,RSPS,4,M,MAHARASHTRA,714523,713822,701,1181744,589936,591808,0.7097983996533936,8388,1.1739300204472074
56,PATIL PRAKASHBAPU VASANTDADA,GEN,SANGLI,304798,2,INC,250,M,MAHARASHTRA,692999,692122,877,1186416,601722,584694,25.711723375274776,305048,44.018533937278406
46,DEEPAK (BABA) ABASAHEB SHINDE,GEN,SANGLI,222866,1,BJP,559,M,MAHARASHTRA,692999,692122,877,1186416,601722,584694,18.831927418376015,223425,32.240306263068206
81,KRANTIVEER NAGNATH(ANNA),GEN,SANGLI,137084,4,SP,38,M,MAHARASHTRA,692999,692122,877,1186416,601722,584694,11.557666113740881,137122,19.78675293903743
61,SHANKARRAO BALKRISHNA KHEDKAR,GEN,SANGLI,10090,8,IND,0,M,MAHARASHTRA,692999,692122,877,1186416,601722,584694,0.8504605467222289,10090,1.4559905569849307
31,ADV SUHASE MADHUKAR MALLAPPA,SC,SANGLI,8250,3,BSP,17,M,MAHARASHTRA,692999,692122,877,1186416,601722,584694,0.6968044935334655,8267,1.192931014330468
64,GANAPATI TUKARAM KAMBLE (G T ),SC,SANGLI,3647,5,IND,7,M,MAHARASHTRA,692999,692122,877,1186416,601722,584694,0.30798640611724726,3654,0.5272734881291316
57,VANMORE NARAYAN APPA,SC,SANGLI,3070,7,IND,0,M,MAHARASHTRA,692999,692122,877,1186416,601722,584694,0.2587625251176653,3070,0.44300208225408694
43,PRAVIN KAVTHEKAR (JIWA MAHALE),GEN,SANGLI,2317,6,IND,6,M,MAHARASHTRA,692999,692122,877,1186416,601722,584694,0.19579978692128222,2323,0.3352097189173433
39,MANE NIVEDITA SAMBHAJIRAO,GEN,ICHALKARANJI,421825,2,NCP,447,F,MAHARASHTRA,791087,790264,823,1215059,612620,602439,34.753209514928905,422272,53.378705502681754
34,DR PATIL SANJAY (DADA) SHAMRAO,GEN,ICHALKARANJI,320862,1,SHS,361,M,MAHARASHTRA,791087,790264,823,1215059,612620,602439,26.436823232452088,321223,40.6052684470861
43,KAMBALE SUKUMAR DATTU,SC,ICHALKARANJI,20147,3,BBM,8,M,MAHARASHTRA,791087,790264,823,1215059,612620,602439,1.6587671874369887,20155,2.5477602337037517
32,MANE SUNITA ARVIND,SC,ICHALKARANJI,19701,5,IND,3,F,MAHARASHTRA,791087,790264,823,1215059,612620,602439,1.6216496482886837,19704,2.4907500692085702
34,PATIL SANJAY SHAMRAO,GEN,ICHALKARANJI,7729,4,IND,4,M,MAHARASHTRA,791087,790264,823,1215059,612620,602439,0.6364300005184933,7733,0.977515747319827
69,MANDLIK SADASHIVRAO DADOBA,GEN,KOLHAPUR,401217,2,NCP,705,M,MAHARASHTRA,813344,811534,1810,1162212,584148,578064,34.58250302010305,401922,49.41599126568832
32,MAHADIK DHANANJAY BHIMRAO,GEN,KOLHAPUR,386118,1,SHS,1051,M,MAHARASHTRA,813344,811534,1810,1162212,584148,578064,33.31311327021232,387169,47.60212161151985
45,PATRAKAR SUNANDA PRAKASH MORE,GEN,KOLHAPUR,13241,4,PWPI,25,F,MAHARASHTRA,813344,811534,1810,1162212,584148,578064,1.1414440738866918,13266,1.6310441830271079
66,WAGH SHANKARRAO KRISHNAJI,SC,KOLHAPUR,10958,3,BSP,29,M,MAHARASHTRA,813344,811534,1810,1162212,584148,578064,0.9453524830237512,10987,1.3508429397647244
55,DR THOKCHOM MEINYA,GEN,INNER MANIPUR,154034,1,INC,21,M,MANIPUR,416406,416376,30,740718,353619,387099,20.798063500549464,154055,36.99634491337781
55,MOIRANGTHEM NARA,GEN,INNER MANIPUR,104719,3,CPI,3,M,MANIPUR,416406,416376,30,740718,353619,387099,14.137904033653834,104722,25.149013222672107
68,LEISHANGTHEM CHANDRAMANI,GEN,INNER MANIPUR,88178,4,FPM,1,M,MANIPUR,416406,416376,30,740718,353619,387099,11.904530469085401,88179,21.176207835621966
67,THOUNAOJAM CHAOBA,GEN,INNER MANIPUR,66446,2,BJP,5,M,MANIPUR,416406,416376,30,740718,353619,387099,8.971160414624729,66451,15.958223464599453
64,NONGMAITHEM IBOYAIMA SINGH,GEN,INNER MANIPUR,1646,5,IND,0,M,MANIPUR,416406,416376,30,740718,353619,387099,0.22221682205643714,1646,0.3952872917297061
40,NONGMAITHEM HOMENDRO SINGH,GEN,INNER MANIPUR,1353,6,IND,0,M,MANIPUR,416406,416376,30,740718,353619,387099,0.1826606076806558,1353,0.32492327199896254
45,MANI CHARENAMEI,ST,OUTER MANIPUR (ST),229628,6,IND,6,M,MANIPUR,619151,618984,167,795792,392435,403357,28.856032732171222,229634,37.08852929253123
51,D LOLI ADANEE,ST,OUTER MANIPUR (ST),147385,2,BJP,56,M,MANIPUR,619151,618984,167,795792,392435,403357,18.527580071174377,147441,23.81341546730927
67,HOLKHOMANG HAOKIP,ST,OUTER MANIPUR (ST),107391,3,NCP,44,M,MANIPUR,619151,618984,167,795792,392435,403357,13.500387035808354,107435,17.351986833583407
46,KIM GANGTE,ST,OUTER MANIPUR (ST),77025,1,MPP,30,F,MANIPUR,619151,618984,167,795792,392435,403357,9.682806562518849,77055,12.445267794124536
42,ROSANGZUALA,ST,OUTER MANIPUR (ST),37440,5,JD(U),15,M,MANIPUR,619151,618984,167,795792,392435,403357,4.706631883708305,37455,6.049412824981306
48,W MORUNG MAKUNGA,ST,OUTER MANIPUR (ST),20115,4,AITC,16,M,MANIPUR,619151,618984,167,795792,392435,403357,2.5296811227054303,20131,3.251387787470262
75,PATY RIPPLE KYNDIAH,ST,SHILLONG,190034,1,INC,24,M,MEGHALAYA,367780,367736,44,785062,391114,393948,24.209298119129443,190058,51.67708956441351
57,S LONIAK MARBANIANG,ST,SHILLONG,119156,3,IND,6,M,MEGHALAYA,367780,367736,44,785062,391114,393948,15.178673786274205,119162,32.40034803415085
53,SANBOR SWELL LYNGDOH,ST,SHILLONG,58546,2,BJP,14,M,MEGHALAYA,367780,367736,44,785062,391114,393948,7.459283470604869,58560,15.922562401435641
56,PURANO AGITOK SANGMA,ST,TURA,191930,2,AITC,8,M,MEGHALAYA,311113,311102,11,504312,257540,246772,38.05937594187725,191938,61.69398257224867
38,DR MUKUL SANGMA,ST,TURA,119172,1,INC,3,M,MEGHALAYA,311113,311102,11,504312,257540,246772,23.63120449245705,119175,38.306017427751335
48,VANLALZAWMA,ST,MIZORAM (ST),180824,1,MNF,2040,M,MIZORAM,348546,344804,3742,549959,273454,276505,33.25047867204646,182864,52.46481095752067
43,DR LALTLUANGLIANA KHIANGTE,ST,MIZORAM (ST),157831,3,IND,1339,M,MIZORAM,348546,344804,3742,549959,273454,276505,28.94215750628683,159170,45.66685602474279
63,TLANGDINGLIANA,ST,MIZORAM (ST),6149,2,EU,363,M,MIZORAM,348546,344804,3742,549959,273454,276505,1.1840882683981897,6512,1.8683330177365398
40,W WANGYUH,ST,NAGALAND,695309,2,NPF,2819,M,NAGALAND,954719,950947,3772,1041433,547114,494319,67.0353253641857,698128,73.12392442174085
58,K ASUNGBA SANGTAM,ST,NAGALAND,245218,1,INC,891,M,NAGALAND,954719,950947,3772,1041433,547114,494319,23.631765077542195,246109,25.778160903888995
55,SHRI AKHEI ACHUMI,ST,NAGALAND,5110,3,JD(S),39,M,NAGALAND,954719,950947,3772,1041433,547114,494319,0.49441490715197234,5149,0.5393209939259614
41,SHRI NYIMTHUNGO,ST,NAGALAND,3678,4,IND,9,M,NAGALAND,954719,950947,3772,1041433,547114,494319,0.3540314163273105,3687,0.3861869303952262
31,DR RILANTHUNG,ST,NAGALAND,1632,5,IND,14,M,NAGALAND,954719,950947,3772,1041433,547114,494319,0.1580514541021842,1646,0.17240675004896727
38,SUDAM MARNDI,ST,MAYURBHANJ (ST),260494,4,JMM,35,M,ORISSA,695997,695815,182,990544,493875,496669,26.3016080052981,260529,37.432488933141954
50,BHAGIRATHI MAJHI,ST,MAYURBHANJ (ST),252453,2,BJP,104,M,ORISSA,695997,695815,182,990544,493875,496669,25.496797719233065,252557,36.287081697191226
47,SUSHILA TIRIYA,ST,MAYURBHANJ (ST),143118,3,INC,41,F,ORISSA,695997,695815,182,990544,493875,496669,14.452563439887578,143159,20.568910498177434
49,KANDA CHARAN NAIK,ST,MAYURBHANJ (ST),39750,1,BSP,2,M,ORISSA,695997,695815,182,990544,493875,496669,4.013148330614288,39752,5.711518871489388
50,MAHAMEGHA BAHAN AIRA KHARBELA,GEN,BALASORE,553022,3,BJP,65,M,ORISSA,947569,947481,88,1330406,681353,649053,41.57279807818065,553087,58.36904753110328
52,NIRANJAN PANDA,GEN,BALASORE,316110,2,INC,22,M,ORISSA,947569,947481,88,1330406,681353,649053,23.762069623859183,316132,33.36242532206098
44,MRUTYUNJAY MOHAPATRA,GEN,BALASORE,28247,6,IND,0,M,ORISSA,947569,947481,88,1330406,681353,649053,2.123186455863849,28247,2.9809966345458747
42,NALINI KUMAR JENA,SC,BALASORE,21203,1,BSP,1,M,ORISSA,947569,947481,88,1330406,681353,649053,1.5937991861131113,21204,2.237726223631208
60,TRAILOKYA NATH DAS,SC,BALASORE,15026,4,RPI,0,M,ORISSA,947569,947481,88,1330406,681353,649053,1.1294296628247318,15026,1.585742040948997
66,MALAYENDRA KISOR CHAUDHURI,GEN,BALASORE,13873,5,BMVP,0,M,ORISSA,947569,947481,88,1330406,681353,649053,1.0427643892165248,13873,1.4640622477096654
64,ARJUN CHARAN SETHI,SC,BHADRAK (SC),488991,1,BJD,209,M,ORISSA,932276,931990,286,1350755,689867,660888,36.216782466102295,489200,52.473730955210684
57,MURALIDHAR JENA,SC,BHADRAK (SC),394360,3,INC,71,M,ORISSA,932276,931990,286,1350755,689867,660888,29.20078030434831,394431,42.30839365166539
59,PURUSOTTAM MALIK,SC,BHADRAK (SC),31581,4,IND,5,M,ORISSA,932276,931990,286,1350755,689867,660888,2.3383959341257294,31586,3.3880524651498054
45,PRAFULLA KUMAR DAS,SC,BHADRAK (SC),17058,2,BSP,1,M,ORISSA,932276,931990,286,1350755,689867,660888,1.262923328064675,17059,1.8298229279741192
44,MOHAN JENA,SC,JAJPUR (SC),452079,2,BJD,98,M,ORISSA,876208,876068,140,1278758,663807,614951,35.360638995024864,452177,51.60612548618593
45,AMIYA KANTA MALLIK,SC,JAJPUR (SC),400671,1,INC,40,M,ORISSA,876208,876068,140,1278758,663807,614951,31.335952541450375,400711,45.732406004053836
30,RADHABALLAV MALLIK,SC,JAJPUR (SC),13017,4,IND,0,M,ORISSA,876208,876068,140,1278758,663807,614951,1.0179408457268695,13017,1.4856061574420685
25,BIJAY KUMAR MALLIK,SC,JAJPUR (SC),10301,3,BMVP,2,M,ORISSA,876208,876068,140,1278758,663807,614951,0.8057036593319457,10303,1.175862352318171
38,ARCHANA NAYAK,GEN,KENDRAPARA,453231,1,BJD,45,F,ORISSA,836265,836194,71,1186834,617076,569758,38.192030224951424,453276,54.20243583074743
53,SRIKANT KUMAR JENA,GEN,KENDRAPARA,366408,2,INC,25,M,ORISSA,836265,836194,71,1186834,617076,569758,30.874831695081202,366433,43.817808948120515
33,BIKRAM KESHARI ROUTRAY,GEN,KENDRAPARA,16555,3,IND,1,M,ORISSA,836265,836194,71,1186834,617076,569758,1.3949718326236018,16556,1.9797552211320575
47,BHARTRUHARI MAHTAB,GEN,CUTTACK,496598,2,BJD,152,M,ORISSA,820302,820082,220,1236228,656489,579739,40.18271710396464,496750,60.55696560535022
72,JAYANTI PATNAIK,GEN,CUTTACK,323484,1,INC,68,F,ORISSA,820302,820082,220,1236228,656489,579739,26.1725183380412,323552,39.44303439464977
53,BRAHMANANDA PANDA,GEN,JAGATSINGHPUR,466260,2,BJD,123,M,ORISSA,926511,926264,247,1301496,673745,627751,35.83437828468163,466383,50.33755670466945
33,RANJIB BISWAL,GEN,JAGATSINGHPUR,408999,3,INC,122,M,ORISSA,926511,926264,247,1301496,673745,627751,31.434672100413678,409121,44.1571659699669
31,BIMALENDU SWAIN,GEN,JAGATSINGHPUR,29404,5,IND,0,M,ORISSA,926511,926264,247,1301496,673745,627751,2.2592462827392477,29404,3.1736266487931606
32,PRADIP KUMAR MALLICK,SC,JAGATSINGHPUR,13790,1,BSP,2,M,ORISSA,926511,926264,247,1301496,673745,627751,1.0597036026234425,13792,1.488595386347275
33,GYANARANJAN DAS,GEN,JAGATSINGHPUR,7811,4,SHS,0,M,ORISSA,926511,926264,247,1301496,673745,627751,0.6001555133477168,7811,0.8430552902232137
57,BRAJA KISHORE TRIPATHY,GEN,PURI,462205,2,BJD,43,M,ORISSA,888955,888886,69,1288034,665732,622302,35.88787252510415,462248,51.99903257195246
44,PINAKI MISRA,GEN,PURI,401262,1,INC,26,M,ORISSA,888955,888886,69,1288034,665732,622302,31.155078204457336,401288,45.14154259776929
72,KSHITISH BISWAL,GEN,PURI,25419,3,CPI(ML)(L),0,M,ORISSA,888955,888886,69,1288034,665732,622302,1.9734727499429363,25419,2.8594248302782477
56,PRASANNA KUMAR PATASANI,GEN,BHUBANESWAR,437686,1,BJD,76,M,ORISSA,853005,852884,121,1491536,810032,681504,29.34974415635962,437762,51.319980539387224
52,SOUMYA RANJAN PATNAIK,GEN,BHUBANESWAR,325446,3,INC,37,M,ORISSA,853005,852884,121,1491536,810032,681504,21.822000943993306,325483,38.15722064935141
27,PRAMILA BEHERA,SC,BHUBANESWAR,36420,9,IND,1,F,ORISSA,853005,852884,121,1491536,810032,681504,2.4418451850977787,36421,4.269728782363527
59,B RAMACHANDRA,GEN,BHUBANESWAR,17131,10,IND,0,M,ORISSA,853005,852884,121,1491536,810032,681504,1.1485475375720062,17131,2.0083117918417828
47,PRAMOD SAMANTARA,GEN,BHUBANESWAR,8526,4,RPI,0,M,ORISSA,853005,852884,121,1491536,810032,681504,0.5716254921101468,8526,0.9995252079413368
66,BADRI NARAYAN ROUTRAY,GEN,BHUBANESWAR,8327,2,BSP,1,M,ORISSA,853005,852884,121,1491536,810032,681504,0.5583505862412976,8328,0.9763131517400249
62,SHANTI DAS,GEN,BHUBANESWAR,6530,5,SP,1,F,ORISSA,853005,852884,121,1491536,810032,681504,0.43787075873461984,6531,0.7656461568220585
38,SANTOSH KUMAR MISHRA,GEN,BHUBANESWAR,5175,6,ABHM,1,M,ORISSA,853005,852884,121,1491536,810032,681504,0.3470248120058785,5176,0.6067959742322729
34,SUSHANT KUMAR CHOUDHURY,GEN,BHUBANESWAR,4021,7,JD(U),0,M,ORISSA,853005,852884,121,1491536,810032,681504,0.26958786110425764,4021,0.4713923130579539
55,KULAMANI SAHOO,GEN,BHUBANESWAR,3622,8,IND,4,M,ORISSA,853005,852884,121,1491536,810032,681504,0.24310509434569463,3626,0.4250854332624076
68,HARI HAR SWAIN,GEN,ASKA,381512,2,BJD,14,M,ORISSA,680381,680351,30,1254942,654321,600621,30.401883114916867,381526,56.075346019362684
62,RAMKRUSHANA PATNAIK,GEN,ASKA,248909,1,INC,15,M,ORISSA,680381,680351,30,1254942,654321,600621,19.835498373630017,248924,36.58597168351262
51,BIJAYA KUMAR MOHAPATRO,GEN,ASKA,19250,3,RSP,0,M,ORISSA,680381,680351,30,1254942,654321,600621,1.533935432872595,19250,2.8292971144108963
66,DUTIKRISHNA PADHI,GEN,ASKA,16395,4,IND,1,M,ORISSA,680381,680351,30,1254942,654321,600621,1.3065145640196918,16396,2.4098262591107042
68,K SHYAMBABU SUBUDHI,GEN,ASKA,14285,5,IND,0,M,ORISSA,680381,680351,30,1254942,654321,600621,1.1382996186277932,14285,2.099558923603099
54,CHANDRA SEKHAR SAHU,GEN,BERHAMPUR,355942,2,INC,31,M,ORISSA,719379,719283,96,1195391,598093,597298,29.7787920437748,355973,49.48337385439386
64,ANADI SAHU,GEN,BERHAMPUR,304253,1,BJP,63,M,ORISSA,719379,719283,96,1195391,598093,597298,25.457444467960695,304316,42.30259710111082
40,JAGANATH PATRO,GEN,BERHAMPUR,34031,3,IND,1,M,ORISSA,719379,719283,96,1195391,598093,597298,2.8469346013145493,34032,4.730746935898879
68,K SHYAMBABU SUBUDHI,GEN,BERHAMPUR,25057,4,IND,1,M,ORISSA,719379,719283,96,1195391,598093,597298,2.0962178902133277,25058,3.4832821085964425
61,GIRIDHAR GAMANG,ST,KORAPUT (ST),334706,1,INC,42,M,ORISSA,735667,735544,123,1139590,554408,585182,29.37442413499592,334748,45.50265269476543
60,PAPANNA MUTIKA,ST,KORAPUT (ST),291403,3,BJD,78,M,ORISSA,735667,735544,123,1139590,554408,585182,25.577707772093472,291481,39.62132323456129
26,TANKADHAR MAJHI,ST,KORAPUT (ST),61069,2,BSP,3,M,ORISSA,735667,735544,123,1139590,554408,585182,5.359120385401767,61072,8.301582101684593
27,MEGHANADA SABAR,ST,KORAPUT (ST),48366,4,CPI(ML)(L),0,M,ORISSA,735667,735544,123,1139590,554408,585182,4.2441579866443195,48366,6.574441968988687
43,PARSURAM MAJHI,ST,NOWRANGPUR (ST),359791,3,BJP,198,M,ORISSA,780728,780357,371,1161159,575221,585938,31.002558650451835,359989,46.10940045700935
37,CHANDRA SEKHAR MAJHI,ST,NOWRANGPUR (ST),334932,2,INC,167,M,ORISSA,780728,780357,371,1161159,575221,585938,28.859010695348353,335099,42.921350329436116
44,CHANDRADHWAJA MAJHI,ST,NOWRANGPUR (ST),85634,1,BSP,6,M,ORISSA,780728,780357,371,1161159,575221,585938,7.375389589194933,85640,10.969249213554528
52,BIKRAM KESHARI DEO,GEN,KALAHANDI,356974,1,BJP,105,M,ORISSA,754128,753897,231,1132680,570384,562296,31.52514390648727,357079,47.349919377081875
45,BHAKTA CHARAN DAS,SC,KALAHANDI,322832,2,INC,125,M,ORISSA,754128,753897,231,1132680,570384,562296,28.51264258219444,322957,42.82522330426665
66,KUNJA BIHARI BAGARTTI,GEN,KALAHANDI,38368,3,SP,1,M,ORISSA,754128,753897,231,1132680,570384,562296,3.387452766889148,38369,5.087863068338532
52,PANCHANAN DHANGADA MAJHI,SC,KALAHANDI,35723,4,RPI,0,M,ORISSA,754128,753897,231,1132680,570384,562296,3.153847512095208,35723,4.736994250312944
40,SUGRIB SINGH,SC,PHULBANI (SC),337916,3,BJD,35,M,ORISSA,787293,787239,54,1183731,598507,585224,28.549645147419472,337951,42.92569602422478
44,ABHIMANYU BEHERA,SC,PHULBANI (SC),318660,1,INC,19,M,ORISSA,787293,787239,54,1183731,598507,585224,26.921572553223662,318679,40.47781448583945
41,NAKUL NAYAK,SC,PHULBANI (SC),60626,5,IND,0,M,ORISSA,787293,787239,54,1183731,598507,585224,5.121602796581318,60626,7.700563830746622
58,RAMACHANDRA NAIK,SC,PHULBANI (SC),20787,7,IND,0,M,ORISSA,787293,787239,54,1183731,598507,585224,1.7560577529861092,20787,2.6403130727696045
63,BIDYADHAR URMA,SC,PHULBANI (SC),17187,2,BSP,0,M,ORISSA,787293,787239,54,1183731,598507,585224,1.4519346033853975,17187,2.1830500207673635
35,BISHNU CHARAN BEHERA,SC,PHULBANI (SC),16862,6,IND,0,M,ORISSA,787293,787239,54,1183731,598507,585224,1.4244790412686665,16862,2.141769328572717
50,KARUNAKAR HARIPALA,SC,PHULBANI (SC),15201,4,RPI,0,M,ORISSA,787293,787239,54,1183731,598507,585224,1.284159999189005,15201,1.930793237079461
42,SANGEETA KUMARI SINGH DEO,GEN,BOLANGIR,322886,3,BJP,26,F,ORISSA,728378,728342,36,1099775,561952,537823,29.36164215407697,322912,44.33302488543037
47,SARAT PATTANAYAK,GEN,BOLANGIR,222222,2,INC,8,M,ORISSA,728378,728342,36,1099775,561952,537823,20.206860494191993,222230,30.51025703686822
62,BALGOPAL MISHRA,GEN,BOLANGIR,90416,5,IND,2,M,ORISSA,728378,728342,36,1099775,561952,537823,8.221499852242504,90418,12.413609417088379
33,DEBENDRA KUMAR BISWAL,GEN,BOLANGIR,30935,1,BSP,0,M,ORISSA,728378,728342,36,1099775,561952,537823,2.8128480825623425,30935,4.247107957681314
37,HENABATI BARIK,SC,BOLANGIR,24235,7,IND,0,F,ORISSA,728378,728342,36,1099775,561952,537823,2.2036325612057013,24235,3.327255902841656
50,LALIT MOHAN GANDHI,SC,BOLANGIR,20351,6,IND,0,M,ORISSA,728378,728342,36,1099775,561952,537823,1.8504694141983586,20351,2.7940162937375925
51,PARAMANAND CHHATAR,GEN,BOLANGIR,17297,4,SP,0,M,ORISSA,728378,728342,36,1099775,561952,537823,1.572776249687436,17297,2.374728506352471
54,PRASANNA ACHARYA,GEN,SAMBALPUR,390534,2,BJD,22,M,ORISSA,810601,810569,32,1242861,647990,594871,31.42394845441284,390556,48.181040980704445
30,SANJAY BHOI,GEN,SAMBALPUR,375778,3,INC,8,M,ORISSA,810601,810569,32,1242861,647990,594871,30.23556133791309,375786,46.35893614737707
43,ASHOK MITTAL,GEN,SAMBALPUR,44257,1,BSP,2,M,ORISSA,810601,810569,32,1242861,647990,594871,3.561057913958198,44259,5.46002287191849
36,DHARMENDRA PRADHAN,GEN,DEOGARH,426023,1,BJP,69,M,ORISSA,823301,823184,117,1219887,635009,584878,34.928808979848135,426092,51.75409722568052
63,SRIBALLAV PANIGRAHI,GEN,DEOGARH,346956,2,INC,40,M,ORISSA,823301,823184,117,1219887,635009,584878,28.444929735295155,346996,42.14691832027412
64,BUNDE DHURUA,ST,DEOGARH,16796,6,IND,1,M,ORISSA,823301,823184,117,1219887,635009,584878,1.3769308140835994,16797,2.0402015787664536
32,SUDARSAN BEHERA,GEN,DEOGARH,14977,3,BSP,2,M,ORISSA,823301,823184,117,1219887,635009,584878,1.2279006170243638,14979,1.8193831903520097
36,ROHIT GANGA DEB,GEN,DEOGARH,10714,4,SP,5,M,ORISSA,823301,823184,117,1219887,635009,584878,0.8786879440472765,10719,1.30195396337427
27,TANKADHAR BARIK,SC,DEOGARH,7718,5,IND,0,M,ORISSA,823301,823184,117,1219887,635009,584878,0.6326815516519153,7718,0.9374457215526278
48,TATHAGATA SATAPATHY,GEN,DHENKANAL,423448,2,BJD,91,M,ORISSA,790367,790179,188,1174787,614835,559952,36.05240779817959,423539,53.58763713565976
63,KAMAKHYA PRASAD SINGHDEO,GEN,DHENKANAL,300565,1,INC,92,M,ORISSA,790367,790179,188,1174787,614835,559952,25.59246910290972,300657,38.04017627254174
61,BHAJAMAN BEHERA,SC,DHENKANAL,32677,4,SP,2,M,ORISSA,790367,790179,188,1174787,614835,559952,2.7816957456968794,32679,4.134661492698961
34,DIBYA KISHORE DAS,GEN,DHENKANAL,18848,5,IND,2,M,ORISSA,790367,790179,188,1174787,614835,559952,1.6045461858192167,18850,2.3849679958803947
42,BENUDHAR BEHERA,SC,DHENKANAL,14641,3,RPI,1,M,ORISSA,790367,790179,188,1174787,614835,559952,1.2463535943111388,14642,1.8525571032191375
43,JUAL ORAM,ST,SUNDARGARH (ST),336532,1,BJP,30,M,ORISSA,732351,732302,49,1209123,630395,578728,27.835216102910955,336562,45.95637884020094
78,FRIDA TOPNO,ST,SUNDARGARH (ST),296872,2,INC,14,F,ORISSA,732351,732302,49,1209123,630395,578728,24.553829511141547,296886,40.53875805453942
45,GEORGE TIRKEY,ST,SUNDARGARH (ST),66542,5,IND,3,M,ORISSA,732351,732302,49,1209123,630395,578728,5.503575732162899,66545,9.086489948125967
43,HARSA CHHATRIA,ST,SUNDARGARH (ST),18562,3,BSP,0,M,ORISSA,732351,732302,49,1209123,630395,578728,1.535162262234694,18562,2.5345769992803997
37,RADHIKA EKKA,ST,SUNDARGARH (ST),13794,4,JKP,2,F,ORISSA,732351,732302,49,1209123,630395,578728,1.1409922729118542,13796,1.8837961578532698
34,ANANTA NAYAK,ST,KEONJHAR (ST),355670,1,BJP,32,M,ORISSA,814662,814619,43,1183472,598600,584872,30.05580191166331,355702,43.66252507174755
45,NILAKANTHA NAYAK,ST,KEONJHAR (ST),306482,2,INC,11,M,ORISSA,814662,814619,43,1183472,598600,584872,25.89778211905309,306493,37.62210585494352
53,MAHESWAR MAJHI,ST,KEONJHAR (ST),61612,5,IND,0,M,ORISSA,814662,814619,43,1183472,598600,584872,5.2060378276799115,61612,7.562891113124216
54,DR SUDARSAN LOHAR,ST,KEONJHAR (ST),38199,6,IND,0,M,ORISSA,814662,814619,43,1183472,598600,584872,3.2277062744196736,38199,4.68893848000766
56,UPENDRA NATH NAYAK,ST,KEONJHAR (ST),31165,3,IND,0,M,ORISSA,814662,814619,43,1183472,598600,584872,2.633353387321373,31165,3.8255129121034246
26,DEEPAK KUMAR SINGH,ST,KEONJHAR (ST),21491,4,IND,0,M,ORISSA,814662,814619,43,1183472,598600,584872,1.815928048994822,21491,2.6380265680736303
58,VINOD KHANNA,GEN,GURDASPUR,387597,3,BJP,15,M,PUNJAB,785834,785813,21,1210260,617250,593010,32.02716771602796,387612,49.32492103930347
60,SUKHBUNS KAUR BHINDER,GEN,GURDASPUR,362623,1,INC,6,F,PUNJAB,785834,785813,21,1210260,617250,593010,29.962900533769606,362629,46.14575088377443
61,BRIJ MOHAN JULKA,GEN,GURDASPUR,16651,2,BSP,0,M,PUNJAB,785834,785813,21,1210260,617250,593010,1.375820071720126,16651,2.1188953392192245
28,BALKAR,GEN,GURDASPUR,7503,9,IND,0,M,PUNJAB,785834,785813,21,1210260,617250,593010,0.6199494323533786,7503,0.954781798700489
49,BALKAR SINGH,GEN,GURDASPUR,3858,4,BGTD,0,M,PUNJAB,785834,785813,21,1210260,617250,593010,0.31877447821129345,3858,0.49094337989957165
54,DEVINDER SINGH SAINI,GEN,GURDASPUR,3277,7,IND,0,M,PUNJAB,785834,785813,21,1210260,617250,593010,0.2707682646704014,3277,0.41700919023610583
52,RAMESH KUMAR,GEN,GURDASPUR,1690,5,PBLP,0,M,PUNJAB,785834,785813,21,1210260,617250,593010,0.13963941632376514,1690,0.21505814205035667
41,NEERAJ JOSHI,GEN,GURDASPUR,1645,8,IND,0,M,PUNJAB,785834,785813,21,1210260,617250,593010,0.13592120701336904,1645,0.2093317418182466
53,KEWAL KRISHAN,SC,GURDASPUR,969,6,IND,0,M,PUNJAB,785834,785813,21,1210260,617250,593010,0.08006544048386297,969,0.12330848499810393
41,NAVJOT SINGH SIDHU,GEN,AMRITSAR,394215,1,BJP,8,M,PUNJAB,711820,711808,12,1292902,672533,620369,30.49132880914408,394223,55.38240004495518
83,RAGHUNANDAN LAL BHATIA,GEN,AMRITSAR,284687,2,INC,4,M,PUNJAB,711820,711808,12,1292902,672533,620369,22.019534349857917,284691,39.99480205669973
55,RAM SHARAN PAUL,GEN,AMRITSAR,15796,3,BSP,0,M,PUNJAB,711820,711808,12,1292902,672533,620369,1.2217476653296226,15796,2.2191003343541906
67,RAMESH TALWAR,GEN,AMRITSAR,5695,11,IND,0,M,PUNJAB,711820,711808,12,1292902,672533,620369,0.4404819545487593,5695,0.800061813379787
44,REHMAT MASIH,GEN,AMRITSAR,3252,10,IND,0,M,PUNJAB,711820,711808,12,1292902,672533,620369,0.251527184581662,3252,0.4568570706077379
36,SURINDER KUMAR KHOSLA,SC,AMRITSAR,2425,7,IND,0,M,PUNJAB,711820,711808,12,1292902,672533,620369,0.18756255307826888,2425,0.34067601359894356
38,BALDEV SINGH RATHAUR,SC,AMRITSAR,1674,9,IND,0,M,PUNJAB,711820,711808,12,1292902,672533,620369,0.12947617066104006,1674,0.23517181309881713
52,SAT PAL DOGRA,SC,AMRITSAR,1301,6,IND,0,M,PUNJAB,711820,711808,12,1292902,672533,620369,0.10062634290920736,1301,0.18277092523390745
32,SANJIV KUMAR PRASHAR ADVOCATE,GEN,AMRITSAR,990,8,IND,0,M,PUNJAB,711820,711808,12,1292902,672533,620369,0.07657192888556132,990,0.13908010452080583
59,HARBANS LAL MAHAJAN,GEN,AMRITSAR,982,4,SP,0,M,PUNJAB,711820,711808,12,1292902,672533,620369,0.0759531658238598,982,0.13795622488831447
28,GEETA,GEN,AMRITSAR,791,5,BGTD,0,F,PUNJAB,711820,711808,12,1292902,672533,620369,0.06118019772573637,791,0.11112359866258324
60,DR RATTAN SINGH AJNALA,GEN,TARN TARAN,364643,2,SAD,3,M,PUNJAB,717375,717320,55,1173431,602797,570634,31.075197433849965,364646,50.83059766509845
45,SUKHBINDER SINGH ( SUKH SARKARIA),GEN,TARN TARAN,308201,1,INC,51,M,PUNJAB,717375,717320,55,1173431,602797,570634,26.269290652795096,308252,42.969437184178425
59,TARLOCHAN SINGH TUR,GEN,TARN TARAN,15090,6,IND,0,M,PUNJAB,717375,717320,55,1173431,602797,570634,1.2859725028570066,15090,2.1035023523261893
60,RAVEL SINGH,SC,TARN TARAN,14725,3,BSP,0,M,PUNJAB,717375,717320,55,1173431,602797,570634,1.2548671374797495,14725,2.0526224080850324
29,RAJINDER RIKHI,GEN,TARN TARAN,7274,9,IND,0,M,PUNJAB,717375,717320,55,1173431,602797,570634,0.619891582888129,7274,1.0139745600278793
32,MANOJ KUMAR DUGGAL,GEN,TARN TARAN,2911,8,IND,0,M,PUNJAB,717375,717320,55,1173431,602797,570634,0.24807594140601363,2911,0.4057849799616658
41,BABU RAM,SC,TARN TARAN,1847,7,IND,0,M,PUNJAB,717375,717320,55,1173431,602797,570634,0.15740167082683174,1847,0.25746645757100545
66,RAJWANT SINGH,GEN,TARN TARAN,1534,4,BGTD,1,M,PUNJAB,717375,717320,55,1173431,602797,570634,0.13081297494271074,1535,0.21397456002787943
34,SUKHJINDER SINGH,GEN,TARN TARAN,1095,5,IND,0,M,PUNJAB,717375,717320,55,1173431,602797,570634,0.09331609613177086,1095,0.15263983272347098
52,RANA GURJEET SINGH,GEN,JULLUNDUR,344617,3,INC,2,M,PUNJAB,741739,741728,11,1221443,635041,586402,28.214087763407708,344619,46.46095189817442
55,NARESH GUJRAL,GEN,JULLUNDUR,311148,2,SAD,8,M,PUNJAB,741739,741728,11,1221443,635041,586402,25.474459307556717,311156,41.94952672031537
49,DEVI DASS NAHAR,SC,JULLUNDUR,69187,1,BSP,1,M,PUNJAB,741739,741728,11,1221443,635041,586402,5.664447706524169,69188,9.327809377692153
43,VINAY JALANDHARI,GEN,JULLUNDUR,3716,11,IND,0,M,PUNJAB,741739,741728,11,1221443,635041,586402,0.30423032429675395,3716,0.5009848477699028
49,BALKAR SINGH,GEN,JULLUNDUR,3342,4,BGTD,0,M,PUNJAB,741739,741728,11,1221443,635041,586402,0.27361080296010537,3342,0.4505627990438685
50,MANOHAR LAL,SC,JULLUNDUR,2088,10,IND,0,M,PUNJAB,741739,741728,11,1221443,635041,586402,0.17094534906663678,2088,0.28150063566834155
57,HAMID MASIH,GEN,JULLUNDUR,2078,7,IND,0,M,PUNJAB,741739,741728,11,1221443,635041,586402,0.17012664528758198,2078,0.2801524525473246
57,KULBHUSHAN KUMAR,GEN,JULLUNDUR,1837,9,IND,0,M,PUNJAB,741739,741728,11,1221443,635041,586402,0.15039588421236194,1837,0.24766123933081582
36,SANDEEP JAIRATH,GEN,JULLUNDUR,1591,6,IND,0,M,PUNJAB,741739,741728,11,1221443,635041,586402,0.1302557712476145,1591,0.2144959345537986
41,VIJAY KUMAR HANS,SC,JULLUNDUR,1288,5,DBSP,0,M,PUNJAB,741739,741728,11,1221443,635041,586402,0.10544904674225486,1288,0.17364598598698464
37,DR KULDEEP SINGH DHILLON,GEN,JULLUNDUR,836,8,IND,0,M,PUNJAB,741739,741728,11,1221443,635041,586402,0.06844363592897908,836,0.11270810891701798
67,CHARANJIT SINGH ATWAL,SC,PHILLAUR (SC),324511,2,SAD,1,M,PUNJAB,722537,722533,4,1181507,608376,573131,27.465939685503344,324512,44.91285567382708
62,SANTOSH CHOWDHARY,SC,PHILLAUR (SC),225628,1,INC,0,F,PUNJAB,722537,722533,4,1181507,608376,573131,19.09662828912567,225628,31.22718974945228
38,PAWAN KUMAR TINU,SC,PHILLAUR (SC),157635,3,BSP,2,M,PUNJAB,722537,722533,4,1181507,608376,573131,13.342028443335503,157637,21.817152616405803
41,HANS RAJ PABWAN,SC,PHILLAUR (SC),7103,7,IND,0,M,PUNJAB,722537,722533,4,1181507,608376,573131,0.6011813726029553,7103,0.9830638430973084
62,HARBHAJAN LAKHA,SC,PHILLAUR (SC),3138,4,SMSP,1,M,PUNJAB,722537,722533,4,1181507,608376,573131,0.26567764727589427,3139,0.4344414196089612
55,HARBANS SINGH DHALIWAL,SC,PHILLAUR (SC),2380,6,IND,0,M,PUNJAB,722537,722533,4,1181507,608376,573131,0.20143765546882078,2380,0.329394896039926
38,JAGIR SINGH SAFRI,SC,PHILLAUR (SC),2138,5,BGTD,0,M,PUNJAB,722537,722533,4,1181507,608376,573131,0.18095533924047846,2138,0.2959018015686394
43,AVINASH RAI KHANNA,GEN,HOSHIARPUR,289797,1,BJP,18,M,PUNJAB,655691,655662,29,1137423,584689,552734,25.479966555977857,289815,44.19993564041599
50,COMRADE DARSHAN SINGH MATTU,GEN,HOSHIARPUR,185438,3,CPM,6,M,PUNJAB,655691,655662,29,1137423,584689,552734,16.303872877548635,185444,28.28222440143299
62,CHARANJIT SINGH CHANNI,GEN,HOSHIARPUR,156265,2,BSP,5,M,PUNJAB,655691,655662,29,1137423,584689,552734,13.73895199938809,156270,23.83287249634355
35,AJEET SINGH PARMAR,GEN,HOSHIARPUR,7511,4,SJP(R),0,M,PUNJAB,655691,655662,29,1137423,584689,552734,0.6603523930850704,7511,1.1455090888848558
34,KULDIP RAI,GEN,HOSHIARPUR,6565,8,IND,0,M,PUNJAB,655691,655662,29,1137423,584689,552734,0.5771819279195163,6565,1.0012338128783222
73,SADHU SINGH SAINI,GEN,HOSHIARPUR,3883,6,IND,0,M,PUNJAB,655691,655662,29,1137423,584689,552734,0.3413857465516347,3883,0.5921996794221668
46,HARMESH LAL AZAD,SC,HOSHIARPUR,3416,7,IND,0,M,PUNJAB,655691,655662,29,1137423,584689,552734,0.30032802220458,3416,0.5209771065944172
39,GURDEV SINGH,GEN,HOSHIARPUR,2787,5,BGTD,0,M,PUNJAB,655691,655662,29,1137423,584689,552734,0.24502757549302237,2787,0.42504777402770516
72,SUKHDEV SINGH LIBRA,SC,ROPAR (SC),347619,1,SAD,12,M,PUNJAB,790221,790206,15,1345244,710102,635142,25.841483032074482,347631,43.991617534841524
56,SHAMSHER SINGH DULLO,SC,ROPAR (SC),313991,2,INC,3,M,PUNJAB,790221,790206,15,1345244,710102,635142,23.341044449928784,313994,39.73496021998909
44,MAAN SINGH MANHERA,SC,ROPAR (SC),78191,4,BSP,0,M,PUNJAB,790221,790206,15,1345244,710102,635142,5.812402805736357,78191,9.89482689019907
62,BHAG SINGH,SC,ROPAR (SC),27393,3,SAD(M),0,M,PUNJAB,790221,790206,15,1345244,710102,635142,2.0362848672805822,27393,3.4664986124134893
63,SURJAN SINGH,SC,ROPAR (SC),15197,8,IND,0,M,PUNJAB,790221,790206,15,1345244,710102,635142,1.129683536964298,15197,1.9231328957342313
53,SUCHA SINGH,SC,ROPAR (SC),3276,7,IND,0,M,PUNJAB,790221,790206,15,1345244,710102,635142,0.24352459479469896,3276,0.4145675703379181
65,SAWINDER SINGH,SC,ROPAR (SC),2650,6,IND,0,M,PUNJAB,790221,790206,15,1345244,710102,635142,0.1969902857771527,2650,0.33534922509019627
66,LEHMBAR DASS,SC,ROPAR (SC),1889,5,BGTD,0,M,PUNJAB,790221,790206,15,1345244,710102,635142,0.14042062257850618,1889,0.23904705139448335
59,PRENEET KAUR,GEN,PATIALA,409893,4,INC,24,F,PUNJAB,874131,874085,46,1427103,752022,675081,28.723715106758235,409917,46.89422981223638
60,KANWALJIT SINGH,GEN,PATIALA,386234,2,SAD,16,M,PUNJAB,874131,874085,46,1427103,752022,675081,27.06532044288324,386250,44.18674088895143
62,HARGOPAL SINGH,GEN,PATIALA,39329,1,BSP,2,M,PUNJAB,874131,874085,46,1427103,752022,675081,2.756002895376157,39331,4.49944001528375
45,GURNAM SINGH,GEN,PATIALA,11494,3,SAD(M),2,M,PUNJAB,874131,874085,46,1427103,752022,675081,0.8055480228126491,11496,1.3151346880501893
26,RAM SARUP,GEN,PATIALA,6070,14,IND,0,M,PUNJAB,874131,874085,46,1427103,752022,675081,0.42533720411210685,6070,0.6944039280153661
33,RAM ISHER SINGH,SC,PATIALA,5460,13,IND,0,M,PUNJAB,874131,874085,46,1427103,752022,675081,0.3825932676197864,5460,0.6246203372263426
51,GURBACHAN SINGH,SC,PATIALA,3356,5,SMSP,0,M,PUNJAB,874131,874085,46,1427103,752022,675081,0.2351617227347991,3356,0.3839241486687922
47,DARSHAN SINGH,GEN,PATIALA,2992,11,IND,0,M,PUNJAB,874131,874085,46,1427103,752022,675081,0.20965550489348,2992,0.3422827928537027
29,BINDER KAUR,SC,PATIALA,2535,12,IND,0,F,PUNJAB,874131,874085,46,1427103,752022,675081,0.17763258853775796,2535,0.2900022994265161
44,JAI PAL,GEN,PATIALA,1924,10,IND,0,M,PUNJAB,874131,874085,46,1427103,752022,675081,0.1348185800184009,1924,0.22010430930833022
50,KRISHNA DAHRI,GEN,PATIALA,1585,9,IND,0,F,PUNJAB,874131,874085,46,1427103,752022,675081,0.1110641628529966,1585,0.18132293672229907
53,KARTAR SINGH,GEN,PATIALA,1356,8,IND,2,M,PUNJAB,874131,874085,46,1427103,752022,675081,0.09515781271569046,1358,0.1553542890024493
54,RANJIT KAUR,GEN,PATIALA,933,6,BGTD,0,F,PUNJAB,874131,874085,46,1427103,752022,675081,0.06537720122513932,933,0.10673457410845742
50,HARBANS SINGH,SC,PATIALA,924,7,IND,0,M,PUNJAB,874131,874085,46,1427103,752022,675081,0.06474655298181001,924,0.10570498014599641
51,SHARANJIT SINGH DHILLON,GEN,LUDHIANA,329232,1,SAD,2,M,PUNJAB,869927,869922,5,1560468,825291,735177,21.098414065523933,329234,37.84616410342477
38,MUNISH TEWARI,GEN,LUDHIANA,299694,2,INC,0,M,PUNJAB,869927,869922,5,1560468,825291,735177,19.2053922284853,299694,34.45047687909445
62,BALWANT SINGH RAMOOWALIA,GEN,LUDHIANA,187787,5,LBP,0,M,PUNJAB,869927,869922,5,1560468,825291,735177,12.034017999728288,187787,21.58652392672029
45,RABINDER SINGH SOHIL,GEN,LUDHIANA,19592,3,BSP,3,M,PUNJAB,869927,869922,5,1560468,825291,735177,1.2557130296808394,19595,2.252487852428997
39,RASHPAL SINGH GILL,GEN,LUDHIANA,6131,17,IND,0,M,PUNJAB,869927,869922,5,1560468,825291,735177,0.3928949520272123,6131,0.7047717797010554
31,VARINDER KUMAR KOFFI,GEN,LUDHIANA,5762,18,IND,0,M,PUNJAB,869927,869922,5,1560468,825291,735177,0.36924819989900465,5762,0.6623544274404634
50,MAHINDER LAL,SC,LUDHIANA,4745,16,IND,0,M,PUNJAB,869927,869922,5,1560468,825291,735177,0.3040754440334566,4745,0.5454480663320026
31,BOBY,SC,LUDHIANA,3383,15,IND,0,M,PUNJAB,869927,869922,5,1560468,825291,735177,0.21679393617812093,3383,0.38888320514250047
52,SADHON SINGH,GEN,LUDHIANA,2368,4,SP,0,M,PUNJAB,869927,869922,5,1560468,825291,735177,0.15174934699077458,2368,0.27220674838233555
51,DR JANARDAN PRASAD SINGH,GEN,LUDHIANA,1928,12,IND,0,M,PUNJAB,869927,869922,5,1560468,825291,735177,0.12355267778640767,1928,0.2216277917572394
38,RAVINDER KUMAR JASSI,SC,LUDHIANA,1833,7,JKNPP,0,M,PUNJAB,869927,869922,5,1560468,825291,735177,0.11746476057182846,1833,0.21070733521318455
38,DALJINDER SINGH JHAMMAT,SC,LUDHIANA,1642,13,IND,0,M,PUNJAB,869927,869922,5,1560468,825291,735177,0.1052248428035692,1642,0.18875146995092693
60,BALWANT SINGH,GEN,LUDHIANA,1639,14,IND,0,M,PUNJAB,869927,869922,5,1560468,825291,735177,0.10503259278626668,1639,0.18840661342848308
43,DR SATNAM SINGH,GEN,LUDHIANA,1181,9,IND,0,M,PUNJAB,869927,869922,5,1560468,825291,735177,0.07568242347808478,1181,0.13575851766872393
58,MASTER MANJEET SINGH WALIA,GEN,LUDHIANA,1123,6,BGTD,0,M,PUNJAB,869927,869922,5,1560468,825291,735177,0.07196558981023642,1123,0.12909129156814309
39,KARNAIL SINGH RATHOR,GEN,LUDHIANA,783,10,IND,0,M,PUNJAB,869927,869922,5,1560468,825291,735177,0.05017725451595291,783,0.09000755235784152
51,JASDEV SINGH,GEN,LUDHIANA,610,11,IND,0,M,PUNJAB,869927,869922,5,1560468,825291,735177,0.039090836851508645,610,0.0701208262302469
48,ABDUL SHAKOOR THIND,GEN,LUDHIANA,489,8,IND,0,M,PUNJAB,869927,869922,5,1560468,825291,735177,0.031336752820307755,489,0.05621161315834547
67,SUKHDEV SINGH DHINDSA,GEN,SANGRUR,286804,3,SAD,24,M,PUNJAB,836818,836752,66,1214485,637300,577185,23.617253403706098,286828,34.27603134731805
37,ARVIND KHANNA,GEN,SANGRUR,259536,1,INC,15,M,PUNJAB,836818,836752,66,1214485,637300,577185,21.371280830969503,259551,31.01642173089011
59,SIMRANJIT SINGH MANN,GEN,SANGRUR,216888,2,SAD(M),10,M,PUNJAB,836818,836752,66,1214485,637300,577185,17.859257216021607,216898,25.91937553924509
45,MANGAT RAI BANSAL,GEN,SANGRUR,38213,4,BSP,2,M,PUNJAB,836818,836752,66,1214485,637300,577185,3.146601234268023,38215,4.566703871092638
60,SUKHDEV SINGH BARI,GEN,SANGRUR,14274,7,IND,15,M,PUNJAB,836818,836752,66,1214485,637300,577185,1.1765480841673632,14289,1.7075397517739819
36,MOHAMAD SHAMSHAD,GEN,SANGRUR,8872,11,IND,0,M,PUNJAB,836818,836752,66,1214485,637300,577185,0.73051540364846,8872,1.0602066399145333
59,MIT SINGH,GEN,SANGRUR,3366,10,IND,0,M,PUNJAB,836818,836752,66,1214485,637300,577185,0.27715451405328184,3366,0.4022380015726239
30,BALJINDER SINGH,GEN,SANGRUR,2631,9,IND,0,M,PUNJAB,836818,836752,66,1214485,637300,577185,0.21663503460314454,2631,0.3144052828691543
39,SUKHDEV SINGH,SC,SANGRUR,2449,6,IND,0,M,PUNJAB,836818,836752,66,1214485,637300,577185,0.201649258739301,2449,0.2926562287140095
39,AVTAR SINGH,SC,SANGRUR,2046,5,IND,0,M,PUNJAB,836818,836752,66,1214485,637300,577185,0.16846646932650464,2046,0.24449760879904592
31,DALJIT SINGH,GEN,SANGRUR,1673,8,IND,0,M,PUNJAB,836818,836752,66,1214485,637300,577185,0.13775386274840776,1673,0.19992399781075454
56,PARAMJIT KAUR GULSHAN,SC,BHATINDA (SC),323381,4,SAD,13,F,PUNJAB,763195,763164,31,1285978,675522,610456,25.147708592215416,323394,42.3737052784675
55,KAUSHALYA CHAMAN BHAURA,SC,BHATINDA (SC),260748,2,CPI,4,F,PUNJAB,763195,763164,31,1285978,675522,610456,20.27655216496705,260752,34.16584228146149
25,SARABJEET SINGH,SC,BHATINDA (SC),113480,1,SAD(M),10,M,PUNJAB,763195,763164,31,1285978,675522,610456,8.825189855502972,113490,14.870380440123428
56,GURNAM SINGH,SC,BHATINDA (SC),31723,3,BSP,4,M,PUNJAB,763195,763164,31,1285978,675522,610456,2.467149515777097,31727,4.157128912008071
32,JASVIR SINGH,SC,BHATINDA (SC),8733,10,IND,0,M,PUNJAB,763195,763164,31,1285978,675522,610456,0.6790940435995017,8733,1.1442685028072772
28,BHAGWANT SINGH SAMAON,SC,BHATINDA (SC),7505,6,CPI(ML)(L),0,M,PUNJAB,763195,763164,31,1285978,675522,610456,0.5836025188611313,7505,0.9833659811712603
33,GURPREET SINGH BAHIA,SC,BHATINDA (SC),6689,9,IND,0,M,PUNJAB,763195,763164,31,1285978,675522,610456,0.5201488672434521,6689,0.8764470417127995
40,PARMINDER SINGH QUAMI,SC,BHATINDA (SC),5429,5,DBSP,0,M,PUNJAB,763195,763164,31,1285978,675522,610456,0.42216896401027076,5429,0.7113516204901762
40,SHAM LAL,SC,BHATINDA (SC),2908,7,IND,0,M,PUNJAB,763195,763164,31,1285978,675522,610456,0.22613139571594537,2908,0.38102974993284805
40,HARI SINGH,SC,BHATINDA (SC),2568,8,IND,0,M,PUNJAB,763195,763164,31,1285978,675522,610456,0.199692374208579,2568,0.3364801918251561
42,SUKHBIR SINGH BADAL,GEN,FARIDKOT,475900,1,SAD,28,M,PUNJAB,893144,893111,33,1262934,658013,604921,37.68431287779092,475928,53.286816011751746
52,KARAN KAUR BRAR,GEN,FARIDKOT,340646,3,INC,3,F,PUNJAB,893144,893111,33,1262934,658013,604921,26.972826766877763,340649,38.14043424128696
43,SANT RAM,SC,FARIDKOT,45205,2,BSP,2,M,PUNJAB,893144,893111,33,1262934,658013,604921,3.5795219702692305,45207,5.061557822702722
45,GURLAL SINGH,GEN,FARIDKOT,10857,4,SAD(M),0,M,PUNJAB,893144,893111,33,1262934,658013,604921,0.8596648755992,10857,1.2155934541350555
40,HARMAIL SINGH,GEN,FARIDKOT,7501,10,IND,0,M,PUNJAB,893144,893111,33,1262934,658013,604921,0.5939344415464308,7501,0.8398421755058535
40,NIRMAL SINGH,SC,FARIDKOT,4448,8,LJNSP,0,M,PUNJAB,893144,893111,33,1262934,658013,604921,0.352195760031799,4448,0.49801599742034874
32,NAVNEET KUMAR,GEN,FARIDKOT,3064,7,SHS,0,M,PUNJAB,893144,893111,33,1262934,658013,604921,0.24260966923053778,3064,0.3430577823956719
30,SUKHBIR SINGH,GEN,FARIDKOT,2735,9,IND,0,M,PUNJAB,893144,893111,33,1262934,658013,604921,0.21655921845480444,2735,0.30622161711885204
38,KULWANT SINGH,GEN,FARIDKOT,1675,6,MB(S)P,0,M,PUNJAB,893144,893111,33,1262934,658013,604921,0.1326276749220466,1675,0.18753974723000993
50,ASHOK KUMAR,GEN,FARIDKOT,1080,5,JD(S),0,M,PUNJAB,893144,893111,33,1262934,658013,604921,0.08551515756167781,1080,0.12092115045278252
62,ZORA SINGH MAAN,GEN,FEROZEPUR,357094,2,SAD,8,M,PUNJAB,866640,866629,11,1302221,673358,628863,27.422534270296673,357102,41.20534477983938
45,JAGMEET SINGH BRAR,GEN,FEROZEPUR,345562,1,INC,1,M,PUNJAB,866640,866629,11,1302221,673358,628863,26.53643275603757,345563,39.87388073479184
43,MOHAN SINGH FALIAN WALA,GEN,FEROZEPUR,101919,4,BSP,2,M,PUNJAB,866640,866629,11,1302221,673358,628863,7.826705298102242,101921,11.760477245453705
46,INDERJIT SINGH ZIRA,GEN,FEROZEPUR,27941,10,IND,0,M,PUNJAB,866640,866629,11,1302221,673358,628863,2.145641945568379,27941,3.224060740330472
40,VARDEV SINGH,GEN,FEROZEPUR,8697,16,IND,0,M,PUNJAB,866640,866629,11,1302221,673358,628863,0.6678589886048527,8697,1.0035308778731653
44,DHIAN SINGH MAND,GEN,FEROZEPUR,7548,3,SAD(M),0,M,PUNJAB,866640,866629,11,1302221,673358,628863,0.579625117395588,7548,0.870949875380781
43,MAHINDERJIT SINGH,GEN,FEROZEPUR,5495,15,IND,0,M,PUNJAB,866640,866629,11,1302221,673358,628863,0.4219713858093212,5495,0.6340579710144928
45,PARAMJIT SINGH DESAL,SC,FEROZEPUR,2486,14,IND,0,M,PUNJAB,866640,866629,11,1302221,673358,628863,0.19090461603675565,2486,0.2868549801532355
48,ANOOP SINGH,GEN,FEROZEPUR,2443,5,LJNSP,0,M,PUNJAB,866640,866629,11,1302221,673358,628863,0.1876025651559912,2443,0.2818932890242777
32,NARDEV SINGH,GEN,FEROZEPUR,1819,13,IND,0,M,PUNJAB,866640,866629,11,1302221,673358,628863,0.13968443144443227,1819,0.2098910735714945
33,AJAY DANIEL ( TINKU ),GEN,FEROZEPUR,1126,9,IND,0,M,PUNJAB,866640,866629,11,1302221,673358,628863,0.08646765794746053,1126,0.1299270746792209
27,ASHOK KUMAR,SC,FEROZEPUR,1112,8,IND,0,M,PUNJAB,866640,866629,11,1302221,673358,628863,0.08539257161418837,1112,0.12831164035816486
62,DES RAJ DEORA,GEN,FEROZEPUR,995,12,IND,0,M,PUNJAB,866640,866629,11,1302221,673358,628863,0.07640792154327107,995,0.11481122496076802
68,MATHRA DASS,GEN,FEROZEPUR,878,7,PTSS,0,M,PUNJAB,866640,866629,11,1302221,673358,628863,0.06742327147235377,878,0.10131080956337118
26,GURSEWAK SINGH,GEN,FEROZEPUR,772,11,IND,0,M,PUNJAB,866640,866629,11,1302221,673358,628863,0.05928333209186459,772,0.08907966398966122
47,SOM PARKASH,GEN,FEROZEPUR,742,6,BGTD,0,M,PUNJAB,866640,866629,11,1302221,673358,628863,0.05697957566342426,742,0.08561801901596973
32,NIHALCHAND MEGHWAL,SC,GANGANAGAR (SC),329816,1,BJP,1659,M,RAJASTHAN,722938,720451,2487,1337857,713696,624161,24.776564311432388,331475,45.851096497901615
47,BHARATRAM,SC,GANGANAGAR (SC),323356,2,INC,726,M,RAJASTHAN,722938,720451,2487,1337857,713696,624161,24.223964145644864,324082,44.82846385167193
60,MUNSHI RAM,SC,GANGANAGAR (SC),25090,3,BSP,54,M,RAJASTHAN,722938,720451,2487,1337857,713696,624161,1.8794235856298542,25144,3.4780299278776328
26,COMRED SHYOPATRAM,SC,GANGANAGAR (SC),22765,4,CPM,36,M,RAJASTHAN,722938,720451,2487,1337857,713696,624161,1.704292760736013,22801,3.1539357455272787
50,TEETAR SINGH,SC,GANGANAGAR (SC),8047,8,IND,0,M,RAJASTHAN,722938,720451,2487,1337857,713696,624161,0.6014843140933598,8047,1.113096835413272
48,BABU LAL,SC,GANGANAGAR (SC),5316,5,LPSP,11,M,RAJASTHAN,722938,720451,2487,1337857,713696,624161,0.39817409483973254,5327,0.7368543360564807
46,TEEKU RAM,SC,GANGANAGAR (SC),3702,7,IND,0,M,RAJASTHAN,722938,720451,2487,1337857,713696,624161,0.2767111881165177,3702,0.5120771075804564
48,HETRAM,SC,GANGANAGAR (SC),2359,6,RJVP,1,M,RAJASTHAN,722938,720451,2487,1337857,713696,624161,0.1764015137641766,2360,0.3264456979713336
68,DHARMENDRA,GEN,BIKANER,515646,2,BJP,2156,M,RAJASTHAN,1077364,1074268,3096,1900686,1017237,883449,27.242900721108064,517802,48.06193635577205
40,RAMESHWAR LAL,GEN,BIKANER,459810,3,INC,817,M,RAJASTHAN,1077364,1074268,3096,1900686,1017237,883449,24.23477628603567,460627,42.75500202345725
42,ARJAN RAM,GEN,BIKANER,38633,1,BSP,96,M,RAJASTHAN,1077364,1074268,3096,1900686,1017237,883449,2.0376327283938536,38729,3.594792474966678
27,SURENDRA KUMAR GANDHI,SC,BIKANER,13281,13,IND,0,M,RAJASTHAN,1077364,1074268,3096,1900686,1017237,883449,0.6987477152985816,13281,1.2327309989938406
27,SHYAM SUNDER,GEN,BIKANER,11540,11,IND,0,M,RAJASTHAN,1077364,1074268,3096,1900686,1017237,883449,0.6071492082332379,11540,1.071132876168129
44,DILIP SINGH MARWAL,GEN,BIKANER,10661,4,INLD,3,M,RAJASTHAN,1077364,1074268,3096,1900686,1017237,883449,0.5610605854938691,10664,0.9898233094850023
38,SAROJ,GEN,BIKANER,7785,12,IND,1,F,RAJASTHAN,1077364,1074268,3096,1900686,1017237,883449,0.40964157151681024,7786,0.7226898244233146
36,DR MOHAN LAL SHARMA,GEN,BIKANER,5193,9,IND,3,M,RAJASTHAN,1077364,1074268,3096,1900686,1017237,883449,0.27337498145406447,5196,0.4822882516958057
72,RAM LAL,GEN,BIKANER,3837,10,IND,11,M,RAJASTHAN,1077364,1074268,3096,1900686,1017237,883449,0.2024532195217937,3848,0.3571680509094419
39,MAHAVIR PRASAD,GEN,BIKANER,2815,5,LPSP,3,M,RAJASTHAN,1077364,1074268,3096,1900686,1017237,883449,0.14826225899491027,2818,0.26156433665873374
31,RAJENDRA SINGH,GEN,BIKANER,1994,6,SP,4,M,RAJASTHAN,1077364,1074268,3096,1900686,1017237,883449,0.10511994090554673,1998,0.18545264181836407
55,BRIJ GOPAL,GEN,BIKANER,1760,8,IND,2,M,RAJASTHAN,1077364,1074268,3096,1900686,1017237,883449,0.09270337130909577,1762,0.1635473247667455
41,JASVINDRA SINGH,GEN,BIKANER,1313,7,IND,0,M,RAJASTHAN,1077364,1074268,3096,1900686,1017237,883449,0.06908032152601745,1313,0.12187153088464066
59,RAMSINGH KASWAN,GEN,CHURU,399881,3,BJP,837,M,RAJASTHAN,833976,832556,1420,1371821,715459,656362,29.210662324020408,400718,48.049104530586014
76,BAL RAM JAKHAR,GEN,CHURU,370311,2,INC,553,M,RAJASTHAN,833976,832556,1420,1371821,715459,656362,27.0344308769147,370864,44.46938521012595
36,DAULATRAM PAINSIYA,GEN,CHURU,30115,1,BSP,27,M,RAJASTHAN,833976,832556,1420,1371821,715459,656362,2.197225439762185,30142,3.6142526883267627
65,DAMODAR MISHRA,GEN,CHURU,10129,4,INLD,3,M,RAJASTHAN,833976,832556,1420,1371821,715459,656362,0.7385803249840904,10132,1.2149030667549185
32,SUFI SULTAN,GEN,CHURU,8594,9,IND,0,M,RAJASTHAN,833976,832556,1420,1371821,715459,656362,0.6264665725338802,8594,1.030485289744549
48,SHABIR KHAN,GEN,CHURU,5146,8,IND,0,M,RAJASTHAN,833976,832556,1420,1371821,715459,656362,0.37512182711884423,5146,0.6170441355626541
30,RANJEET RAI,SC,CHURU,3773,7,IND,0,M,RAJASTHAN,833976,832556,1420,1371821,715459,656362,0.27503588296140674,3773,0.4524111005592487
46,CHIMNA RAM,GEN,CHURU,2499,5,IND,0,M,RAJASTHAN,833976,832556,1420,1371821,715459,656362,0.18216662377963305,2499,0.29964891076002187
33,MOHAMMAD ILIYAS KHICHI (TELI),GEN,CHURU,2108,6,IND,0,M,RAJASTHAN,833976,832556,1420,1371821,715459,656362,0.15366436291615304,2108,0.2527650675798824
76,SHISH RAM OLA,GEN,JHUNJHUNU,273454,2,INC,714,M,RAJASTHAN,681505,679616,1889,1370602,716648,653954,20.00347292649507,274168,40.229785548161786
47,SANTOSH AHLAWAT,GEN,JHUNJHUNU,249805,3,BJP,1008,F,RAJASTHAN,681505,679616,1889,1370602,716648,653954,18.299477164049083,250813,36.80281142471442
33,RANVEER SINGH GUDHA,GEN,JHUNJHUNU,111587,5,LJNSP,109,M,RAJASTHAN,681505,679616,1889,1370602,716648,653954,8.149411718354417,111696,16.389608293409438
72,AYUB KHAN,GEN,JHUNJHUNU,22999,1,BSP,38,M,RAJASTHAN,681505,679616,1889,1370602,716648,653954,1.6807942787184025,23037,3.3803126902957428
57,MAHENDRA CHOUDHARY,GEN,JHUNJHUNU,6806,4,CPI(ML)(L),4,M,RAJASTHAN,681505,679616,1889,1370602,716648,653954,0.49686196284552336,6810,0.9992589929641015
44,MAHADA RAM SAINI,GEN,JHUNJHUNU,5488,9,IND,0,M,RAJASTHAN,681505,679616,1889,1370602,716648,653954,0.4004079959025304,5488,0.8052765570318633
58,ROHITASH,GEN,JHUNJHUNU,3852,6,SP,11,M,RAJASTHAN,681505,679616,1889,1370602,716648,653954,0.28184695484174105,3863,0.5668336989457157
50,VIJAY,GEN,JHUNJHUNU,2969,7,ABHM,1,M,RAJASTHAN,681505,679616,1889,1370602,716648,653954,0.21669310273879652,2970,0.4358001775482205
43,BASANT LAL SAINI,GEN,JHUNJHUNU,2656,8,IND,4,M,RAJASTHAN,681505,679616,1889,1370602,716648,653954,0.19407530413643057,2660,0.3903126169287092
46,SUBHASH MEHARIA,GEN,SIKAR,366644,4,BJP,902,M,RAJASTHAN,779471,777956,1515,1476344,773748,702596,24.89568826777499,367546,47.1532616351346
66,NARAYAN SINGH,GEN,SIKAR,312322,3,INC,541,M,RAJASTHAN,779471,777956,1515,1476344,773748,702596,21.191741220203422,312863,40.13786272997969
49,AMRARAM,GEN,SIKAR,66194,1,CPM,47,M,RAJASTHAN,779471,777956,1515,1476344,773748,702596,4.486826918387584,66241,8.498199419862958
47,RAMESH CHANDRA SHARMA ADVOCATE,GEN,SIKAR,9769,7,IND,5,M,RAJASTHAN,779471,777956,1515,1476344,773748,702596,0.6620408251735368,9774,1.2539273430313636
37,BHAGIRATH SINGH KHARRATE MAHAN,GEN,SIKAR,9530,5,ABHM,0,M,RAJASTHAN,779471,777956,1515,1476344,773748,702596,0.6455135117560677,9530,1.2226240617033861
62,GULAM NABI,GEN,SIKAR,8052,2,BSP,20,M,RAJASTHAN,779471,777956,1515,1476344,773748,702596,0.5467560405975843,8072,1.035574126555061
43,AJAY PAL,GEN,SIKAR,5445,6,IND,0,M,RAJASTHAN,779471,777956,1515,1476344,773748,702596,0.3688164817955707,5445,0.6985506837329419
77,GIRDHARI LAL BHARGAVA,GEN,JAIPUR,480144,1,BJP,586,M,RAJASTHAN,881075,880276,799,1896856,1011448,885408,25.34351579666564,480730,54.561756944641495
35,PRATAP SINGH KHACHARIAWAS,GEN,JAIPUR,373347,2,INC,197,M,RAJASTHAN,881075,880276,799,1896856,1011448,885408,19.692796922908222,373544,42.3963907726357
30,VIJAY RATHI,ST,JAIPUR,8885,12,IND,0,M,RAJASTHAN,881075,880276,799,1896856,1011448,885408,0.46840666871918585,8885,1.0084272054024912
54,O P BARWADIA,GEN,JAIPUR,7302,3,BSP,8,M,RAJASTHAN,881075,880276,799,1896856,1011448,885408,0.3853745355472424,7310,0.8296683029254036
30,MONU KURUVILA,GEN,JAIPUR,3414,11,IND,0,M,RAJASTHAN,881075,880276,799,1896856,1011448,885408,0.17998203342794603,3414,0.3874812019408109
61,BHAG CHAND JAIN,GEN,JAIPUR,1487,10,IND,4,M,RAJASTHAN,881075,880276,799,1896856,1011448,885408,0.07860375273610648,1491,0.16922509434497632
42,MAHENDRA PRATAP SINGH,GEN,JAIPUR,1367,6,RLD,4,M,RAJASTHAN,881075,880276,799,1896856,1011448,885408,0.07227749497062508,1371,0.1556053684419601
48,INDERJEET SINGH,GEN,JAIPUR,1251,4,SP,0,M,RAJASTHAN,881075,880276,799,1896856,1011448,885408,0.06595123720514366,1251,0.1419856425389439
54,AVINASH RAI,GEN,JAIPUR,877,7,IND,0,M,RAJASTHAN,881075,880276,799,1896856,1011448,885408,0.04623440050272661,877,0.09953749680787674
50,PRABHU DEVI SOYAL,SC,JAIPUR,807,9,IND,0,F,RAJASTHAN,881075,880276,799,1896856,1011448,885408,0.04254408347286246,807,0.09159265669778395
35,IFTKHAR,GEN,JAIPUR,732,8,IND,0,M,RAJASTHAN,881075,880276,799,1896856,1011448,885408,0.038590172369436584,732,0.08308032800839883
46,OM PRAKASH KEDAWAT,GEN,JAIPUR,663,5,SAP,0,M,RAJASTHAN,881075,880276,799,1896856,1011448,885408,0.03495257415428477,663,0.07524898561416452
26,SACHIN PILOT,GEN,DAUSA,369555,3,INC,380,M,RAJASTHAN,716901,715613,1288,1462752,770858,691894,25.29034313403776,369935,51.60196456693462
54,KARTAR SINGH BHADANA,GEN,DAUSA,254393,1,BJP,677,M,RAJASTHAN,716901,715613,1288,1462752,770858,691894,17.43767911443635,255070,35.57952911210893
57,ROHITASH KUMAR SHARMA,GEN,DAUSA,46758,6,INLD,180,M,RAJASTHAN,716901,715613,1288,1462752,770858,691894,3.2088829822143463,46938,6.54734754171078
28,RAKESH MEENA,ST,DAUSA,15405,2,BSP,32,M,RAJASTHAN,716901,715613,1288,1462752,770858,691894,1.0553395244033166,15437,2.153295922310054
47,SUBHASH CHANDRA SHARMA,GEN,DAUSA,11990,9,IND,14,M,RAJASTHAN,716901,715613,1288,1462752,770858,691894,0.8206449213537224,12004,1.6744292447632239
52,DHANNA RAM,GEN,DAUSA,7672,4,RJVP,0,M,RAJASTHAN,716901,715613,1288,1462752,770858,691894,0.5244908227778872,7672,1.0701617099153162
33,ROHITASH KULDEEP (RAIGAR),SC,DAUSA,3919,8,IND,5,M,RAJASTHAN,716901,715613,1288,1462752,770858,691894,0.2682614687930695,3924,0.5473559110672185
36,RAMESH,GEN,DAUSA,3047,7,IND,0,M,RAJASTHAN,716901,715613,1288,1462752,770858,691894,0.20830598761786007,3047,0.42502381779353077
48,MUKARRAM ALI,GEN,DAUSA,2874,5,SP,0,M,RAJASTHAN,716901,715613,1288,1462752,770858,691894,0.19647896567565795,2874,0.4008921733963267
59,DR KARAN SINGH YADAV,GEN,ALWAR,245928,1,INC,905,M,RAJASTHAN,542876,540460,2416,1262622,665810,596812,19.549239598232884,246833,45.4676574392679
48,MAHANT CHANDNATH,GEN,ALWAR,237163,2,BJP,1299,M,RAJASTHAN,542876,540460,2416,1262622,665810,596812,18.886254159994046,238462,43.925684686742464
56,BHAI SHREE NATH GURJAR,GEN,ALWAR,21194,3,BSP,53,M,RAJASTHAN,542876,540460,2416,1262622,665810,596812,1.6827680810250416,21247,3.913785100096523
67,PT R D SHARMA,GEN,ALWAR,16519,10,IND,108,M,RAJASTHAN,542876,540460,2416,1262622,665810,596812,1.316862845728967,16627,3.0627620303715766
35,CHANDRABHAN,GEN,ALWAR,5821,4,INLD,12,M,RAJASTHAN,542876,540460,2416,1262622,665810,596812,0.4619751596281389,5833,1.0744626765596563
37,SUBHASH,GEN,ALWAR,5189,12,IND,1,M,RAJASTHAN,542876,540460,2416,1262622,665810,596812,0.4110493877027329,5190,0.956019422483219
45,SAGAR MAL,SC,ALWAR,3626,11,IND,17,M,RAJASTHAN,542876,540460,2416,1262622,665810,596812,0.288526574065714,3643,0.6710556370147143
39,MANJUL KAUSHIK,GEN,ALWAR,1638,6,SP,5,F,RAJASTHAN,542876,540460,2416,1262622,665810,596812,0.1301260393055087,1643,0.30264738172252964
52,LAXMAN SAINI,GEN,ALWAR,1050,9,IND,8,M,RAJASTHAN,542876,540460,2416,1262622,665810,596812,0.08379388288814864,1058,0.19488796704956565
38,BAKSHA NAND BHARTI,GEN,ALWAR,980,5,SMSP,5,M,RAJASTHAN,542876,540460,2416,1262622,665810,596812,0.07801226336940113,985,0.1814410657314009
31,RAMESH CHAND,ST,ALWAR,729,8,IND,1,M,RAJASTHAN,542876,540460,2416,1262622,665810,596812,0.057816195187474946,730,0.13446901318164736
70,MOOL CHAND,SC,ALWAR,623,7,IND,2,M,RAJASTHAN,542876,540460,2416,1262622,665810,596812,0.04950016711256417,625,0.11512757977880769
42,VISHVENDRA SINGH,GEN,BHARATPUR,319077,2,BJP,827,M,RAJASTHAN,576987,575898,1089,1189295,637177,552118,26.898624815541982,319904,55.4438834843766
49,VED PRAKASH,GEN,BHARATPUR,208315,3,INC,240,M,RAJASTHAN,576987,575898,1089,1189295,637177,552118,17.53601923828823,208555,36.14552840878564
70,MANDLESHWAR SINGH,GEN,BHARATPUR,38707,1,BSP,16,M,RAJASTHAN,576987,575898,1089,1189295,637177,552118,3.2559625660580425,38723,6.711243060935515
38,KHURSHEED AHAMAD,GEN,BHARATPUR,3960,4,SP,3,M,RAJASTHAN,576987,575898,1089,1189295,637177,552118,0.3332226234870238,3963,0.6868438976961353
66,DR SAMUNDRA SINGH,GEN,BHARATPUR,3116,7,IND,1,M,RAJASTHAN,576987,575898,1089,1189295,637177,552118,0.2620880437570157,3117,0.5402201436080882
69,SHIV KUMAR SINGH,GEN,BHARATPUR,1494,6,IND,1,M,RAJASTHAN,576987,575898,1089,1189295,637177,552118,0.1257047242273784,1495,0.2591046245409342
29,JAIKAM DEEN,GEN,BHARATPUR,1229,5,IND,1,M,RAJASTHAN,576987,575898,1089,1189295,637177,552118,0.10342261591951535,1230,0.21317638005708966
39,RAMSWAROOP KOLI,SC,BAYANA (SC),264243,2,BJP,808,M,RAJASTHAN,490633,489457,1176,1197119,653647,543472,22.14073955889097,265051,54.02225288555804
66,MAHENDRA SINGH,SC,BAYANA (SC),205070,1,INC,357,M,RAJASTHAN,490633,489457,1176,1197119,653647,543472,17.160115243346734,205427,41.86978862000721
53,SHAKUNTLA PADAM SINGH,SC,BAYANA (SC),11642,3,BSP,6,F,RAJASTHAN,490633,489457,1176,1197119,653647,543472,0.9730026839437016,11648,2.3740759386343764
32,LAKKHEERAM,SC,BAYANA (SC),3226,8,IND,0,M,RAJASTHAN,490633,489457,1176,1197119,653647,543472,0.2694803106458088,3226,0.657517941108731
39,MOOL CHAND KOLI,SC,BAYANA (SC),1790,7,IND,0,M,RAJASTHAN,490633,489457,1176,1197119,653647,543472,0.14952565283818903,1790,0.3648348154323089
40,MAHANT AJAY BALMIKI,SC,BAYANA (SC),1553,4,SP,2,M,RAJASTHAN,490633,489457,1176,1197119,653647,543472,0.12989519003541,1555,0.3169375072610281
46,LAKHAN SINGH MOURYA (JATAV),SC,BAYANA (SC),1310,5,RLD,3,M,RAJASTHAN,490633,489457,1176,1197119,653647,543472,0.109679990042761,1313,0.2676134707612411
40,JANKI DEVI KOLI,SC,BAYANA (SC),623,6,IND,0,F,RAJASTHAN,490633,489457,1176,1197119,653647,543472,0.05204160989843115,623,0.126978821237055
60,NAMO NARAIN,ST,SAWAI MADHOPUR (ST),367208,3,INC,345,M,RAJASTHAN,665594,664489,1105,1340804,719512,621292,27.412880629831054,367553,55.221801879223676
57,JASKAUR,ST,SAWAI MADHOPUR (ST),255645,2,BJP,745,F,RAJASTHAN,665594,664489,1105,1340804,719512,621292,19.122108824257683,256390,38.52047945143736
40,KAILASH,ST,SAWAI MADHOPUR (ST),27319,1,BSP,13,M,RAJASTHAN,665594,664489,1105,1340804,719512,621292,2.038478405494017,27332,4.1064072091996024
48,HARI PRASAD,ST,SAWAI MADHOPUR (ST),7233,5,SJP(R),2,M,RAJASTHAN,665594,664489,1105,1340804,719512,621292,0.5396016121670282,7235,1.08699898136101
56,GEETA,ST,SAWAI MADHOPUR (ST),7084,4,JP,0,F,RAJASTHAN,665594,664489,1105,1340804,719512,621292,0.5283397125903563,7084,1.0643124787783544
61,RASA SINGH RAWAT,GEN,AJMER,313878,2,BJP,910,M,RAJASTHAN,529549,528395,1154,1203803,616207,587596,26.149461332128265,314788,59.44454620818848
49,HAJI HABIBURREHAMAN,GEN,AJMER,186592,3,INC,220,M,RAJASTHAN,529549,528395,1154,1203803,616207,587596,15.518485998124278,186812,35.277566381958984
43,PARAS CHATAR JAIN,GEN,AJMER,11210,1,BSP,14,M,RAJASTHAN,529549,528395,1154,1203803,616207,587596,0.9323784705637053,11224,2.119539457160716
53,REKHRAJ FOUJI,GEN,AJMER,6318,7,IND,7,M,RAJASTHAN,529549,528395,1154,1203803,616207,587596,0.5254181955020879,6325,1.1944126039327807
40,K P SINGH,GEN,AJMER,5429,4,SP,2,M,RAJASTHAN,529549,528395,1154,1203803,616207,587596,0.4511535525330972,5431,1.0255896999144556
61,RAM PAL KOLI,SC,AJMER,2610,6,IND,0,M,RAJASTHAN,529549,528395,1154,1203803,616207,587596,0.2168128838356442,2610,0.4928722365635663
49,SWAMI KRISHNANAND MAHARAJ,GEN,AJMER,2358,5,IND,1,M,RAJASTHAN,529549,528395,1154,1203803,616207,587596,0.1959622961564309,2359,0.4454734122810165
70,KAILASH MEGHWAL,SC,TONK (SC),314949,1,BJP,768,M,RAJASTHAN,594358,593288,1070,1278411,658013,620398,24.696048453900975,315717,53.118995622167105
61,NAND KISHORE BAIRWA,SC,TONK (SC),256920,2,INC,285,M,RAJASTHAN,594358,593288,1070,1278411,658013,620398,20.119116622119176,257205,43.27442383210119
30,RAM BABU RAIGER,SC,TONK (SC),21419,3,BSP,17,M,RAJASTHAN,594358,593288,1070,1278411,658013,620398,1.6767690515804383,21436,3.606580545731697
71,RAGHUVEER SINGH KOSHAL,GEN,KOTA,297334,2,BJP,980,M,RAJASTHAN,580105,578649,1456,1327073,692170,634903,22.479094970660995,298314,51.424138733505146
65,HARI MOHAN SHARMA,GEN,KOTA,226103,3,INC,433,M,RAJASTHAN,580105,578649,1456,1327073,692170,634903,17.070349558765795,226536,39.050861481973094
41,KUNDAN CHEETA,ST,KOTA,18220,4,SP,17,M,RAJASTHAN,580105,578649,1456,1327073,692170,634903,1.3742273409224661,18237,3.1437412192620298
57,MOTI LAL MEENA,ST,KOTA,15131,1,BSP,25,M,RAJASTHAN,580105,578649,1456,1327073,692170,634903,1.1420622678631847,15156,2.6126304720697116
67,SAMUDRA SINGH HADA,GEN,KOTA,10308,8,IND,0,M,RAJASTHAN,580105,578649,1456,1327073,692170,634903,0.7767470214524748,10308,1.7769196955723532
34,BADAM BERWA,SC,KOTA,4702,7,IND,1,F,RAJASTHAN,580105,578649,1456,1327073,692170,634903,0.35438894469256776,4703,0.8107153015402385
64,DAULAT KUNWAR SHARMA ALIAS DAULAT,GEN,KOTA,4050,6,IND,0,F,RAJASTHAN,580105,578649,1456,1327073,692170,634903,0.30518291005845194,4050,0.6981494729402435
50,BHARAT SINGH,GEN,KOTA,2801,5,ABRAHP,0,M,RAJASTHAN,580105,578649,1456,1327073,692170,634903,0.2110660076725244,2801,0.4828436231371907
33,DUSHYANT SINGH,GEN,JHALAWAR,302972,1,BJP,873,M,RAJASTHAN,567611,566497,1114,1188576,614634,573942,25.563783889292736,303845,53.53049888039521
38,SANJAY GURJAR,GEN,JHALAWAR,222029,3,INC,237,M,RAJASTHAN,567611,566497,1114,1188576,614634,573942,18.700192499259618,222266,39.15815584969283
27,JAKIR HUSEN,GEN,JHALAWAR,25163,4,IND,1,M,RAJASTHAN,567611,566497,1114,1188576,614634,573942,2.11715531863339,25164,4.433317888483486
31,RATAN LAL,ST,JHALAWAR,16333,2,BSP,3,M,RAJASTHAN,567611,566497,1114,1188576,614634,573942,1.374417790700805,16336,2.8780273814284785
37,DHAN SINGH RAWAT,ST,BANSWARA (ST),268481,1,BJP,758,M,RAJASTHAN,666098,665138,960,1373808,692092,681716,19.598007873007,269239,40.420328540244824
67,PRABHULAL RAWAT,ST,BANSWARA (ST),247377,2,INC,179,M,RAJASTHAN,666098,665138,960,1373808,692092,681716,18.019694163958867,247556,37.16510183186258
44,JEETMAL KHANT,ST,BANSWARA (ST),78540,4,JD(U),16,M,RAJASTHAN,666098,665138,960,1373808,692092,681716,5.7181207272049654,78556,11.793459821227508
43,SURYALAL KHANT,ST,BANSWARA (ST),31132,7,IND,0,M,RAJASTHAN,666098,665138,960,1373808,692092,681716,2.2661099658758723,31132,4.673786740089296
55,SUNDER LAL PARMAR,ST,BANSWARA (ST),17836,3,BSP,5,M,RAJASTHAN,666098,665138,960,1373808,692092,681716,1.2986530868942385,17841,2.678434704803197
61,NANURAM KHANT,ST,BANSWARA (ST),11084,6,IND,0,M,RAJASTHAN,666098,665138,960,1373808,692092,681716,0.8068085205501788,11084,1.6640194085554976
56,BAHADUR SINGH,ST,BANSWARA (ST),10688,5,SP,2,M,RAJASTHAN,666098,665138,960,1373808,692092,681716,0.7781291126562081,10690,1.604868953217094
52,MAHAVEER BHAGORA,ST,SALUMBER (ST),280787,3,BJP,872,M,RAJASTHAN,629834,628768,1066,1279337,649803,629534,22.016012981724128,281659,44.71956102719129
70,BHERULAL MEENA,ST,SALUMBER (ST),256694,2,INC,191,M,RAJASTHAN,629834,628768,1066,1279337,649803,629534,20.079541199855864,256885,40.78614365054919
65,MEGHRAJ TAWAR,ST,SALUMBER (ST),32233,4,CPI,0,M,RAJASTHAN,629834,628768,1066,1279337,649803,629534,2.519508151487841,32233,5.117697679070994
62,KIKA BHAI MEENA,ST,SALUMBER (ST),25351,1,NCP,0,M,RAJASTHAN,629834,628768,1066,1279337,649803,629534,1.9815732680286742,25351,4.025028817116891
36,PURANMAL,ST,SALUMBER (ST),22028,6,CPI(ML)(L),1,M,RAJASTHAN,629834,628768,1066,1279337,649803,629534,1.7219075192853799,22029,3.497588253412804
30,HARI OM MEENA,ST,SALUMBER (ST),11675,5,BSP,2,M,RAJASTHAN,629834,628768,1066,1279337,649803,629534,0.9127383949655173,11677,1.8539805726588274
43,KIRAN MAHESHWARI,GEN,UDAIPUR,396878,1,BJP,1181,F,RAJASTHAN,759698,758166,1532,1363337,692098,671239,29.197403136568585,398059,52.39700512572101
57,GIRIJA VYAS,GEN,UDAIPUR,322836,2,INC,348,F,RAJASTHAN,759698,758166,1532,1363337,692098,671239,23.705364117602617,323184,42.541115022021906
38,SUNITA SINGH GUJAR,GEN,UDAIPUR,15887,3,BSP,3,F,RAJASTHAN,759698,758166,1532,1363337,692098,671239,1.1655225377144462,15890,2.0916206176664938
67,SUKHDEO MENARIA,GEN,UDAIPUR,15582,5,IND,0,M,RAJASTHAN,759698,758166,1532,1363337,692098,671239,1.1429309114327566,15582,2.0510781915971874
49,LAHARI LAL BAIRWA (LEHARU),SC,UDAIPUR,6983,4,ABCD(A),0,M,RAJASTHAN,759698,758166,1532,1363337,692098,671239,0.5121991114449326,6983,0.9191810429934
46,SHRICHAND KRIPLANI,GEN,CHITTORGARH,374135,3,BJP,1250,M,RAJASTHAN,672477,670995,1482,1385950,709904,676046,27.08503192755871,375385,55.82123998292878
44,VISHWA VIJAY SINGH,GEN,CHITTORGARH,239395,2,INC,220,M,RAJASTHAN,672477,670995,1482,1385950,709904,676046,17.288863234604424,239615,35.631701902072486
46,RADHA DEVI,GEN,CHITTORGARH,32109,1,CPI,5,F,RAJASTHAN,672477,670995,1482,1385950,709904,676046,2.3171110068905807,32114,4.775479310073058
63,S S STONE,SC,CHITTORGARH,12792,4,BSP,6,M,RAJASTHAN,672477,670995,1482,1385950,709904,676046,0.9234099354233558,12798,1.9031134150312947
34,CHAND MAL MEGHWAL,SC,CHITTORGARH,12564,5,ABCD(A),1,M,RAJASTHAN,672477,670995,1482,1385950,709904,676046,0.9065983621342761,12565,1.8684653898943755
55,VIJAYENDRAPAL SINGH,GEN,BHILWARA,316212,3,BJP,1080,M,RAJASTHAN,619696,618293,1403,1233703,628228,605475,25.71866972845166,317292,51.20123415352044
52,KAILASH VYAS,GEN,BHILWARA,256322,1,INC,318,M,RAJASTHAN,619696,618293,1403,1233703,628228,605475,20.802413546858524,256640,41.4138545351269
30,MUBARIQ,GEN,BHILWARA,24895,4,IND,1,M,RAJASTHAN,619696,618293,1403,1233703,628228,605475,2.0179897430743052,24896,4.017453719242984
45,RAMGOPAL JONWAL,SC,BHILWARA,20864,2,BSP,4,M,RAJASTHAN,619696,618293,1403,1233703,628228,605475,1.6914930092574956,20868,3.3674575921096794
48,PUSP JAIN,GEN,PALI,263251,1,BJP,863,M,RAJASTHAN,542738,541391,1347,1195737,611530,584207,22.08796750455995,264114,48.663259252162185
45,SURENDRA KUMAR SURANA,GEN,PALI,200494,3,INC,382,M,RAJASTHAN,542738,541391,1347,1195737,611530,584207,16.7993463445557,200876,37.011596755709014
61,MADHAV SINGH DIWAN,GEN,PALI,38581,6,IND,83,M,RAJASTHAN,542738,541391,1347,1195737,611530,584207,3.233486962434047,38664,7.123879293508102
35,HEERA RAM,SC,PALI,10784,9,IND,0,M,RAJASTHAN,542738,541391,1347,1195737,611530,584207,0.9018705618375947,10784,1.986962401748173
65,MITHALAL JAIN,GEN,PALI,10438,2,NCP,13,M,RAJASTHAN,542738,541391,1347,1195737,611530,584207,0.8740216285019198,10451,1.9256068305517577
49,SOHAN SINGH SANKHALA,GEN,PALI,6363,4,BSP,5,M,RAJASTHAN,542738,541391,1347,1195737,611530,584207,0.5325585810257607,6368,1.1733101422785948
61,MOOLA RAM,GEN,PALI,5969,7,IND,0,M,RAJASTHAN,542738,541391,1347,1195737,611530,584207,0.49919003928121314,5969,1.0997940074216288
40,LAHARA RAM SARGARA,SC,PALI,2900,8,IND,1,M,RAJASTHAN,542738,541391,1347,1195737,611530,584207,0.24261187869907846,2901,0.5345120481705722
43,BARKAT ALI,GEN,PALI,2611,5,IND,0,M,RAJASTHAN,542738,541391,1347,1195737,611530,584207,0.21835905387221438,2611,0.4810792684499703
52,B SUSHEELA,SC,JALORE (SC),320679,3,BJP,576,F,RAJASTHAN,655868,654757,1111,1428584,745665,682919,22.487652108661443,321255,48.98165484518226
69,BUTA SINGH,SC,JALORE (SC),281535,2,INC,528,M,RAJASTHAN,655868,654757,1111,1428584,745665,682919,19.74423625072099,282063,43.006062195441764
39,JASA RAM,SC,JALORE (SC),28060,4,IND,1,M,RAJASTHAN,655868,654757,1111,1428584,745665,682919,1.9642527145761117,28061,4.27845237151378
59,DINESH KATIWAL,SC,JALORE (SC),24483,1,BSP,6,M,RAJASTHAN,655868,654757,1111,1428584,745665,682919,1.7142149149087489,24489,3.733830587862192
40,MANVENDRA SINGH,GEN,BARMER,630671,1,BJP,1180,M,RAJASTHAN,1048698,1046864,1834,1639188,876048,763140,38.54658526050703,631851,60.250996950504344
59,COL SONA RAM CHOUDHARY,GEN,BARMER,359329,3,INC,634,M,RAJASTHAN,1048698,1046864,1834,1639188,876048,763140,21.95983621158769,359963,34.324753170121426
31,ARJUN RAM,GEN,BARMER,20495,5,IND,0,M,RAJASTHAN,1048698,1046864,1834,1639188,876048,763140,1.2503141799476325,20495,1.9543281287844545
40,SHARVAN KUMAR,SC,BARMER,19616,2,BSP,20,M,RAJASTHAN,1048698,1046864,1834,1639188,876048,763140,1.1979101847988152,19636,1.8724170352189096
51,HASTIMAL DOSHI,GEN,BARMER,16753,4,INLD,0,M,RAJASTHAN,1048698,1046864,1834,1639188,876048,763140,1.0220304199396286,16753,1.5975047153708695
45,JASWANT SINGH BISHNOI,GEN,JODHPUR,433429,1,BJP,923,M,RAJASTHAN,864927,863581,1346,1572050,823789,748261,27.629655545307084,434352,50.218342125982886
51,BADRI RAM JAKHAR,GEN,JODHPUR,391453,2,INC,404,M,RAJASTHAN,864927,863581,1346,1572050,823789,748261,24.92649724881524,391857,45.3052107287667
46,SABIR GOURI,GEN,JODHPUR,10362,12,IND,1,M,RAJASTHAN,864927,863581,1346,1572050,823789,748261,0.6592029515600649,10363,1.1981357964313752
36,RAVI GARG,GEN,JODHPUR,8973,3,JP,1,M,RAJASTHAN,864927,863581,1346,1572050,823789,748261,0.5708469832384466,8974,1.0375442089332394
48,SHAITAN SINGH CHOUHAN,GEN,JODHPUR,4681,11,IND,1,M,RAJASTHAN,864927,863581,1346,1572050,823789,748261,0.2978276772367291,4682,0.5413173597309368
64,DEVILAL BHEEL,ST,JODHPUR,3824,5,IND,3,M,RAJASTHAN,864927,863581,1346,1572050,823789,748261,0.24344009414458828,3827,0.442465086648931
47,MAHMUDA BEGUM ABBASI,GEN,JODHPUR,3118,8,IND,0,F,RAJASTHAN,864927,863581,1346,1572050,823789,748261,0.19833974746350305,3118,0.3604928508417473
56,VIJAY KRISHAN SHARMA,GEN,JODHPUR,2683,10,IND,1,M,RAJASTHAN,864927,863581,1346,1572050,823789,748261,0.1707324830635158,2684,0.3103152057919339
26,DUNGARLAL MEGHWAL,SC,JODHPUR,1658,4,IND,0,M,RAJASTHAN,864927,863581,1346,1572050,823789,748261,0.1054673833529468,1658,0.19169247809352696
45,LEELA DEVI,ST,JODHPUR,1591,9,IND,1,F,RAJASTHAN,864927,863581,1346,1572050,823789,748261,0.10126904360548328,1592,0.1840617763117581
47,BADRI RAM,SC,JODHPUR,960,7,IND,10,M,RAJASTHAN,864927,863581,1346,1572050,823789,748261,0.06170287204605451,970,0.1121481928532697
36,PUKHRAJ MEGHWAL,SC,JODHPUR,849,6,IND,1,M,RAJASTHAN,864927,863581,1346,1572050,823789,748261,0.05406952705066633,850,0.09827418961368993
74,BHANWAR SINGH DANGAWAS,GEN,NAGAUR,283936,1,BJP,721,M,RAJASTHAN,631471,630119,1352,1436070,743607,692463,19.821944612727794,284657,45.07839631590366
70,RAMRAGHUNATH,GEN,NAGAUR,213714,3,INC,316,M,RAJASTHAN,631471,630119,1352,1436070,743607,692463,14.903869588529808,214030,33.89387636170149
62,MOOL CHAND,SC,NAGAUR,107453,2,BSP,304,M,RAJASTHAN,631471,630119,1352,1436070,743607,692463,7.503603584783472,107757,17.064441597476367
49,BHANWAR SINGH RATHORE,GEN,NAGAUR,9884,7,IND,4,M,RAJASTHAN,631471,630119,1352,1436070,743607,692463,0.6885458229752032,9888,1.5658676328762524
28,NAWAB KHAN,GEN,NAGAUR,7675,4,NLP,2,M,RAJASTHAN,631471,630119,1352,1436070,743607,692463,0.5345839687480415,7677,1.2157327889958527
34,KAILASH,GEN,NAGAUR,3839,5,IND,3,M,RAJASTHAN,631471,630119,1352,1436070,743607,692463,0.267535705084014,3842,0.6084206558971038
49,BHANU PRAKASH,GEN,NAGAUR,3618,6,IND,2,M,RAJASTHAN,631471,630119,1352,1436070,743607,692463,0.2520768486215853,3620,0.5732646471492753
44,NAKUL DAS RAI,GEN,SIKKIM,150333,2,SDF,3076,M,SIKKIM,219648,215294,4354,281937,145738,136199,54.412510596338905,153409,69.84311261655012
42,BIRAJ ADHIKARI,GEN,SIKKIM,59029,1,INC,1229,M,SIKKIM,219648,215294,4354,281937,145738,136199,21.37285989423169,60258,27.43389423076923
40,RAJENDRA PD UPRETY,GEN,SIKKIM,3192,3,SSP,24,M,SIKKIM,219648,215294,4354,281937,145738,136199,1.1406803647623405,3216,1.4641608391608392
30,TARA KUMAR PRADHAN,GEN,SIKKIM,2740,4,SHRP,25,M,SIKKIM,219648,215294,4354,281937,145738,136199,0.9807155499278207,2765,1.2588323135198136
77,KUPPUSAMI C,GEN,MADRAS NORTH,570043,2,DMK,79,M,TAMIL NADU,915865,915778,87,2000866,1015695,985171,28.493762200966984,570122,62.24956734889967
56,SUKUMAR NAMBIAR M N,GEN,MADRAS NORTH,316575,3,BJP,8,M,TAMIL NADU,915865,915778,87,2000866,1015695,985171,15.822298944557007,316583,34.56655729829178
66,GUNASEKARAN MUTHU,GEN,MADRAS NORTH,4512,4,JD(U),0,M,TAMIL NADU,915865,915778,87,2000866,1015695,985171,0.2255023574792115,4512,0.4926490257843678
51,UMAKANTHAN R,SC,MADRAS NORTH,3820,1,BSP,0,M,TAMIL NADU,915865,915778,87,2000866,1015695,985171,0.1909173327948998,3820,0.41709203867382205
36,MANIVANNAN C,GEN,MADRAS NORTH,2375,18,IND,0,M,TAMIL NADU,915865,915778,87,2000866,1015695,985171,0.11869860350468248,2375,0.25931769420165635
48,KUMARASAMY S,GEN,MADRAS NORTH,2071,5,CPI(ML)(L),0,M,TAMIL NADU,915865,915778,87,2000866,1015695,985171,0.10350518225608313,2071,0.22612502934384435
32,PARIMALAM V,GEN,MADRAS NORTH,1898,16,IND,0,M,TAMIL NADU,915865,915778,87,2000866,1015695,985171,0.0948589260850052,1898,0.2072357825662079
63,SETHURAMAN R D,GEN,MADRAS NORTH,1671,7,JP,0,M,TAMIL NADU,915865,915778,87,2000866,1015695,985171,0.08351383850792607,1671,0.18245047032040748
39,MATHI T,GEN,MADRAS NORTH,1602,19,IND,0,M,TAMIL NADU,915865,915778,87,2000866,1015695,985171,0.08006533171136898,1602,0.17491660888886462
64,JAINALUFTHIN J,GEN,MADRAS NORTH,1494,25,IND,0,M,TAMIL NADU,915865,915778,87,2000866,1015695,985171,0.07466766889936657,1494,0.16312447795253668
41,SREENIVASULU V,GEN,MADRAS NORTH,1424,6,SP,0,M,TAMIL NADU,915865,915778,87,2000866,1015695,985171,0.07116918374343909,1424,0.1554814301234352
45,KUPPUSAMY V,GEN,MADRAS NORTH,1230,10,IND,0,M,TAMIL NADU,915865,915778,87,2000866,1015695,985171,0.06147338202558292,1230,0.13429926899706834
37,NOWSHATH ALI M K,GEN,MADRAS NORTH,1039,15,IND,0,M,TAMIL NADU,915865,915778,87,2000866,1015695,985171,0.05192751538583793,1039,0.11344466706337723
34,BALAMURUGAN B,GEN,MADRAS NORTH,963,17,IND,0,M,TAMIL NADU,915865,915778,87,2000866,1015695,985171,0.048129160073688095,963,0.10514650084892424
44,DAVESON T R,GEN,MADRAS NORTH,706,14,IND,0,M,TAMIL NADU,915865,915778,87,2000866,1015695,985171,0.03528472171549719,706,0.07708559667636605
37,VALSALA TMT,GEN,MADRAS NORTH,562,8,RLD,0,F,TAMIL NADU,915865,915778,87,2000866,1015695,985171,0.028087837966160656,562,0.06136275542792879
26,RAJASEKAR R,GEN,MADRAS NORTH,530,22,IND,0,M,TAMIL NADU,915865,915778,87,2000866,1015695,985171,0.026488530466308086,530,0.05786879070605384
31,ELANGOVAN R,GEN,MADRAS NORTH,494,9,IND,0,M,TAMIL NADU,915865,915778,87,2000866,1015695,985171,0.024689309528973958,494,0.053938080393944515
48,MARIMUTHU P,GEN,MADRAS NORTH,493,20,IND,0,M,TAMIL NADU,915865,915778,87,2000866,1015695,985171,0.02463933116960356,493,0.05382889399638593
36,JAGANATHAN R,GEN,MADRAS NORTH,424,24,IND,0,M,TAMIL NADU,915865,915778,87,2000866,1015695,985171,0.02119082437304647,424,0.04629503256484307
33,SENDHILKUMAR R,GEN,MADRAS NORTH,415,11,IND,0,M,TAMIL NADU,915865,915778,87,2000866,1015695,985171,0.020741019138712936,415,0.04531235498681574
46,DEVADOSS M,GEN,MADRAS NORTH,409,13,IND,0,M,TAMIL NADU,915865,915778,87,2000866,1015695,985171,0.02044114898249058,409,0.04465723660146419
43,THIRUMOORTHY P I,GEN,MADRAS NORTH,370,12,IND,0,M,TAMIL NADU,915865,915778,87,2000866,1015695,985171,0.01849199296704527,370,0.040398967096679096
36,JANAKIRAMAN C,GEN,MADRAS NORTH,360,23,IND,0,M,TAMIL NADU,915865,915778,87,2000866,1015695,985171,0.017992209373341343,360,0.03930710312109317
34,MURUGAN S,GEN,MADRAS NORTH,298,21,IND,0,M,TAMIL NADU,915865,915778,87,2000866,1015695,985171,0.014893551092377,298,0.03253754647246046
37,DAYANIDHI MARAN,GEN,MADRAS CENTRAL,316295,2,DMK,34,M,TAMIL NADU,512820,512784,36,1045260,523077,522183,30.26318810630848,316329,61.684216684216686
53,BALAGANGA N,GEN,MADRAS CENTRAL,182149,3,ADMK,2,M,TAMIL NADU,512820,512784,36,1045260,523077,522183,17.426381952815568,182151,35.51948051948052
40,VENKATESAN G,GEN,MADRAS CENTRAL,2896,4,JP,0,M,TAMIL NADU,512820,512784,36,1045260,523077,522183,0.2770602529514188,2896,0.5647205647205648
64,SAGUL HAMEEDHU,GEN,MADRAS CENTRAL,2164,1,BSP,0,M,TAMIL NADU,512820,512784,36,1045260,523077,522183,0.20702982989878113,2164,0.42198042198042196
43,"MOHAMED ANSARE, P",GEN,MADRAS CENTRAL,1433,18,IND,0,M,TAMIL NADU,512820,512784,36,1045260,523077,522183,0.1370950768229914,1433,0.27943527943527946
26,BHEEMA RAO B R,SC,MADRAS CENTRAL,1101,16,IND,0,M,TAMIL NADU,512820,512784,36,1045260,523077,522183,0.10533264450950001,1101,0.2146952146952147
48,FAROUK MOHAMED M S,GEN,MADRAS CENTRAL,858,15,IND,0,M,TAMIL NADU,512820,512784,36,1045260,523077,522183,0.08208484013546868,858,0.16731016731016732
27,"MOHAMMED ALI JINNA, J",GEN,MADRAS CENTRAL,772,19,IND,0,M,TAMIL NADU,512820,512784,36,1045260,523077,522183,0.07385722212655224,772,0.15054015054015052
32,ARUNTHATHI JAIGANESH(ALIAS) JAIGANESH,GEN,MADRAS CENTRAL,537,23,IND,0,M,TAMIL NADU,512820,512784,36,1045260,523077,522183,0.05137477756730383,537,0.10471510471510473
48,"MEENAKSHISUNDARAM, S P",GEN,MADRAS CENTRAL,501,17,IND,0,M,TAMIL NADU,512820,512784,36,1045260,523077,522183,0.04793065840078067,501,0.0976950976950977
55,"KUMARESH, N",GEN,MADRAS CENTRAL,442,9,IND,0,M,TAMIL NADU,512820,512784,36,1045260,523077,522183,0.042286129766756594,442,0.08619008619008618
40,KALAIAZHAGAN A,GEN,MADRAS CENTRAL,413,6,IND,0,M,TAMIL NADU,512820,512784,36,1045260,523077,522183,0.0395117004381685,413,0.08053508053508054
34,RAVICHANDRAN K S,SC,MADRAS CENTRAL,387,5,IND,0,M,TAMIL NADU,512820,512784,36,1045260,523077,522183,0.03702428104012399,387,0.07546507546507547
45,"KUMAR, K",GEN,MADRAS CENTRAL,384,10,IND,0,M,TAMIL NADU,512820,512784,36,1045260,523077,522183,0.03673727110958039,384,0.07488007488007488
42,"DURAIRAJ, J",GEN,MADRAS CENTRAL,342,14,IND,0,M,TAMIL NADU,512820,512784,36,1045260,523077,522183,0.03271913208197003,342,0.06669006669006669
46,"GOPINATH, D",GEN,MADRAS CENTRAL,326,11,IND,0,M,TAMIL NADU,512820,512784,36,1045260,523077,522183,0.031188412452404186,326,0.06357006357006356
33,"DALITKUDIMAHAN, T D K (ALIAS) DAYA",SC,MADRAS CENTRAL,293,8,IND,0,M,TAMIL NADU,512820,512784,36,1045260,523077,522183,0.028031303216424622,293,0.057135057135057135
46,"VASANTHA, ( TMT ) L",GEN,MADRAS CENTRAL,289,21,IND,0,F,TAMIL NADU,512820,512784,36,1045260,523077,522183,0.027648623309033157,289,0.05635505635505635
44,SUDHARSAN M S,SC,MADRAS CENTRAL,281,13,IND,0,M,TAMIL NADU,512820,512784,36,1045260,523077,522183,0.026883263494250232,281,0.054795054795054796
42,"KIRUBANANDAM, S N",GEN,MADRAS CENTRAL,269,7,IND,0,M,TAMIL NADU,512820,512784,36,1045260,523077,522183,0.025735223772075846,269,0.052455052455052456
51,"RAVIKUMAR, K G",GEN,MADRAS CENTRAL,227,20,IND,0,M,TAMIL NADU,512820,512784,36,1045260,523077,522183,0.02171708474446549,227,0.04426504426504427
42,"VIJAYASEKAR, D",GEN,MADRAS CENTRAL,224,22,IND,0,M,TAMIL NADU,512820,512784,36,1045260,523077,522183,0.021430074813921896,224,0.04368004368004368
44,"GOVINDARAJAN, A",GEN,MADRAS CENTRAL,201,12,IND,0,M,TAMIL NADU,512820,512784,36,1045260,523077,522183,0.019229665346420986,201,0.039195039195039194
62,"BAALU, T R",GEN,MADRAS SOUTH,564420,2,DMK,158,M,TAMIL NADU,934548,934370,178,1949904,977555,972349,28.954143383469134,564578,60.41187825558452
57,BADER SAYEED ( TMT),GEN,MADRAS SOUTH,343820,1,ADMK,18,F,TAMIL NADU,934548,934370,178,1949904,977555,972349,17.633586063724163,343838,36.79190367963978
42,VASUDEVAN,GEN,MADRAS SOUTH,4006,3,BSP,0,M,TAMIL NADU,934548,934370,178,1949904,977555,972349,0.20544601170108887,4006,0.4286564200019689
39,BABU T,SC,MADRAS SOUTH,2371,18,IND,0,M,TAMIL NADU,934548,934370,178,1949904,977555,972349,0.12159572984105885,2371,0.25370553465418577
40,THIYAGARAJAN P,SC,MADRAS SOUTH,2203,16,IND,0,M,TAMIL NADU,934548,934370,178,1949904,977555,972349,0.11297992106278053,2203,0.23572892992120256
31,"NAVAMANI, T",GEN,MADRAS SOUTH,2193,4,JP,1,M,TAMIL NADU,934548,934370,178,1949904,977555,972349,0.1125183598782299,2194,0.23476589752479274
49,DEVADOSS KUPPAL G,GEN,MADRAS SOUTH,1782,17,IND,0,M,TAMIL NADU,934548,934370,178,1949904,977555,972349,0.09138911454102357,1782,0.1906804144891434
36,RAJENDRAN A,SC,MADRAS SOUTH,1233,32,IND,0,M,TAMIL NADU,934548,934370,178,1949904,977555,972349,0.06323388228343549,1233,0.1319354383081447
36,SALVAM S,SC,MADRAS SOUTH,771,15,IND,0,M,TAMIL NADU,934548,934370,178,1949904,977555,972349,0.03954040814317013,771,0.08249977529244085
52,"MOHAN RAJ, J",GEN,MADRAS SOUTH,734,5,JJ,0,M,TAMIL NADU,934548,934370,178,1949904,977555,972349,0.03764287882890645,734,0.07854064210720048
67,RAJAN P,SC,MADRAS SOUTH,635,31,IND,0,M,TAMIL NADU,934548,934370,178,1949904,977555,972349,0.032565705798849584,635,0.06794728574669252
54,"VIVEKANANDA, S",GEN,MADRAS SOUTH,612,33,IND,0,M,TAMIL NADU,934548,934370,178,1949904,977555,972349,0.03138616054944243,612,0.06548620295586743
56,"SURYANARAYANAN, R",GEN,MADRAS SOUTH,583,14,IND,0,M,TAMIL NADU,934548,934370,178,1949904,977555,972349,0.0298989078436682,583,0.06238309856743581
37,MAZHAI MENI PANDIYAN S,SC,MADRAS SOUTH,570,25,IND,0,M,TAMIL NADU,934548,934370,178,1949904,977555,972349,0.029232208354872856,570,0.06099205177262163
31,ANAND S,SC,MADRAS SOUTH,565,6,IND,0,M,TAMIL NADU,934548,934370,178,1949904,977555,972349,0.028975785474566952,565,0.06045703377461618
29,BASKARAN S,SC,MADRAS SOUTH,554,19,IND,1,M,TAMIL NADU,934548,934370,178,1949904,977555,972349,0.02846293971395515,555,0.059386997778605274
44,PURUSHOTHAMAN S,GEN,MADRAS SOUTH,553,23,IND,0,M,TAMIL NADU,934548,934370,178,1949904,977555,972349,0.028360370561832788,553,0.05917299057940308
47,RAJALAXMI ( TMT) P,GEN,MADRAS SOUTH,484,30,IND,0,F,TAMIL NADU,934548,934370,178,1949904,977555,972349,0.024821734813611336,484,0.05178974220692784
31,JAYARAJ S,SC,MADRAS SOUTH,445,35,IND,0,M,TAMIL NADU,934548,934370,178,1949904,977555,972349,0.0228216363472253,445,0.04761660182248531
35,"PUGAZHENTHI, G",SC,MADRAS SOUTH,440,22,IND,0,M,TAMIL NADU,934548,934370,178,1949904,977555,972349,0.022565213466919396,440,0.047081583824479856
67,"SRINIVASAN, V R ALIAS LOVE SRINI",GEN,MADRAS SOUTH,431,13,IND,0,M,TAMIL NADU,934548,934370,178,1949904,977555,972349,0.022103652282368772,431,0.04611855142807004
29,"PRAKASH, P",SC,MADRAS SOUTH,419,20,IND,0,M,TAMIL NADU,934548,934370,178,1949904,977555,972349,0.021488237369634608,419,0.04483450823285695
28,GOPI M,SC,MADRAS SOUTH,417,8,IND,0,M,TAMIL NADU,934548,934370,178,1949904,977555,972349,0.021385668217512248,417,0.04462050103365477
39,MOHD FAROOK,GEN,MADRAS SOUTH,397,26,IND,0,M,TAMIL NADU,934548,934370,178,1949904,977555,972349,0.020359976696288636,397,0.04248042904163296
49,JANAKIRAMAN A,SC,MADRAS SOUTH,395,34,IND,0,M,TAMIL NADU,934548,934370,178,1949904,977555,972349,0.02025740754416628,395,0.042266421842430776
55,SHANMUGAM G,SC,MADRAS SOUTH,388,9,IND,0,M,TAMIL NADU,934548,934370,178,1949904,977555,972349,0.019898415511738012,388,0.041517396645223144
44,"SHANMUGAM, P T (ALIAS) SHANMUGA",GEN,MADRAS SOUTH,374,10,IND,0,M,TAMIL NADU,934548,934370,178,1949904,977555,972349,0.019180431446881488,374,0.04001934625080788
46,KUMAR D S,SC,MADRAS SOUTH,370,7,IND,0,M,TAMIL NADU,934548,934370,178,1949904,977555,972349,0.018975293142636764,370,0.03959133185240351
37,PRASAD V B D,GEN,MADRAS SOUTH,362,21,IND,0,M,TAMIL NADU,934548,934370,178,1949904,977555,972349,0.01856501653414732,362,0.03873530305559479
38,MURUGAN V G,SC,MADRAS SOUTH,354,27,IND,0,M,TAMIL NADU,934548,934370,178,1949904,977555,972349,0.01815473992565788,354,0.037879274258786066
37,BOMMI ( TMT) R,GEN,MADRAS SOUTH,337,24,IND,0,F,TAMIL NADU,934548,934370,178,1949904,977555,972349,0.01728290213261781,337,0.036060213065567524
30,SIVAKUMAR PON,SC,MADRAS SOUTH,307,11,IND,0,M,TAMIL NADU,934548,934370,178,1949904,977555,972349,0.015744364850782396,307,0.03285010507753481
31,"CHINNATAMBI, K",SC,MADRAS SOUTH,298,12,IND,0,M,TAMIL NADU,934548,934370,178,1949904,977555,972349,0.015282803666231776,298,0.03188707268112499
34,"MURUGAN, D",SC,MADRAS SOUTH,295,28,IND,0,M,TAMIL NADU,934548,934370,178,1949904,977555,972349,0.015128949938048232,295,0.03156606188232172
41,RAJADURAI M,GEN,MADRAS SOUTH,252,29,IND,0,M,TAMIL NADU,934548,934370,178,1949904,977555,972349,0.012923713167417472,252,0.026964907099474827
38,KRISHNASWAMY A,SC,SRIPERUMBUDUR (SC),516617,1,DMK,1000,M,TAMIL NADU,843101,842045,1056,1423561,696342,727219,36.36071794605219,517617,61.394423681148524
52,VENUGOPAL DR P,SC,SRIPERUMBUDUR (SC),282226,2,ADMK,45,M,TAMIL NADU,843101,842045,1056,1423561,696342,727219,19.82851454907798,282271,33.48009313237679
36,VIJAYARAGUNATHAN M,SC,SRIPERUMBUDUR (SC),11995,15,IND,0,M,TAMIL NADU,843101,842045,1056,1423561,696342,727219,0.8426052694615827,11995,1.422723967828291
42,BALAKRISHNAN K,SC,SRIPERUMBUDUR (SC),11514,12,IND,3,M,TAMIL NADU,843101,842045,1056,1423561,696342,727219,0.8090275021583198,11517,1.3660285066676472
35,SAMBATH S,SC,SRIPERUMBUDUR (SC),5807,4,JP,8,M,TAMIL NADU,843101,842045,1056,1423561,696342,727219,0.4084826712729557,5815,0.6897157042869122
39,RAVI M,SC,SRIPERUMBUDUR (SC),4194,14,IND,0,M,TAMIL NADU,843101,842045,1056,1423561,696342,727219,0.2946132972173303,4194,0.4974492972965279
52,JAYAKUMAR J K B E,SC,SRIPERUMBUDUR (SC),3805,3,BSP,0,M,TAMIL NADU,843101,842045,1056,1423561,696342,727219,0.26728745729898473,3805,0.451310104008891
34,PURUSHOTHAMAN B,SC,SRIPERUMBUDUR (SC),1129,13,IND,0,M,TAMIL NADU,843101,842045,1056,1423561,696342,727219,0.07930815750080256,1129,0.13391040931039105
47,SELVARAJ K,SC,SRIPERUMBUDUR (SC),759,9,IND,0,M,TAMIL NADU,843101,842045,1056,1423561,696342,727219,0.053316998709574084,759,0.090024801299014
47,EAGAMBARAM S,SC,SRIPERUMBUDUR (SC),721,5,IND,0,M,TAMIL NADU,843101,842045,1056,1423561,696342,727219,0.05064763645533982,721,0.08551763074649418
36,SIVAKUMAR S,SC,SRIPERUMBUDUR (SC),685,6,IND,0,M,TAMIL NADU,843101,842045,1056,1423561,696342,727219,0.0481187669513284,685,0.08124767969673859
31,PALANI E,SC,SRIPERUMBUDUR (SC),672,11,IND,0,M,TAMIL NADU,843101,842045,1056,1423561,696342,727219,0.04720556407487982,672,0.07970575292877129
29,DILLI C,SC,SRIPERUMBUDUR (SC),649,10,IND,0,M,TAMIL NADU,843101,842045,1056,1423561,696342,727219,0.04558989744731697,649,0.07697772864698299
30,SURESH M,SC,SRIPERUMBUDUR (SC),639,8,IND,0,M,TAMIL NADU,843101,842045,1056,1423561,696342,727219,0.04488743369620269,639,0.07579163113316198
34,SIVAKUMAR M G,SC,SRIPERUMBUDUR (SC),633,7,IND,0,M,TAMIL NADU,843101,842045,1056,1423561,696342,727219,0.04446595544553412,633,0.07507997262486937
39,"MOORTHY, A K",GEN,CHENGALPATTU,430087,2,PMK,1556,M,TAMIL NADU,759076,757406,1670,1167736,571050,596686,36.9640911986956,431643,56.86426655565451
48,RAMACHANDRAN K N,GEN,CHENGALPATTU,282826,3,ADMK,93,M,TAMIL NADU,759076,757406,1670,1167736,571050,596686,24.227993313557175,282919,37.271498506078444
42,KUMARESAN A,GEN,CHENGALPATTU,10941,4,JP,15,M,TAMIL NADU,759076,757406,1670,1167736,571050,596686,0.9382257633574711,10956,1.4433337373332842
49,NAHAMANI ( TMT) J,GEN,CHENGALPATTU,8654,1,BSP,5,F,TAMIL NADU,759076,757406,1670,1167736,571050,596686,0.7415203436393157,8659,1.140728991563427
36,SHAYEEN BANU ( TMT) S,GEN,CHENGALPATTU,6520,12,IND,0,F,TAMIL NADU,759076,757406,1670,1167736,571050,596686,0.5583453794350778,6520,0.8589390258682925
41,MOORTHY N,GEN,CHENGALPATTU,5427,11,IND,0,M,TAMIL NADU,759076,757406,1670,1167736,571050,596686,0.46474545616474955,5427,0.7149481738323962
36,SOWMIYA NARAYANAN S,GEN,CHENGALPATTU,4800,9,IND,0,M,TAMIL NADU,759076,757406,1670,1167736,571050,596686,0.4110518130810389,4800,0.6323477491054914
36,MANIVANNAN R S,GEN,CHENGALPATTU,3578,10,IND,0,M,TAMIL NADU,759076,757406,1670,1167736,571050,596686,0.30640487233415775,3578,0.4713625513123851
29,KRISHNAMOORTHY A,GEN,CHENGALPATTU,1791,5,IND,1,M,TAMIL NADU,759076,757406,1670,1167736,571050,596686,0.1534593435502545,1792,0.23607649299938346
33,SUBRAMANIYAM M,GEN,CHENGALPATTU,973,8,IND,0,M,TAMIL NADU,759076,757406,1670,1167736,571050,596686,0.08332362794330225,973,0.128182158308259
37,SHANKAR K,GEN,CHENGALPATTU,956,6,IND,0,M,TAMIL NADU,759076,757406,1670,1167736,571050,596686,0.08186781943864023,956,0.12594259336351038
37,CHANAKHYA BABU K,GEN,CHENGALPATTU,853,7,IND,0,M,TAMIL NADU,759076,757406,1670,1167736,571050,596686,0.07304733261627629,853,0.1123734645806217
63,"VELU, R",GEN,ARAKKONAM,385242,2,PMK,1669,M,TAMIL NADU,775439,773529,1910,1160259,567485,592774,33.346950982496146,386911,49.89573647959414
57,SHANMUGAM N,GEN,ARAKKONAM,284559,1,ADMK,156,M,TAMIL NADU,775439,773529,1910,1160259,567485,592774,24.538917603741922,284715,36.71662116555912
43,SETHUMADHAVAN S,GEN,ARAKKONAM,34854,5,JD(U),22,M,TAMIL NADU,775439,773529,1910,1160259,567485,592774,3.0058805835593607,34876,4.497581370036843
65,KULANDAIVELU M,GEN,ARAKKONAM,22237,4,JP,47,M,TAMIL NADU,775439,773529,1910,1160259,567485,592774,1.9206056578746644,22284,2.873727011409021
48,VENKATESAN V,GEN,ARAKKONAM,9645,16,IND,1,M,TAMIL NADU,775439,773529,1910,1160259,567485,592774,0.8313661001552239,9646,1.243940529171218
45,ARUNKUMAR S,SC,ARAKKONAM,5504,3,RPI(A),3,M,TAMIL NADU,775439,773529,1910,1160259,567485,592774,0.4746354046811962,5507,0.710178363481847
47,VELU M,GEN,ARAKKONAM,5022,17,IND,0,M,TAMIL NADU,775439,773529,1910,1160259,567485,592774,0.4328343930105261,5022,0.647633147159222
31,RAVI N,GEN,ARAKKONAM,4370,15,IND,1,M,TAMIL NADU,775439,773529,1910,1160259,567485,592774,0.376726230953606,4371,0.5636807021571006
33,SAMPATH G,GEN,ARAKKONAM,4331,12,IND,2,M,TAMIL NADU,775439,773529,1910,1160259,567485,592774,0.3734511001422958,4333,0.5587802522184208
31,VELU K,GEN,ARAKKONAM,4061,18,IND,0,M,TAMIL NADU,775439,773529,1910,1160259,567485,592774,0.3500080585455489,4061,0.5237033473941858
30,VELU G S,GEN,ARAKKONAM,2229,20,IND,0,M,TAMIL NADU,775439,773529,1910,1160259,567485,592774,0.19211227837922396,2229,0.28745007666624967
49,VELU S,GEN,ARAKKONAM,2169,19,IND,0,M,TAMIL NADU,775439,773529,1910,1160259,567485,592774,0.18694101920347095,2169,0.27971252413149195
38,SEKATHAM BASHA M,GEN,ARAKKONAM,1466,14,IND,0,M,TAMIL NADU,775439,773529,1910,1160259,567485,592774,0.12635109919423163,1466,0.18905420026591388
30,SEKAR A,SC,ARAKKONAM,1341,13,IND,1,M,TAMIL NADU,775439,773529,1910,1160259,567485,592774,0.11566383023100878,1342,0.1730632583607479
41,ASKAR A,GEN,ARAKKONAM,1273,8,IND,0,M,TAMIL NADU,775439,773529,1910,1160259,567485,592774,0.1097168821788928,1273,0.1641650729457765
45,MOHAN R,GEN,ARAKKONAM,1263,7,SP,2,M,TAMIL NADU,775439,773529,1910,1160259,567485,592774,0.10902738095545908,1265,0.16313339927447548
49,SHANMUGAM N,GEN,ARAKKONAM,1168,11,IND,3,M,TAMIL NADU,775439,773529,1910,1160259,567485,592774,0.10092574158011272,1171,0.1510112336366884
39,SHANMUGAM S,GEN,ARAKKONAM,1044,10,IND,0,M,TAMIL NADU,775439,773529,1910,1160259,567485,592774,0.0899799096581022,1044,0.13463341410478452
70,"MANIEZHILAN, PULAVAR A",SC,ARAKKONAM,1036,6,BBP,2,M,TAMIL NADU,775439,773529,1910,1160259,567485,592774,0.0894627837405269,1038,0.13385965885130874
41,ELANGOVAN M,GEN,ARAKKONAM,715,9,IND,1,M,TAMIL NADU,775439,773529,1910,1160259,567485,592774,0.06171035949731913,716,0.09233479358144225
63,"KADER MOHIDEEN, K M",GEN,VELLORE,435252,2,DMK,1390,M,TAMIL NADU,746914,745335,1579,1220454,595130,625324,35.7770141275296,436642,58.459474584758084
50,SANTHANAM A,GEN,VELLORE,257889,3,ADMK,143,M,TAMIL NADU,746914,745335,1579,1220454,595130,625324,21.14229622746945,258032,34.546413643337786
73,PARAMASIVAM A M S,GEN,VELLORE,11289,6,JP,20,M,TAMIL NADU,746914,745335,1579,1220454,595130,625324,0.9266223880621474,11309,1.514096669763855
38,KARUNANITHI E,SC,VELLORE,7515,1,BSP,9,M,TAMIL NADU,746914,745335,1579,1220454,595130,625324,0.616491895638836,7524,1.0073448884342777
48,VENKATESAN K,GEN,VELLORE,5590,18,IND,0,M,TAMIL NADU,746914,745335,1579,1220454,595130,625324,0.4580262754679816,5590,0.7484128025448713
36,BALACHANDRAN V,SC,VELLORE,4757,16,IND,0,M,TAMIL NADU,746914,745335,1579,1220454,595130,625324,0.38977298611828054,4757,0.6368872453856803
41,SHARIFF M K,GEN,VELLORE,4563,19,IND,0,M,TAMIL NADU,746914,745335,1579,1220454,595130,625324,0.3738772620680501,4563,0.6109137062633716
45,ARUN KUMAR S,SC,VELLORE,4141,4,RPI(A),6,M,TAMIL NADU,746914,745335,1579,1220454,595130,625324,0.3397915857541538,4147,0.5552178697949162
42,THANIKACHALAM D,GEN,VELLORE,3205,15,IND,0,M,TAMIL NADU,746914,745335,1579,1220454,595130,625324,0.26260719371643665,3205,0.4290989324072116
46,CHITTYBABU P C,GEN,VELLORE,2692,14,IND,1,M,TAMIL NADU,746914,745335,1579,1220454,595130,625324,0.22065559209933353,2693,0.3605502105998816
34,MUSHTHAQUE AHMED A M,GEN,VELLORE,1332,17,IND,0,M,TAMIL NADU,746914,745335,1579,1220454,595130,625324,0.10913971358199491,1332,0.1783337840768817
57,VATCHALABAI (SELVI) DR P K,GEN,VELLORE,1187,7,SP,1,F,TAMIL NADU,746914,745335,1579,1220454,595130,625324,0.09734082562718463,1188,0.15905445606857013
75,CHANDRAN T,GEN,VELLORE,1136,13,IND,2,M,TAMIL NADU,746914,745335,1579,1220454,595130,625324,0.09324398953176441,1138,0.1523602449545731
48,SATHIYAMOORTHY J,GEN,VELLORE,1120,5,BBP,4,M,TAMIL NADU,746914,745335,1579,1220454,595130,625324,0.09209687542504674,1124,0.1504858658426539
35,KHADER BASHA M Z,GEN,VELLORE,880,10,IND,1,M,TAMIL NADU,746914,745335,1579,1220454,595130,625324,0.07218625200130444,881,0.1179519998286282
60,KUPPURAO V P,SC,VELLORE,824,12,IND,1,M,TAMIL NADU,746914,745335,1579,1220454,595130,625324,0.06759779557443378,825,0.1104544833809515
26,KADHAR SHERIF M,GEN,VELLORE,697,11,IND,0,M,TAMIL NADU,746914,745335,1579,1220454,595130,625324,0.057109895170157986,697,0.09331730292911902
54,KANNIYAPPAN P,GEN,VELLORE,675,8,IND,1,M,TAMIL NADU,746914,745335,1579,1220454,595130,625324,0.05538922401008149,676,0.09050573426124026
35,KADER BASHA A,GEN,VELLORE,591,9,IND,0,M,TAMIL NADU,746914,745335,1579,1220454,595130,625324,0.048424602647867104,591,0.07912557536744526
68,"VENUGOPAL, D",GEN,TIRUPPATTUR,452176,3,DMK,1610,M,TAMIL NADU,776085,774387,1698,1213662,593471,620191,37.389816934204084,453786,58.47117261640156
43,SUBRAMANI K G,GEN,TIRUPPATTUR,272806,2,ADMK,78,M,TAMIL NADU,776085,774387,1698,1213662,593471,620191,22.48434901974355,272884,35.16161245224428
52,IRSHAD AHAMED H S,GEN,TIRUPPATTUR,12326,4,JD(U),1,M,TAMIL NADU,776085,774387,1698,1213662,593471,620191,1.0156864102196492,12327,1.5883569454376776
50,RAJENDIRAN P,SC,TIRUPPATTUR,8281,1,BSP,3,M,TAMIL NADU,776085,774387,1698,1213662,593471,620191,0.6825623608549992,8284,1.0674088534116752
33,SATHTAR BASHA A K,GEN,TIRUPPATTUR,6171,16,IND,0,M,TAMIL NADU,776085,774387,1698,1213662,593471,620191,0.508461169584283,6171,0.7951448617097354
32,VIJAYAKUMAR P,GEN,TIRUPPATTUR,4168,5,JP,3,M,TAMIL NADU,776085,774387,1698,1213662,593471,620191,0.3436706430620716,4171,0.5374411308039712
41,RAMU G,GEN,TIRUPPATTUR,4117,14,IND,0,M,TAMIL NADU,776085,774387,1698,1213662,593471,620191,0.33922129884597196,4117,0.5304831300695155
40,VENUGOPAL P,SC,TIRUPPATTUR,3733,15,IND,0,M,TAMIL NADU,776085,774387,1698,1213662,593471,620191,0.30758151775370735,3733,0.4810040137356089
27,PRABHAKARAN K,GEN,TIRUPPATTUR,2287,13,IND,0,M,TAMIL NADU,776085,774387,1698,1213662,593471,620191,0.1884379670781486,2287,0.2946842162907414
30,KUMAR P,SC,TIRUPPATTUR,1355,9,IND,0,M,TAMIL NADU,776085,774387,1698,1213662,593471,620191,0.11164558171879815,1355,0.17459427768865524
35,NOWSATH B,GEN,TIRUPPATTUR,1304,12,IND,1,M,TAMIL NADU,776085,774387,1698,1213662,593471,620191,0.10752581855574288,1305,0.16815168441601114
58,SUBRAMANIAN S,GEN,TIRUPPATTUR,1278,11,IND,1,M,TAMIL NADU,776085,774387,1698,1213662,593471,620191,0.10538354171095413,1279,0.16480153591423619
41,AYODHI L,GEN,TIRUPPATTUR,1256,6,IND,0,M,TAMIL NADU,776085,774387,1698,1213662,593471,620191,0.1034884506559487,1256,0.1618379430088199
61,SRINIVASAN R,GEN,TIRUPPATTUR,1064,10,IND,1,M,TAMIL NADU,776085,774387,1698,1213662,593471,620191,0.08775095537307752,1065,0.13722723670731943
43,KAMARAJ A,GEN,TIRUPPATTUR,1046,8,IND,0,M,TAMIL NADU,776085,774387,1698,1213662,593471,620191,0.08618544537111651,1046,0.13477905126371467
36,ARUNACHALAM C,GEN,TIRUPPATTUR,1019,7,IND,0,M,TAMIL NADU,776085,774387,1698,1213662,593471,620191,0.08396077326306665,1019,0.13130005089648683
59,"RAMACHANDRAN GINGEE, N",GEN,VANDAVASI,393415,1,MDMK,1488,M,TAMIL NADU,703269,701659,1610,1128624,552653,575971,34.98977515984066,394903,56.15248219386891
39,RAJALAKSHMI R,GEN,VANDAVASI,243372,3,ADMK,98,F,TAMIL NADU,703269,701659,1610,1128624,552653,575971,21.572286252994797,243470,34.61975431875996
42,PUNNIYAKOTTI P,GEN,VANDAVASI,23596,4,JD(U),13,M,TAMIL NADU,703269,701659,1610,1128624,552653,575971,2.091839266221523,23609,3.357036923282556
28,VINAYAGAM S,SC,VANDAVASI,14473,15,IND,0,M,TAMIL NADU,703269,701659,1610,1128624,552653,575971,1.2823579863621541,14473,2.057960751860241
57,SUBRAMANIAN A V,SC,VANDAVASI,5450,2,BSP,1,M,TAMIL NADU,703269,701659,1610,1128624,552653,575971,0.4829775018075107,5451,0.7750945939604902
43,MANICKAM C,GEN,VANDAVASI,5130,5,JP,6,M,TAMIL NADU,703269,701659,1610,1128624,552653,575971,0.4550674095181389,5136,0.7303037671218268
27,RANJITH KUMAR M,SC,VANDAVASI,3705,13,IND,0,M,TAMIL NADU,703269,701659,1610,1128624,552653,575971,0.32827584740356397,3705,0.5268254394833272
37,RAJALAKSHMI,GEN,VANDAVASI,3561,14,IND,0,F,TAMIL NADU,703269,701659,1610,1128624,552653,575971,0.3155169480712797,3561,0.5063496329285095
55,MUNUSAMY M,SC,VANDAVASI,1951,12,IND,0,M,TAMIL NADU,703269,701659,1610,1128624,552653,575971,0.17286536525893478,1951,0.2774187401975631
28,BABU M,SC,VANDAVASI,1514,11,IND,0,M,TAMIL NADU,703269,701659,1610,1128624,552653,575971,0.13414564992415542,1514,0.21528035502773477
39,NAGARAJAN D,SC,VANDAVASI,1379,10,IND,1,M,TAMIL NADU,703269,701659,1610,1128624,552653,575971,0.12227278526772424,1380,0.1962264794836684
29,EZHILMARAN M,SC,VANDAVASI,1194,7,IND,0,M,TAMIL NADU,703269,701659,1610,1128624,552653,575971,0.10579254029685706,1194,0.1697785626836957
47,GOVINDARASU U,GEN,VANDAVASI,1075,9,IND,2,M,TAMIL NADU,703269,701659,1610,1128624,552653,575971,0.09542593458937608,1077,0.15314196985790643
37,ANBALAGAN R,SC,VANDAVASI,992,6,IND,1,M,TAMIL NADU,703269,701659,1610,1128624,552653,575971,0.08798324331221026,993,0.1411977493675962
37,KANNAN M,SC,VANDAVASI,852,8,IND,0,M,TAMIL NADU,703269,701659,1610,1128624,552653,575971,0.07549015438268192,852,0.12114852211600396
47,DHANARAJU K,GEN,TINDIVANAM,366171,2,PMK,1678,M,TAMIL NADU,726923,725105,1818,1158938,573307,585631,31.740179371113896,367849,50.603571492441425
45,ARUNMOZHITHEVAN A,GEN,TINDIVANAM,276600,1,ADMK,85,M,TAMIL NADU,726923,725105,1818,1158938,573307,585631,23.87401224224247,276685,38.062490800263575
32,GOPALAKRISHNAN P,GEN,TINDIVANAM,29889,4,JD(U),26,M,TAMIL NADU,726923,725105,1818,1158938,573307,585631,2.581242482341592,29915,4.115291440771581
44,MOHAMED ALI JINNA M,GEN,TINDIVANAM,10987,16,IND,0,M,TAMIL NADU,726923,725105,1818,1158938,573307,585631,0.9480231039106493,10987,1.5114393133798216
67,PERUMAL S,GEN,TINDIVANAM,8083,15,IND,0,M,TAMIL NADU,726923,725105,1818,1158938,573307,585631,0.6974488712942366,8083,1.111947207613461
39,VEETHUS DURAI RAJ L,GEN,TINDIVANAM,6732,18,IND,5,M,TAMIL NADU,726923,725105,1818,1158938,573307,585631,0.5813080596201005,6737,0.9267831668553616
51,ELLANGOVAN ARANGA,GEN,TINDIVANAM,6627,7,IND,23,M,TAMIL NADU,726923,725105,1818,1158938,573307,585631,0.573801186948741,6650,0.9148149116206256
48,RANGANATHAN S,GEN,TINDIVANAM,5338,17,IND,0,M,TAMIL NADU,726923,725105,1818,1158938,573307,585631,0.4605940956289293,5338,0.7343281200347217
45,RAYAR K,GEN,TINDIVANAM,3937,3,BSP,1,M,TAMIL NADU,726923,725105,1818,1158938,573307,585631,0.3397938457449838,3938,0.5417355070619584
27,SOUNDARARAJAN N K,GEN,TINDIVANAM,3443,13,IND,0,M,TAMIL NADU,726923,725105,1818,1158938,573307,585631,0.29708232882173163,3443,0.47364026176087426
33,NAVANEETHE KRISHNAN B,GEN,TINDIVANAM,1540,14,IND,0,M,TAMIL NADU,726923,725105,1818,1158938,573307,585631,0.13288027487234003,1540,0.21185187427003963
42,SEKAR I M,GEN,TINDIVANAM,1401,12,IND,0,M,TAMIL NADU,726923,725105,1818,1158938,573307,585631,0.12088653577671973,1401,0.19273017912488669
35,ASHOK KUMAR P N,GEN,TINDIVANAM,990,5,IND,0,M,TAMIL NADU,726923,725105,1818,1158938,573307,585631,0.08542303384650429,990,0.1361904906021683
31,SALVAM M,GEN,TINDIVANAM,844,11,IND,0,M,TAMIL NADU,726923,725105,1818,1158938,573307,585631,0.07282529350146427,844,0.11610583239215157
51,INIYADAYALAN G,GEN,TINDIVANAM,725,8,IND,0,M,TAMIL NADU,726923,725105,1818,1158938,573307,585631,0.06255727226132891,725,0.09973546028946668
35,KUZANDAIVELU T,GEN,TINDIVANAM,701,10,IND,0,M,TAMIL NADU,726923,725105,1818,1158938,573307,585631,0.060486410834746984,701,0.09643387263850504
50,ARASAN K,SC,TINDIVANAM,625,6,IND,0,M,TAMIL NADU,726923,725105,1818,1158938,573307,585631,0.05392868298390423,625,0.08597884507712646
36,KASI G,GEN,TINDIVANAM,472,9,IND,0,M,TAMIL NADU,726923,725105,1818,1158938,573307,585631,0.04072694138944447,472,0.0649312238022459
57,VENKATAPATHY K,GEN,CUDDALORE,398188,3,DMK,1871,M,TAMIL NADU,760180,758178,2002,1206876,594174,612702,33.1483101826534,400059,52.62687784472099
43,RAJENDRAN R,GEN,CUDDALORE,268609,1,ADMK,98,M,TAMIL NADU,760180,758178,2002,1206876,594174,612702,22.264673421295974,268707,35.34781236023047
46,SARWAR KHAN E,GEN,CUDDALORE,53377,4,JD(U),29,M,TAMIL NADU,760180,758178,2002,1206876,594174,612702,4.425143925307985,53406,7.025441342839854
46,VEERAPATRAN P M,GEN,CUDDALORE,13664,13,IND,0,M,TAMIL NADU,760180,758178,2002,1206876,594174,612702,1.132179279395729,13664,1.797469020495146
62,SANTHIYAGURAJ M,GEN,CUDDALORE,5765,2,BSP,1,M,TAMIL NADU,760180,758178,2002,1206876,594174,612702,0.47776242132580315,5766,0.7585045647083586
37,RAJENDIRAN M,SC,CUDDALORE,5030,11,IND,0,M,TAMIL NADU,760180,758178,2002,1206876,594174,612702,0.41677852571432356,5030,0.6616853903022968
28,VIJAYKUMAR P,SC,CUDDALORE,3544,12,IND,0,M,TAMIL NADU,760180,758178,2002,1206876,594174,612702,0.2936507147378853,3544,0.4662053724117972
64,THIYAGARAJAN R,GEN,CUDDALORE,2597,8,IND,2,M,TAMIL NADU,760180,758178,2002,1206876,594174,612702,0.2153493813780372,2599,0.34189270962140544
35,RAVI K,GEN,CUDDALORE,2327,10,IND,0,M,TAMIL NADU,760180,758178,2002,1206876,594174,612702,0.19281185473901213,2327,0.3061117103843826
59,DHARMALINGAM MARUR N,SC,CUDDALORE,1935,5,RLD,1,M,TAMIL NADU,760180,758178,2002,1206876,594174,612702,0.16041416019541363,1936,0.25467652398116236
37,MURUGAN C,GEN,CUDDALORE,1373,9,IND,0,M,TAMIL NADU,760180,758178,2002,1206876,594174,612702,0.11376479439478455,1373,0.18061511747217765
40,GOVINDAN M,GEN,CUDDALORE,920,6,IND,0,M,TAMIL NADU,760180,758178,2002,1206876,594174,612702,0.07622986951434944,920,0.12102396800757716
40,DHANAKOTTI G,SC,CUDDALORE,849,7,IND,0,M,TAMIL NADU,760180,758178,2002,1206876,594174,612702,0.07034691219313335,849,0.1116840748243837
67,"PONNUSWAMY, E",SC,CHIDAMBARAM (SC),342359,3,PMK,1065,M,TAMIL NADU,743410,741925,1485,1125487,552578,572909,30.513368879427304,343424,46.19577353008434
41,THIRUMAAVALAVAN THOL,SC,CHIDAMBARAM (SC),255426,4,JD(U),347,M,TAMIL NADU,743410,741925,1485,1125487,552578,572909,22.72554014395546,255773,34.40537523035741
41,PERIASAMY D,SC,CHIDAMBARAM (SC),113906,2,BJP,68,M,TAMIL NADU,743410,741925,1485,1125487,552578,572909,10.126638512928182,113974,15.331243862740616
42,RAMALINGAM D,SC,CHIDAMBARAM (SC),6051,13,IND,0,M,TAMIL NADU,743410,741925,1485,1125487,552578,572909,0.5376339309116853,6051,0.8139519242409975
36,JAWAHARLAL NEHRU P,SC,CHIDAMBARAM (SC),5521,5,JP,5,M,TAMIL NADU,743410,741925,1485,1125487,552578,572909,0.49098745698528723,5526,0.7433314052810697
28,KUMAR K,SC,CHIDAMBARAM (SC),5092,1,BSP,0,M,TAMIL NADU,743410,741925,1485,1125487,552578,572909,0.45242637187279816,5092,0.6849517762741959
48,PONNUSAMY V E,SC,CHIDAMBARAM (SC),3159,11,IND,0,M,TAMIL NADU,743410,741925,1485,1125487,552578,572909,0.28067849739712675,3159,0.42493375122745186
27,PERIYASAMY S A,SC,CHIDAMBARAM (SC),2828,10,IND,0,M,TAMIL NADU,743410,741925,1485,1125487,552578,572909,0.2512690062168644,2828,0.380409195464145
37,RAMAMOORTHY,SC,CHIDAMBARAM (SC),2003,12,IND,0,M,TAMIL NADU,743410,741925,1485,1125487,552578,572909,0.1779674043325245,2003,0.2694340942414011
39,KANAGASABAI R,SC,CHIDAMBARAM (SC),1758,7,IND,0,M,TAMIL NADU,743410,741925,1485,1125487,552578,572909,0.15619904983353874,1758,0.2364778520601014
47,ARCHUNAN T,SC,CHIDAMBARAM (SC),1486,6,IND,0,M,TAMIL NADU,743410,741925,1485,1125487,552578,572909,0.13203173381833821,1486,0.19988969747514831
28,PURUSHOTHMAN K,SC,CHIDAMBARAM (SC),1274,9,IND,0,M,TAMIL NADU,743410,741925,1485,1125487,552578,572909,0.11319544339472602,1274,0.17137245934275838
55,THIRAVIDAMANI S,SC,CHIDAMBARAM (SC),1062,8,IND,0,M,TAMIL NADU,743410,741925,1485,1125487,552578,572909,0.09435915297111383,1062,0.14285522121036845
41,"SENTHIL, DR R",GEN,DHARMAPURI,394991,3,PMK,2549,M,TAMIL NADU,709991,707138,2853,1295521,645026,650495,30.68572412180119,397540,55.99225905680495
52,ELANGOVAN P D,GEN,DHARMAPURI,181313,1,BJP,137,M,TAMIL NADU,709991,707138,2853,1295521,645026,650495,14.005948186096559,181450,25.55666198585616
38,MUNUSAMY (ALAIS) THAMILSELVAN M,SC,DHARMAPURI,62830,5,JD(U),130,M,TAMIL NADU,709991,707138,2853,1295521,645026,650495,4.859820875153702,62960,8.8677180414963
61,BALASUBRAMANIAM M,GEN,DHARMAPURI,23520,4,TDK,33,M,TAMIL NADU,709991,707138,2853,1295521,645026,650495,1.818033053883341,23553,3.3173659947802157
42,JAGANATHAN V P,GEN,DHARMAPURI,10968,13,IND,0,M,TAMIL NADU,709991,707138,2853,1295521,645026,650495,0.8466092020121635,10968,1.5448083144715918
45,MAHENDRAN D,GEN,DHARMAPURI,10370,11,IND,0,M,TAMIL NADU,709991,707138,2853,1295521,645026,650495,0.8004501663809387,10370,1.4605818947000737
36,KANNAN KALIRU,SC,DHARMAPURI,6220,2,BSP,0,M,TAMIL NADU,709991,707138,2853,1295521,645026,650495,0.4801157217829738,6220,0.8760674431084338
42,PADMARAJAN DR K,GEN,DHARMAPURI,5161,9,IND,0,M,TAMIL NADU,709991,707138,2853,1295521,645026,650495,0.3983725466433967,5161,0.7269106228107116
32,BAYAS AHAMED A J,GEN,DHARMAPURI,3084,10,IND,1,M,TAMIL NADU,709991,707138,2853,1295521,645026,650495,0.23812813532161967,3085,0.4345125501590865
40,MURUGAN R,GEN,DHARMAPURI,2844,12,IND,0,M,TAMIL NADU,709991,707138,2853,1295521,645026,650495,0.21952558082809925,2844,0.4005684579100299
31,AYYAPPAN R,GEN,DHARMAPURI,2178,6,IND,0,M,TAMIL NADU,709991,707138,2853,1295521,645026,650495,0.16811769164683552,2178,0.306764451943757
34,SENTHIL K,GEN,DHARMAPURI,1908,8,IND,3,M,TAMIL NADU,709991,707138,2853,1295521,645026,650495,0.1475082225606532,1911,0.26915834144376477
44,SUBRAMANI P,GEN,DHARMAPURI,1751,7,IND,0,M,TAMIL NADU,709991,707138,2853,1295521,645026,650495,0.13515797891350276,1751,0.24662284451493047
46,SUGAVANAM E G,GEN,KRISHNAGIRI,401789,2,DMK,1508,M,TAMIL NADU,738737,737128,1609,1252580,622735,629845,32.19730476296923,403297,54.592771175668744
49,NANJE GOWDU K,GEN,KRISHNAGIRI,283981,3,ADMK,94,M,TAMIL NADU,738737,737128,1609,1252580,622735,629845,22.679190151527248,284075,38.45414538597633
50,SANAULLA SHARIFF H,GEN,KRISHNAGIRI,14054,1,BSP,1,M,TAMIL NADU,738737,737128,1609,1252580,622735,629845,1.122084018585639,14055,1.9025715511745045
33,SYED NIKHAR A,GEN,KRISHNAGIRI,11829,8,IND,1,M,TAMIL NADU,738737,737128,1609,1252580,622735,629845,0.9444506538504528,11830,1.6013818178864738
42,AMEERJAN S,GEN,KRISHNAGIRI,8677,4,IND,2,M,TAMIL NADU,738737,737128,1609,1252580,622735,629845,0.6928898752973862,8679,1.1748430090817166
65,KUPPUSAMY P K,GEN,KRISHNAGIRI,6275,7,IND,2,M,TAMIL NADU,738737,737128,1609,1252580,622735,629845,0.5011256766034904,6277,0.8496934633029075
45,KRISHNAMOORTHY RAO V M,GEN,KRISHNAGIRI,6252,6,IND,1,M,TAMIL NADU,738737,737128,1609,1252580,622735,629845,0.49920963132095353,6253,0.8464446751685647
63,KRISHNACHETTY T V,GEN,KRISHNAGIRI,4271,5,IND,0,M,TAMIL NADU,738737,737128,1609,1252580,622735,629845,0.34097622507145253,4271,0.5781489217407548
45,RANI K,SC,RASIPURAM (SC),381458,3,INC,2712,F,TAMIL NADU,695976,693014,2962,1132426,551892,580534,33.92451250677748,384170,55.19874248537305
54,ANBALAGAN S,SC,RASIPURAM (SC),249412,1,ADMK,225,M,TAMIL NADU,695976,693014,2962,1132426,551892,580534,22.044442639077523,249637,35.868621906502526
37,AYYASAMY S,SC,RASIPURAM (SC),24503,4,JD(U),19,M,TAMIL NADU,695976,693014,2962,1132426,551892,580534,2.1654395077470845,24522,3.5233973585296043
38,RAVI R,SC,RASIPURAM (SC),12285,13,IND,1,M,TAMIL NADU,695976,693014,2962,1132426,551892,580534,1.0849274036449181,12286,1.7652907571525454
47,MARIYAPPAN M P,SC,RASIPURAM (SC),6403,2,BSP,0,M,TAMIL NADU,695976,693014,2962,1132426,551892,580534,0.5654232594447672,6403,0.9200029886088026
31,KUMARAVEL N,SC,RASIPURAM (SC),4167,5,JP,4,M,TAMIL NADU,695976,693014,2962,1132426,551892,580534,0.36832428785633675,4171,0.5993022747910848
32,PONMENY ( SELVI) M P V,SC,RASIPURAM (SC),3956,11,IND,0,F,TAMIL NADU,695976,693014,2962,1132426,551892,580534,0.3493384998225049,3956,0.5684104049564928
32,MANIVANNAN K,SC,RASIPURAM (SC),3577,12,IND,0,M,TAMIL NADU,695976,693014,2962,1132426,551892,580534,0.315870529288448,3577,0.513954504178305
37,BALASUBRAMANIAM M,SC,RASIPURAM (SC),2355,10,IND,0,M,TAMIL NADU,695976,693014,2962,1132426,551892,580534,0.20796060846359937,2355,0.3383737370254147
27,NALLA THAMBI C,SC,RASIPURAM (SC),1418,9,IND,1,M,TAMIL NADU,695976,693014,2962,1132426,551892,580534,0.12530620102328982,1419,0.20388634090830718
27,SENTHIL KUMAR P,SC,RASIPURAM (SC),1188,8,IND,0,M,TAMIL NADU,695976,693014,2962,1132426,551892,580534,0.10490751713577752,1188,0.1706955412255595
41,SHANKAR K M,SC,RASIPURAM (SC),1152,7,IND,0,M,TAMIL NADU,695976,693014,2962,1132426,551892,580534,0.10172850146499639,1152,0.1655229490672092
37,ABIMANYU N,SC,RASIPURAM (SC),1140,6,IND,0,M,TAMIL NADU,695976,693014,2962,1132426,551892,580534,0.10066882957473601,1140,0.16379875168109245
55,THANGKABALU K V,GEN,SALEM,443260,2,INC,1331,M,TAMIL NADU,741437,740000,1437,1251141,617226,633915,35.534843794584305,444591,59.96342238113286
39,RAJASEKARAN A,GEN,SALEM,268861,1,ADMK,103,M,TAMIL NADU,741437,740000,1437,1251141,617226,633915,21.49749708466112,268964,36.27604233400815
34,SHAH JAHAN M A,GEN,SALEM,8466,15,IND,0,M,TAMIL NADU,741437,740000,1437,1251141,617226,633915,0.6766623426136623,8466,1.1418367305651054
53,JAYA VENUGOPAL C D,GEN,SALEM,4346,14,IND,0,M,TAMIL NADU,741437,740000,1437,1251141,617226,633915,0.34736292712012473,4346,0.5861590398105301
52,BALAKRISHNAN N,GEN,SALEM,4100,3,ABHM,1,M,TAMIL NADU,741437,740000,1437,1251141,617226,633915,0.32778080168422263,4101,0.5531150994622605
43,RAJAVEL R,GEN,SALEM,3915,4,JP,1,M,TAMIL NADU,741437,740000,1437,1251141,617226,633915,0.31299429880405166,3916,0.5281635526686691
42,RAJAVEL M,GEN,SALEM,1334,13,IND,0,M,TAMIL NADU,741437,740000,1437,1251141,617226,633915,0.10662267482242209,1334,0.17992088336568043
53,ASRAF ALI DR A K,GEN,SALEM,919,5,IND,1,M,TAMIL NADU,741437,740000,1437,1251141,617226,633915,0.0735328791878773,920,0.12408336783840031
32,BASKAR A,GEN,SALEM,829,12,IND,0,M,TAMIL NADU,741437,740000,1437,1251141,617226,633915,0.0662595183116851,829,0.11180990428047158
49,RATHINAM P,GEN,SALEM,747,6,IND,0,M,TAMIL NADU,741437,740000,1437,1251141,617226,633915,0.05970550081885255,747,0.1007502997557446
37,BASHEER J,GEN,SALEM,690,11,IND,0,M,TAMIL NADU,741437,740000,1437,1251141,617226,633915,0.055149659390907976,690,0.09306252587880022
46,GOPAL K A,GEN,SALEM,673,8,IND,0,M,TAMIL NADU,741437,740000,1437,1251141,617226,633915,0.05379089966678416,673,0.09076968103830804
35,KANNAN G A,GEN,SALEM,660,7,IND,0,M,TAMIL NADU,741437,740000,1437,1251141,617226,633915,0.05275184811304242,660,0.08901632910146108
38,SELVAM K,GEN,SALEM,611,9,IND,0,M,TAMIL NADU,741437,740000,1437,1251141,617226,633915,0.048835423025861996,611,0.08240754103180715
41,SYED MOHAMMED M,GEN,SALEM,589,10,IND,0,M,TAMIL NADU,741437,740000,1437,1251141,617226,633915,0.047077028088760575,589,0.07944033006175845
57,SUBBULAKSHMI JAGADEESAN,GEN,TIRUCHENGODE,499203,1,DMK,2366,F,TAMIL NADU,864451,861950,2501,1443197,711672,731525,34.75402180021162,501569,58.021680812446284
51,PALANISWAMI K,GEN,TIRUCHENGODE,322054,2,ADMK,118,M,TAMIL NADU,864451,861950,2501,1443197,711672,731525,22.323494297729276,322172,37.26897186769406
49,PALANISAMY K,GEN,TIRUCHENGODE,14208,14,IND,0,M,TAMIL NADU,864451,861950,2501,1443197,711672,731525,0.9844809821528177,14208,1.64358650750592
46,BALASUBRAMANYAM K M,GEN,TIRUCHENGODE,6739,3,BSP,7,M,TAMIL NADU,864451,861950,2501,1443197,711672,731525,0.46743445281552,6746,0.7803796860666481
37,PALANISAMY R,GEN,TIRUCHENGODE,5282,13,IND,0,M,TAMIL NADU,864451,861950,2501,1443197,711672,731525,0.36599300026261145,5282,0.6110236439080989
47,SHANMUGAM N,GEN,TIRUCHENGODE,3143,5,JP,2,M,TAMIL NADU,864451,861950,2501,1443197,711672,731525,0.21791896740361852,3145,0.36381472171354995
41,GOVINDARAJ A,GEN,TIRUCHENGODE,2431,4,CPI(ML)(L),0,M,TAMIL NADU,864451,861950,2501,1443197,711672,731525,0.16844547210117536,2431,0.28121894705425754
28,PARAMASIVAM S,SC,TIRUCHENGODE,1930,12,IND,2,M,TAMIL NADU,864451,861950,2501,1443197,711672,731525,0.13386945787719903,1932,0.22349444907808538
44,SUBBULAKSHMI ( TMT) S,GEN,TIRUCHENGODE,1343,7,IND,0,F,TAMIL NADU,864451,861950,2501,1443197,711672,731525,0.09305728878316681,1343,0.1553587190020024
26,DHARMENDRAN D,SC,TIRUCHENGODE,1286,10,IND,2,M,TAMIL NADU,864451,861950,2501,1443197,711672,731525,0.08924630525146601,1288,0.14899629938539027
68,DHANDAPANI A,GEN,TIRUCHENGODE,1182,8,IND,3,M,TAMIL NADU,864451,861950,2501,1443197,711672,731525,0.08210937245573542,1185,0.13708122264882566
34,NATARAJAN C,GEN,TIRUCHENGODE,1146,11,IND,1,M,TAMIL NADU,864451,861950,2501,1443197,711672,731525,0.07947632928837851,1147,0.13268536909553
39,CHANDRA SEKARAN K,SC,TIRUCHENGODE,1020,6,IND,0,M,TAMIL NADU,864451,861950,2501,1443197,711672,731525,0.07067642186063303,1020,0.11799396379898919
25,TAMIL MANI K,SC,TIRUCHENGODE,983,9,IND,0,M,TAMIL NADU,864451,861950,2501,1443197,711672,731525,0.0681126693029434,983,0.1137137906023592
56,PRABHU R,GEN,NILGIRIS,492105,1,INC,2016,M,TAMIL NADU,780890,778708,2182,1317502,649304,668198,37.50438329505382,494121,63.27664587842078
71,MATHAN M @ MASTER MATHAN M,GEN,NILGIRIS,257474,2,BJP,145,M,TAMIL NADU,780890,778708,2182,1317502,649304,668198,19.553594605548984,257619,32.9904339919835
72,PAPPANNAN T K,GEN,NILGIRIS,10648,9,IND,1,M,TAMIL NADU,780890,778708,2182,1317502,649304,668198,0.8082720178033886,10649,1.3637003931411593
29,KUMARAN P,GEN,NILGIRIS,6574,3,YSP,6,M,TAMIL NADU,780890,778708,2182,1317502,649304,668198,0.49942998188997056,6580,0.8426282831128584
46,TIRRUMURTHI M,GEN,NILGIRIS,3629,8,IND,1,M,TAMIL NADU,780890,778708,2182,1317502,649304,668198,0.2755214033830689,3630,0.46485420481757994
31,SHANMUGAM P,SC,NILGIRIS,2187,7,IND,1,M,TAMIL NADU,780890,778708,2182,1317502,649304,668198,0.1660718541603732,2188,0.28019311298646415
29,SENTHILKUMAR V,GEN,NILGIRIS,2163,4,ABHM,4,M,TAMIL NADU,780890,778708,2182,1317502,649304,668198,0.16447792868625627,2167,0.27750387378504016
34,DHARMARAJ M,GEN,NILGIRIS,2106,5,JP,6,M,TAMIL NADU,780890,778708,2182,1317502,649304,668198,0.16030336196833098,2112,0.27046062825750106
37,PARTHASARATHI K,GEN,NILGIRIS,1822,6,JD(U),2,M,TAMIL NADU,780890,778708,2182,1317502,649304,668198,0.13844381260901312,1824,0.23357963349511457
55,"ELANGOVAN, E V K S",GEN,GOBICHETTIPALAYAM,424382,1,INC,2444,M,TAMIL NADU,680103,677523,2580,1052350,521404,530946,40.559319617997815,426826,62.7590232655936
49,"GOVINDARAJAR, N R",GEN,GOBICHETTIPALAYAM,212227,2,ADMK,122,M,TAMIL NADU,680103,677523,2580,1052350,521404,530946,20.178552762864065,212349,31.223064741664132
33,"SHAIK MUHAIDEEN, S",GEN,GOBICHETTIPALAYAM,15356,12,IND,0,M,TAMIL NADU,680103,677523,2580,1052350,521404,530946,1.4592103387656197,15356,2.2578932896928845
49,"MUTHUSAMY, K K",GEN,GOBICHETTIPALAYAM,6037,3,BSP,2,M,TAMIL NADU,680103,677523,2580,1052350,521404,530946,0.5738585071506628,6039,0.8879537364193365
37,"ARUL JOTHE, B K",GEN,GOBICHETTIPALAYAM,5215,4,JP,10,M,TAMIL NADU,680103,677523,2580,1052350,521404,530946,0.49650781584073744,5225,0.7682659832407738
41,"SHEIK DAVOOD, A M",GEN,GOBICHETTIPALAYAM,4490,11,IND,0,M,TAMIL NADU,680103,677523,2580,1052350,521404,530946,0.4266641326554853,4490,0.660194117655708
40,"PERUMAL, P",SC,GOBICHETTIPALAYAM,1998,9,IND,0,M,TAMIL NADU,680103,677523,2580,1052350,521404,530946,0.18986078776072599,1998,0.2937790305291993
54,"MUTHAN, S",SC,GOBICHETTIPALAYAM,1895,10,IND,1,M,TAMIL NADU,680103,677523,2580,1052350,521404,530946,0.1801681949921604,1896,0.2787813022439248
29,"MALATHI SHANMUGAM, ( THIRUMATHI)",GEN,GOBICHETTIPALAYAM,1794,5,TDK,1,F,TAMIL NADU,680103,677523,2580,1052350,521404,530946,0.1705706276428945,1795,0.2639306105104668
35,"SELVAN, S",SC,GOBICHETTIPALAYAM,1503,8,IND,0,M,TAMIL NADU,680103,677523,2580,1052350,521404,530946,0.14282320520739297,1503,0.2209959373800733
54,"KARUPPUSAMY, S R",SC,GOBICHETTIPALAYAM,1315,7,IND,0,M,TAMIL NADU,680103,677523,2580,1052350,521404,530946,0.12495842637905641,1315,0.1933530656385871
48,"KANNAIAN, N",SC,GOBICHETTIPALAYAM,1311,6,IND,0,M,TAMIL NADU,680103,677523,2580,1052350,521404,530946,0.12457832470185776,1311,0.19276491943132143
56,"SUBBARAYAN, K",GEN,COIMBATORE,503627,1,CPI,1354,M,TAMIL NADU,878866,877443,1423,1584223,796722,787501,31.875626095568617,504981,57.458247332357836
47,RADHAKISHNAN C P,GEN,COIMBATORE,340410,3,BJP,66,M,TAMIL NADU,878866,877443,1423,1584223,796722,787501,21.491671311425222,340476,38.74037680374482
35,VELLINGIRI S,GEN,COIMBATORE,11562,11,IND,0,M,TAMIL NADU,878866,877443,1423,1584223,796722,787501,0.7298214960898812,11562,1.3155589134179726
45,NOOR MUHAMAD A,GEN,COIMBATORE,4483,2,BSP,1,M,TAMIL NADU,878866,877443,1423,1584223,796722,787501,0.28304096077383045,4484,0.5102029205817497
50,MOOGAMBIKAI MANI,GEN,COIMBATORE,4436,4,SHS,1,M,TAMIL NADU,878866,877443,1423,1584223,796722,787501,0.2800742067246846,4437,0.504855120120701
34,RANGASAMY O,SC,COIMBATORE,3222,9,IND,0,M,TAMIL NADU,878866,877443,1423,1584223,796722,787501,0.20338045843293523,3222,0.36660878905316624
39,RANGASAMY R,GEN,COIMBATORE,2855,10,IND,0,M,TAMIL NADU,878866,877443,1423,1584223,796722,787501,0.18021452787896655,2855,0.3248504322615734
47,RAJENDRAN,GEN,COIMBATORE,2329,5,JP,0,M,TAMIL NADU,878866,877443,1423,1584223,796722,787501,0.14701213149916392,2329,0.26500058029324147
53,SUBBURAJU K,GEN,COIMBATORE,2271,8,IND,0,M,TAMIL NADU,878866,877443,1423,1584223,796722,787501,0.1433510307576648,2271,0.2584011669583304
31,ANNADURAI A,GEN,COIMBATORE,1218,6,IND,0,M,TAMIL NADU,878866,877443,1423,1584223,796722,787501,0.07688311557148204,1218,0.1385876800331336
36,ANBARASU R,GEN,COIMBATORE,1030,7,IND,1,M,TAMIL NADU,878866,877443,1423,1584223,796722,787501,0.06507922180147618,1031,0.11731026117747188
68,"KRISHNAN, DR C",SC,POLLACHI (SC),363220,1,MDMK,1768,M,TAMIL NADU,642999,641158,1841,1039279,511106,528173,35.11934716279267,364988,56.763385324082925
45,MURUGAN G,SC,POLLACHI (SC),244001,3,ADMK,66,M,TAMIL NADU,642999,641158,1841,1039279,511106,528173,23.484261685264496,244067,37.95760180031384
33,RAJKUMAR R,SC,POLLACHI (SC),13039,7,IND,0,M,TAMIL NADU,642999,641158,1841,1039279,511106,528173,1.2546197892962332,13039,2.027841411884
42,GANESAN K M,SC,POLLACHI (SC),6502,4,IND,1,M,TAMIL NADU,642999,641158,1841,1039279,511106,528173,0.6257222555252246,6503,1.011354605528158
48,KRISHNAN A,SC,POLLACHI (SC),5451,5,IND,1,M,TAMIL NADU,642999,641158,1841,1039279,511106,528173,0.524594454424654,5452,0.847901785228282
29,MUTHUKUMAR N,SC,POLLACHI (SC),5289,2,BSP,5,M,TAMIL NADU,642999,641158,1841,1039279,511106,528173,0.5093916070660526,5294,0.8233294297502796
31,DEVARAJ K,SC,POLLACHI (SC),3656,6,IND,0,M,TAMIL NADU,642999,641158,1841,1039279,511106,528173,0.3517823414116902,3656,0.5685856432125089
56,"KHARVENTHAN, S K",GEN,PALANI,447451,1,INC,1449,M,TAMIL NADU,695442,693929,1513,1088931,533394,555537,41.22391593223079,448900,64.54887682941208
43,KISHORE KUMAR K,GEN,PALANI,217348,2,ADMK,59,M,TAMIL NADU,695442,693929,1513,1088931,533394,555537,19.96517685693584,217407,31.261701191472476
44,JEYAPRAKASH P,SC,PALANI,11337,11,IND,0,M,TAMIL NADU,695442,693929,1513,1088931,533394,555537,1.0411127977805756,11337,1.630186270026832
47,SUBRAMANIYAM T,GEN,PALANI,5554,3,BSP,0,M,TAMIL NADU,695442,693929,1513,1088931,533394,555537,0.5100414994154817,5554,0.7986287857218862
36,PARAMESHVARAN S,GEN,PALANI,3524,10,IND,0,M,TAMIL NADU,695442,693929,1513,1088931,533394,555537,0.32362013754774177,3524,0.5067280952257701
45,SOUNDARARAJAN V S,GEN,PALANI,2601,4,JP,4,M,TAMIL NADU,695442,693929,1513,1088931,533394,555537,0.23922544219973532,2605,0.37458192056275
33,ABDUL HAKKEEM A,GEN,PALANI,1440,5,IND,0,M,TAMIL NADU,695442,693929,1513,1088931,533394,555537,0.1322397837879535,1440,0.2070625587755701
38,NAGALINGAM S,SC,PALANI,1411,9,IND,0,M,TAMIL NADU,695442,693929,1513,1088931,533394,555537,0.1295766214755572,1411,0.20289254891133982
33,THANGAPANDI R,SC,PALANI,1137,8,IND,1,M,TAMIL NADU,695442,693929,1513,1088931,533394,555537,0.10450616246575771,1138,0.16363693881013802
30,KARUNAGARAN I,SC,PALANI,1078,6,IND,0,M,TAMIL NADU,695442,693929,1513,1088931,533394,555537,0.09899617147459297,1078,0.15500933219448926
37,CHINNASAMY R,SC,PALANI,1048,7,IND,0,M,TAMIL NADU,695442,693929,1513,1088931,533394,555537,0.09624117597901061,1048,0.15069552888666488
70,"CHITTHAN, N S V",GEN,DINDIGUL,405619,1,INC,1497,M,TAMIL NADU,690231,688646,1585,1137313,552499,584814,35.796302337175426,407116,58.98257250109021
49,JEYARAMAN M,GEN,DINDIGUL,251865,3,ADMK,80,M,TAMIL NADU,690231,688646,1585,1137313,552499,584814,22.152652787755,251945,36.50154803247029
43,RAVINDRAN J,SC,DINDIGUL,10359,8,IND,0,M,TAMIL NADU,690231,688646,1585,1137313,552499,584814,0.9108310553031576,10359,1.5008019054490453
42,THINAKARA KUMAR P,GEN,DINDIGUL,5846,4,JP,4,M,TAMIL NADU,690231,688646,1585,1137313,552499,584814,0.5143702744978735,5850,0.8475423445194434
34,PUSHPA SACHAN,GEN,DINDIGUL,5205,5,JD(U),1,F,TAMIL NADU,690231,688646,1585,1137313,552499,584814,0.45774558103178276,5206,0.754240247105679
58,PERUMAL M,SC,DINDIGUL,5009,2,BSP,2,M,TAMIL NADU,690231,688646,1585,1137313,552499,584814,0.44059990521518705,5011,0.7259888356216977
40,KANDAVEL P,SC,DINDIGUL,2455,6,IND,1,M,TAMIL NADU,690231,688646,1585,1137313,552499,584814,0.21594758874645767,2456,0.3558229056649151
34,MACHAKKALAI M,SC,DINDIGUL,2288,7,IND,0,M,TAMIL NADU,690231,688646,1585,1137313,552499,584814,0.20117592958139052,2288,0.33148322807871566
54,"MOHAN, P",GEN,MADURAI,413053,2,CPM,1380,M,TAMIL NADU,739680,738136,1544,1344023,669725,674298,30.83526100371794,414433,56.02868808133247
56,"BOSE, A K",GEN,MADURAI,281447,1,ADMK,146,M,TAMIL NADU,739680,738136,1544,1344023,669725,674298,20.9515015740058,281593,38.0695706251352
42,"SAKTHIVEL, P",SC,MADURAI,12085,4,JD(U),8,M,TAMIL NADU,739680,738136,1544,1344023,669725,674298,0.899761388011961,12093,1.6348961713173265
64,SUBRAMANIAN SWAMY,GEN,MADURAI,12002,5,JP,7,M,TAMIL NADU,739680,738136,1544,1344023,669725,674298,0.893511494966976,12009,1.6235399091499028
48,"BHASKARAN, PON",GEN,MADURAI,5514,14,IND,0,M,TAMIL NADU,739680,738136,1544,1344023,669725,674298,0.4102608363100929,5514,0.7454574951330305
58,MAHALINGAM N,GEN,MADURAI,5478,15,IND,0,M,TAMIL NADU,739680,738136,1544,1344023,669725,674298,0.407582310719385,5478,0.740590525632706
54,"RADHAKRISHNAN, S",SC,MADURAI,2645,3,BSP,1,M,TAMIL NADU,739680,738136,1544,1344023,669725,674298,0.19687163091703044,2646,0.3577222582738481
44,RAJENDRAN M,GEN,MADURAI,1067,8,IND,0,M,TAMIL NADU,739680,738136,1544,1344023,669725,674298,0.07938852236903683,1067,0.14425156824572788
29,BASKARAN S,GEN,MADURAI,1062,13,IND,0,M,TAMIL NADU,739680,738136,1544,1344023,669725,674298,0.07901650492588297,1062,0.14357560025957172
47,"PANDI, V",SC,MADURAI,750,12,IND,0,M,TAMIL NADU,739680,738136,1544,1344023,669725,674298,0.055802616473081185,750,0.10139519792342634
28,KANNAN G,GEN,MADURAI,705,9,IND,0,M,TAMIL NADU,739680,738136,1544,1344023,669725,674298,0.05245445948469632,705,0.09531148604802075
67,RAMADOSS M,GEN,MADURAI,688,6,ABHM,0,M,TAMIL NADU,739680,738136,1544,1344023,669725,674298,0.05118960017797315,688,0.09301319489508977
61,"THANGAIAH, P G",GEN,MADURAI,612,11,IND,2,M,TAMIL NADU,739680,738136,1544,1344023,669725,674298,0.0456837420192958,614,0.08300886869997837
38,"ARUN THAMILARASAN, K",GEN,MADURAI,580,7,IND,0,M,TAMIL NADU,739680,738136,1544,1344023,669725,674298,0.04315402340584945,580,0.07841228639411638
44,"CHANDRASEHAR, K",GEN,MADURAI,448,10,IND,0,M,TAMIL NADU,739680,738136,1544,1344023,669725,674298,0.03333276290658716,448,0.060566731559593336
53,AARON RASHID J M,GEN,PERIYAKULAM,344354,1,INC,2497,M,TAMIL NADU,700534,697773,2761,1056853,514655,542198,32.81922840735656,346851,49.5123719905101
40,DHINAKARAN T T V,GEN,PERIYAKULAM,325436,2,ADMK,260,M,TAMIL NADU,700534,697773,2761,1056853,514655,542198,30.817530914895446,325696,46.492532839234066
37,VEERAJOTHIMURUGAN S,GEN,PERIYAKULAM,4852,3,JP,0,M,TAMIL NADU,700534,697773,2761,1056853,514655,542198,0.4590988529152115,4852,0.6926144912309753
49,THANGADURAI K,SC,PERIYAKULAM,4089,16,IND,0,M,TAMIL NADU,700534,697773,2761,1056853,514655,542198,0.38690338202190844,4089,0.5836975792752386
53,DAMODARAN M,GEN,PERIYAKULAM,3950,17,IND,0,M,TAMIL NADU,700534,697773,2761,1056853,514655,542198,0.37375112716716513,3950,0.5638555730342854
33,THIRUKKANNAN M,SC,PERIYAKULAM,2596,18,IND,0,M,TAMIL NADU,700534,697773,2761,1056853,514655,542198,0.24563491800657233,2596,0.3705744474929126
41,VENUGOPAL S,GEN,PERIYAKULAM,1744,29,IND,0,M,TAMIL NADU,700534,697773,2761,1056853,514655,542198,0.16501821918469267,1744,0.2489529416131123
63,SURULIAPPAN P,GEN,PERIYAKULAM,1583,15,IND,0,M,TAMIL NADU,700534,697773,2761,1056853,514655,542198,0.14978431248243607,1583,0.22597047395272749
40,ABDUL JABAR K V,GEN,PERIYAKULAM,1052,4,IND,0,M,TAMIL NADU,700534,697773,2761,1056853,514655,542198,0.09954080652654626,1052,0.15017115514735901
44,VEERAPANDIYAN M,GEN,PERIYAKULAM,737,28,IND,0,M,TAMIL NADU,700534,697773,2761,1056853,514655,542198,0.06973533689169639,737,0.10520545755095399
32,SHAHUL P M,GEN,PERIYAKULAM,649,14,IND,2,M,TAMIL NADU,700534,697773,2761,1056853,514655,542198,0.061597970578689744,651,0.09292910836590372
43,UTHAYASURIYAN K,SC,PERIYAKULAM,550,8,IND,0,M,TAMIL NADU,700534,697773,2761,1056853,514655,542198,0.052041296187833125,550,0.07851153548578656
44,CHANDRASEKHAR ALIAS CHANDRAN E,GEN,PERIYAKULAM,507,13,IND,0,M,TAMIL NADU,700534,697773,2761,1056853,514655,542198,0.047972613031329804,507,0.07237336089326142
25,KANNAN K,SC,PERIYAKULAM,487,9,IND,0,M,TAMIL NADU,700534,697773,2761,1056853,514655,542198,0.046080202260863144,487,0.06951839596650555
58,RAMAKRISHNAN MAHA,SC,PERIYAKULAM,476,7,IND,1,M,TAMIL NADU,700534,697773,2761,1056853,514655,542198,0.04513399687562982,477,0.06809091350312761
33,ANANDAKUMAR K,SC,PERIYAKULAM,467,5,IND,0,M,TAMIL NADU,700534,697773,2761,1056853,514655,542198,0.04418779149039649,467,0.06666343103974968
54,PALANICHAMY K,SC,PERIYAKULAM,465,19,IND,0,M,TAMIL NADU,700534,697773,2761,1056853,514655,542198,0.043998550413349824,465,0.06637793454707408
31,ERANIYAN R,SC,PERIYAKULAM,434,6,IND,0,M,TAMIL NADU,700534,697773,2761,1056853,514655,542198,0.0410653137191265,434,0.06195273891060249
36,GOVINDARASU S,SC,PERIYAKULAM,429,12,IND,0,M,TAMIL NADU,700534,697773,2761,1056853,514655,542198,0.04059221102650983,429,0.06123899767891351
44,GURUVU K,SC,PERIYAKULAM,387,11,IND,0,M,TAMIL NADU,700534,697773,2761,1056853,514655,542198,0.03661814840852985,387,0.05524357133272617
42,BOMMURASU M,GEN,PERIYAKULAM,387,24,IND,0,M,TAMIL NADU,700534,697773,2761,1056853,514655,542198,0.03661814840852985,387,0.05524357133272617
56,KRISHNASAMY S R,GEN,PERIYAKULAM,366,10,IND,0,M,TAMIL NADU,700534,697773,2761,1056853,514655,542198,0.03463111709953986,366,0.05224585815963251
54,VEERANAN A,GEN,PERIYAKULAM,357,27,IND,0,M,TAMIL NADU,700534,697773,2761,1056853,514655,542198,0.03377953225282986,357,0.05096112394259236
55,PERIYASUBBIAN P,SC,PERIYAKULAM,303,23,IND,0,M,TAMIL NADU,700534,697773,2761,1056853,514655,542198,0.02867002317256988,303,0.043252718640351503
30,MOHANRAJ ALIAS GOURMOHANDASS V S,SC,PERIYAKULAM,256,25,IND,0,M,TAMIL NADU,700534,697773,2761,1056853,514655,542198,0.024222857861973236,256,0.03654355106247519
39,RAVI M,GEN,PERIYAKULAM,230,26,IND,0,M,TAMIL NADU,700534,697773,2761,1056853,514655,542198,0.021762723860366578,230,0.03283209665769256
56,BALU V,SC,PERIYAKULAM,227,20,IND,0,M,TAMIL NADU,700534,697773,2761,1056853,514655,542198,0.02147886224479658,227,0.03240385191867918
47,PETHANAN K,SC,PERIYAKULAM,225,22,IND,0,M,TAMIL NADU,700534,697773,2761,1056853,514655,542198,0.021289621167749913,225,0.032118355426003595
30,PRABAKARAN S N,GEN,PERIYAKULAM,178,21,IND,1,M,TAMIL NADU,700534,697773,2761,1056853,514655,542198,0.016937076395676598,179,0.02555193609446508
69,"PALANISAMY, K C",GEN,KARUR,448450,1,DMK,1957,M,TAMIL NADU,743592,741533,2059,1069359,529000,540359,42.11934439229482,450407,60.57179205801031
49,"PALANICHAMY, RAJA N",GEN,KARUR,259434,2,ADMK,97,M,TAMIL NADU,743592,741533,2059,1069359,529000,540359,24.26977282652505,259531,34.902338917040524
33,JAWAHAR N,GEN,KARUR,14552,14,IND,0,M,TAMIL NADU,743592,741533,2059,1069359,529000,540359,1.3608152173404815,14552,1.956987165004465
26,NAGARAJAN H,GEN,KARUR,5669,3,JP,3,M,TAMIL NADU,743592,741533,2059,1069359,529000,540359,0.5304112089578897,5672,0.7627838922419822
37,RATHINASAMY C,GEN,KARUR,5578,13,IND,0,M,TAMIL NADU,743592,741533,2059,1069359,529000,540359,0.5216208962565425,5578,0.7501425512915685
36,MURUGESAN R,GEN,KARUR,1243,12,IND,0,M,TAMIL NADU,743592,741533,2059,1069359,529000,540359,0.11623785838058126,1243,0.16716156171664032
37,ARUMUGAM P,SC,KARUR,1162,4,IND,0,M,TAMIL NADU,743592,741533,2059,1069359,529000,540359,0.10866322722303735,1162,0.15626849132319873
30,PALANISAMY K,GEN,KARUR,945,10,IND,1,M,TAMIL NADU,743592,741533,2059,1069359,529000,540359,0.08846421080292025,946,0.1272203036073546
36,MANIVASAGAM R,SC,KARUR,876,11,IND,0,M,TAMIL NADU,743592,741533,2059,1069359,529000,540359,0.08191823325936379,876,0.11780653906981248
36,SELVAKUMAR L K,GEN,KARUR,776,9,IND,0,M,TAMIL NADU,743592,741533,2059,1069359,529000,540359,0.07256683676856884,776,0.10435830401618093
28,SAKTHIVEL A K,GEN,KARUR,756,5,IND,0,M,TAMIL NADU,743592,741533,2059,1069359,529000,540359,0.07069655747040984,756,0.1016686570054546
25,CHANDRAMOHAN R,GEN,KARUR,728,7,IND,0,M,TAMIL NADU,743592,741533,2059,1069359,529000,540359,0.06807816645298725,728,0.09790315119043776
25,SENTHILKUMAR K,GEN,KARUR,689,8,IND,0,M,TAMIL NADU,743592,741533,2059,1069359,529000,540359,0.06443112182157722,689,0.09265833951952146
38,SAKTHEVEL P,GEN,KARUR,675,6,IND,1,M,TAMIL NADU,743592,741533,2059,1069359,529000,540359,0.06321544027777388,676,0.09091006896254936
68,GANESAN L,GEN,TIRUCHIRAPPALLI,450147,1,MDMK,760,M,TAMIL NADU,708137,707321,816,1192254,582244,610010,37.819709558533674,450907,63.675108065247265
44,PARANJOTHI M,GEN,TIRUCHIRAPPALLI,234129,2,ADMK,53,M,TAMIL NADU,708137,707321,816,1192254,582244,610010,19.641955489350423,234182,33.070154504001344
49,RAVI P,GEN,TIRUCHIRAPPALLI,7831,14,IND,0,M,TAMIL NADU,708137,707321,816,1192254,582244,610010,0.6568231266156372,7831,1.1058594593983933
33,RAMESH M,SC,TIRUCHIRAPPALLI,4418,3,BSP,0,M,TAMIL NADU,708137,707321,816,1192254,582244,610010,0.3705586225753908,4418,0.6238905748463928
36,PILANTINAL MARY A,GEN,TIRUCHIRAPPALLI,2342,13,IND,0,F,TAMIL NADU,708137,707321,816,1192254,582244,610010,0.19643465234757024,2342,0.33072696385021544
27,HEMAVATHY V,GEN,TIRUCHIRAPPALLI,1861,4,JP,1,F,TAMIL NADU,708137,707321,816,1192254,582244,610010,0.15617477483824757,1862,0.2629434699782669
28,BALAKRISHNAN M D,GEN,TIRUCHIRAPPALLI,1378,12,IND,0,M,TAMIL NADU,708137,707321,816,1192254,582244,610010,0.11557939834968053,1378,0.19459511365738552
51,ANGUSAMY N,GEN,TIRUCHIRAPPALLI,1101,5,IND,0,M,TAMIL NADU,708137,707321,816,1192254,582244,610010,0.0923460940370089,1101,0.1554783890687819
35,ARUMUGAM P,GEN,TIRUCHIRAPPALLI,844,9,IND,0,M,TAMIL NADU,708137,707321,816,1192254,582244,610010,0.07079028462055904,844,0.1191859767248428
28,THIYAGARAJAN A,GEN,TIRUCHIRAPPALLI,823,11,IND,1,M,TAMIL NADU,708137,707321,816,1192254,582244,610010,0.06911278972433726,824,0.11636166448017826
61,AJIMUDEEN G,GEN,TIRUCHIRAPPALLI,711,6,IND,0,M,TAMIL NADU,708137,707321,816,1192254,582244,610010,0.05963494356068422,711,0.10040430029782373
31,SATHAKATHULLA MOULANA N M,GEN,TIRUCHIRAPPALLI,623,10,IND,0,M,TAMIL NADU,708137,707321,816,1192254,582244,610010,0.05225396601730839,623,0.08797732642129984
48,ARUMUGAM C,GEN,TIRUCHIRAPPALLI,593,8,IND,1,M,TAMIL NADU,708137,707321,816,1192254,582244,610010,0.04982159841778681,594,0.08388207366653629
48,ARUMUGAM K,GEN,TIRUCHIRAPPALLI,520,7,IND,0,M,TAMIL NADU,708137,707321,816,1192254,582244,610010,0.04361486730176624,520,0.07343211836127755
41,"RAJA, A",SC,PERAMBALUR (SC),387465,1,DMK,2243,M,TAMIL NADU,707028,704648,2380,999508,479747,519761,38.98998307167126,389708,55.11917491245043
41,SUNDARAM DR M,SC,PERAMBALUR (SC),236282,2,ADMK,93,M,TAMIL NADU,707028,704648,2380,999508,479747,519761,23.649135374604306,236375,33.43219787618029
38,GANESAN V,SC,PERAMBALUR (SC),47007,3,JD(U),34,M,TAMIL NADU,707028,704648,2380,999508,479747,519761,4.706415556453775,47041,6.653343290506175
27,JAISANKAR K,SC,PERAMBALUR (SC),15933,7,IND,2,M,TAMIL NADU,707028,704648,2380,999508,479747,519761,1.594284387918856,15935,2.2538004152593674
33,THATCHANAMOORTHY DR M,SC,PERAMBALUR (SC),7464,4,JP,6,M,TAMIL NADU,707028,704648,2380,999508,479747,519761,0.747367704910816,7470,1.0565352433001238
37,JAYARAMAN A,SC,PERAMBALUR (SC),6994,6,IND,1,M,TAMIL NADU,707028,704648,2380,999508,479747,519761,0.6998443234071162,6995,0.9893526140407453
47,SUBRAMANIAN N,SC,PERAMBALUR (SC),3503,5,IND,1,M,TAMIL NADU,707028,704648,2380,999508,479747,519761,0.3505724816609772,3504,0.4955956482628694
63,MANI SHANKAR AIYAR,GEN,MAYILADUTURAI,409257,1,INC,1903,M,TAMIL NADU,695627,693551,2076,1022018,506566,515452,40.23021120958731,411160,59.10638891244877
49,MANIAN O S,GEN,MAYILADUTURAI,215325,2,ADMK,144,M,TAMIL NADU,695627,693551,2076,1022018,506566,515452,21.082701087456385,215469,30.974789650200467
30,RAJAN J,GEN,MAYILADUTURAI,49099,3,JD(U),25,M,TAMIL NADU,695627,693551,2076,1022018,506566,515452,4.806568964538785,49124,7.0618305499930285
49,RAHMATHULLAH U,GEN,MAYILADUTURAI,8335,10,IND,0,M,TAMIL NADU,695627,693551,2076,1022018,506566,515452,0.8155433661638054,8335,1.1981996098483814
31,MALARVIZHI D,GEN,MAYILADUTURAI,3573,9,IND,0,F,TAMIL NADU,695627,693551,2076,1022018,506566,515452,0.349602453185756,3573,0.5136373372511418
43,GUNASEKARAN N,SC,MAYILADUTURAI,2382,4,CPI(ML)(L),2,M,TAMIL NADU,695627,693551,2076,1022018,506566,515452,0.2332639933934627,2384,0.34271240190504393
38,SOUNDARRAJAN B,GEN,MAYILADUTURAI,1772,8,IND,1,M,TAMIL NADU,695627,693551,2076,1022018,506566,515452,0.17348031052290663,1773,0.2548779733966623
38,CHAKRAVARTHY K,GEN,MAYILADUTURAI,1587,7,IND,0,M,TAMIL NADU,695627,693551,2076,1022018,506566,515452,0.15528102244774555,1587,0.22813950579836606
46,GANESAN MAVAI,SC,MAYILADUTURAI,1198,6,IND,0,M,TAMIL NADU,695627,693551,2076,1022018,506566,515452,0.11721907050560754,1198,0.17221873216537023
50,RAJA R,GEN,MAYILADUTURAI,1023,5,JP,1,M,TAMIL NADU,695627,693551,2076,1022018,506566,515452,0.10019393004819876,1024,0.14720532699277056
43,"VIJAYAN, A K S",SC,NAGAPATTINAM (SC),461554,3,DMK,1835,M,TAMIL NADU,751436,749483,1953,1049004,517378,531626,44.17418808698537,463389,61.667128005578654
47,ARCHUNAN P J,SC,NAGAPATTINAM (SC),247061,1,ADMK,105,M,TAMIL NADU,751436,749483,1953,1049004,517378,531626,23.561969258458497,247166,32.89248851532266
36,RAMESH S G M,SC,NAGAPATTINAM (SC),17079,4,JD(U),11,M,TAMIL NADU,751436,749483,1953,1049004,517378,531626,1.6291644264464198,17090,2.2743121170665233
32,MURUGESAN K,SC,NAGAPATTINAM (SC),9480,11,IND,0,M,TAMIL NADU,751436,749483,1953,1049004,517378,531626,0.9037143804980725,9480,1.2615844862370182
43,BALAGURU A,SC,NAGAPATTINAM (SC),4207,2,BSP,0,M,TAMIL NADU,751436,749483,1953,1049004,517378,531626,0.40104708847630705,4207,0.5598613854007527
33,KUMAR T,SC,NAGAPATTINAM (SC),3811,9,IND,0,M,TAMIL NADU,751436,749483,1953,1049004,517378,531626,0.3632969941010711,3811,0.5071622866085734
34,KEMBURAJ G,SC,NAGAPATTINAM (SC),2113,10,IND,0,M,TAMIL NADU,751436,749483,1953,1049004,517378,531626,0.20142916518907458,2113,0.2811949387572594
36,KUMAR K,SC,NAGAPATTINAM (SC),1361,8,IND,0,M,TAMIL NADU,751436,749483,1953,1049004,517378,531626,0.12974211728458612,1361,0.18111988246504027
29,INGERSAL N,SC,NAGAPATTINAM (SC),1155,5,IND,0,M,TAMIL NADU,751436,749483,1953,1049004,517378,531626,0.11010444192777148,1155,0.1537057048105228
36,KARUNAKARAN S,SC,NAGAPATTINAM (SC),924,7,IND,2,M,TAMIL NADU,751436,749483,1953,1049004,517378,531626,0.08827421058451636,926,0.1232307209130252
30,EZHILAN G,SC,NAGAPATTINAM (SC),738,6,IND,0,M,TAMIL NADU,751436,749483,1953,1049004,517378,531626,0.07035244860839425,738,0.09821195683997042
53,PALANIMANICKAM S S,GEN,THANJAVUR,399081,2,DMK,1905,M,TAMIL NADU,708724,706664,2060,1030779,504188,526591,38.90125817464267,400986,56.57858348242757
56,THANGAMUTHU K,GEN,THANJAVUR,281688,1,ADMK,150,M,TAMIL NADU,708724,706664,2060,1030779,504188,526591,27.342233398235706,281838,39.766961468780515
28,SHAHUL HAMEED A R,GEN,THANJAVUR,10606,13,IND,0,M,TAMIL NADU,708724,706664,2060,1030779,504188,526591,1.0289305467030276,10606,1.496492287547762
43,DHARAMALINGAM N,GEN,THANJAVUR,5018,12,IND,0,M,TAMIL NADU,708724,706664,2060,1030779,504188,526591,0.48681628166658425,5018,0.7080330283721167
31,VENKATESAN A,GEN,THANJAVUR,3944,3,JP,3,M,TAMIL NADU,708724,706664,2060,1030779,504188,526591,0.3829142813347963,3947,0.5569163736518024
32,KESHOR KUMAR T P,GEN,THANJAVUR,1900,4,IND,1,M,TAMIL NADU,708724,706664,2060,1030779,504188,526591,0.1844236252387757,1901,0.26822853466229446
34,DHAYANITHI J,SC,THANJAVUR,904,11,IND,0,M,TAMIL NADU,708724,706664,2060,1030779,504188,526591,0.08770066134447829,904,0.1275531800813857
55,SOZHAMANNAR KANAKARAJA K,GEN,THANJAVUR,789,10,IND,0,M,TAMIL NADU,708724,706664,2060,1030779,504188,526591,0.07654405066459444,789,0.11132683527014747
29,SENTHILKUMAR P K,SC,THANJAVUR,776,9,IND,0,M,TAMIL NADU,708724,706664,2060,1030779,504188,526591,0.07528286858773801,776,0.1094925528132249
41,SUSAI ARUL V,GEN,THANJAVUR,576,8,IND,0,M,TAMIL NADU,708724,706664,2060,1030779,504188,526591,0.05588006740533131,576,0.08127282270672363
51,CHARLES A,GEN,THANJAVUR,469,5,IND,0,M,TAMIL NADU,708724,706664,2060,1030779,504188,526591,0.04549956877274372,469,0.06617526709974546
40,SINGARAVELU G,GEN,THANJAVUR,467,6,IND,1,M,TAMIL NADU,708724,706664,2060,1030779,504188,526591,0.045402554766831686,468,0.06603416844921295
32,SIVAKUMAR M,SC,THANJAVUR,446,7,IND,0,M,TAMIL NADU,708724,706664,2060,1030779,504188,526591,0.043268246636766955,446,0.06292999813749782
53,"REGUPATHY, S",GEN,PUDUKKOTTAI,463090,2,DMK,3043,M,TAMIL NADU,820271,817046,3225,1234949,602894,632055,37.745121458456985,466133,56.82670727113357
37,RAVICHANDRAN A,GEN,PUDUKKOTTAI,309466,3,ADMK,171,M,TAMIL NADU,820271,817046,3225,1234949,602894,632055,25.072857259692505,309637,37.7481344580023
47,NAGOORAN A,SC,PUDUKKOTTAI,10019,1,BSP,5,M,TAMIL NADU,820271,817046,3225,1234949,602894,632055,0.8116934383525151,10024,1.222035156673831
61,"RAJENDRAN, LION, M S",GEN,PUDUKKOTTAI,9721,13,IND,2,M,TAMIL NADU,820271,817046,3225,1234949,602894,632055,0.7873199622008682,9723,1.1853399669133737
36,SRINIVASAN G,GEN,PUDUKKOTTAI,7544,4,JP,1,M,TAMIL NADU,820271,817046,3225,1234949,602894,632055,0.6109564038676901,7545,0.919817962600165
40,MACHAKKALAI @ INGARSAL A,SC,PUDUKKOTTAI,4725,12,IND,0,M,TAMIL NADU,820271,817046,3225,1234949,602894,632055,0.3826068930781757,4725,0.5760291415885725
32,PERIYASAMY R,GEN,PUDUKKOTTAI,3346,11,IND,0,M,TAMIL NADU,820271,817046,3225,1234949,602894,632055,0.2709423628020266,3346,0.40791396989531503
34,JAHIR HUSSAIN J,GEN,PUDUKKOTTAI,2921,5,JD(U),2,M,TAMIL NADU,820271,817046,3225,1234949,602894,632055,0.2366899361835995,2923,0.3563456467435762
41,PACKIANATHAN D,GEN,PUDUKKOTTAI,1675,10,IND,0,M,TAMIL NADU,820271,817046,3225,1234949,602894,632055,0.13563313140866545,1675,0.204200806806531
58,SELVARAJAN S,SC,PUDUKKOTTAI,1178,9,IND,1,M,TAMIL NADU,820271,817046,3225,1234949,602894,632055,0.09546952951093528,1179,0.14373298580591048
29,ASAITHAMBI R,SC,PUDUKKOTTAI,1173,6,IND,0,M,TAMIL NADU,820271,817046,3225,1234949,602894,632055,0.09498367948797885,1173,0.14300152022929008
41,SELVAM S,GEN,PUDUKKOTTAI,1150,8,IND,0,M,TAMIL NADU,820271,817046,3225,1234949,602894,632055,0.09312125439997927,1150,0.14019756885224516
35,SUBRAMANIAN K,GEN,PUDUKKOTTAI,1038,7,IND,0,M,TAMIL NADU,820271,817046,3225,1234949,602894,632055,0.08405205397145955,1038,0.12654354475533086
58,"CHIDAMBARAM, P",GEN,SIVAGANGA,397923,2,INC,2470,M,TAMIL NADU,667208,664594,2614,1083542,523314,560228,36.95223627695096,400393,60.01022169997962
45,KARUPPIAH S P,GEN,SIVAGANGA,237533,1,ADMK,135,M,TAMIL NADU,667208,664594,2614,1083542,523314,560228,21.934359720250807,237668,35.62127552427429
65,SUBRAMANIAN MUTHARAIYAR M,GEN,SIVAGANGA,9709,12,IND,0,M,TAMIL NADU,667208,664594,2614,1083542,523314,560228,0.8960427929881813,9709,1.4551684032565557
35,NOWSHAD ALI KHAN K,GEN,SIVAGANGA,6503,3,BSP,0,M,TAMIL NADU,667208,664594,2614,1083542,523314,560228,0.6001613227729059,6503,0.9746585772352848
50,CHIDAMBARAM N,GEN,SIVAGANGA,4512,11,IND,0,M,TAMIL NADU,667208,664594,2614,1083542,523314,560228,0.41641210031544695,4512,0.676250884281963
33,CHIDAMBARAM S P,GEN,SIVAGANGA,1501,10,IND,2,M,TAMIL NADU,667208,664594,2614,1083542,523314,560228,0.13871174352263227,1503,0.22526708312849966
36,VENKATACHALAPATHI A R,GEN,SIVAGANGA,1486,4,RLD,1,M,TAMIL NADU,667208,664594,2614,1083542,523314,560228,0.1372351048690314,1487,0.22286903034735794
39,IRUDHAYARAJ,GEN,SIVAGANGA,1297,5,IND,1,M,TAMIL NADU,667208,664594,2614,1083542,523314,560228,0.11979231077337105,1298,0.19454203187012145
41,CHIDAMBARAM K,GEN,SIVAGANGA,1212,9,IND,3,M,TAMIL NADU,667208,664594,2614,1083542,523314,560228,0.11213224775781648,1215,0.18210213306794884
43,GUNASEKARAN P,GEN,SIVAGANGA,1067,7,IND,0,M,TAMIL NADU,667208,664594,2614,1083542,523314,560228,0.0984733402120084,1067,0.15992014484238798
48,SHANMUGAM C,GEN,SIVAGANGA,959,8,IND,2,M,TAMIL NADU,667208,664594,2614,1083542,523314,560228,0.08869060913190259,961,0.14403304516732415
67,KAAYAMBU V,GEN,SIVAGANGA,892,6,IND,0,M,TAMIL NADU,667208,664594,2614,1083542,523314,560228,0.08232260493824882,892,0.1336914425486505
49,BHAVANI RAJENTHIRAN M S K,GEN,RAMANATHAPURAM,332879,2,DMK,2408,F,TAMIL NADU,674387,671727,2660,1147726,565257,582469,29.21315714726337,335287,49.71729882100337
51,MURUGESAN C,GEN,RAMANATHAPURAM,225160,3,ADMK,177,M,TAMIL NADU,674387,671727,2660,1147726,565257,582469,19.633344543906823,225337,33.41360376163835
53,KANNAPPAN S,GEN,RAMANATHAPURAM,79444,4,JD(U),63,M,TAMIL NADU,674387,671727,2660,1147726,565257,582469,6.927350256071571,79507,11.789521446884356
43,VEERAYA T,GEN,RAMANATHAPURAM,6858,18,IND,0,M,TAMIL NADU,674387,671727,2660,1147726,565257,582469,0.5975293754781194,6858,1.0169235172089615
60,ALLAPICHAI E,GEN,RAMANATHAPURAM,5223,1,BSP,0,M,TAMIL NADU,674387,671727,2660,1147726,565257,582469,0.4550737719629947,5223,0.7744811213739292
44,MOHIDEEN ABDUL KADER M,GEN,RAMANATHAPURAM,3313,16,IND,1,M,TAMIL NADU,674387,671727,2660,1147726,565257,582469,0.28874487464778176,3314,0.491409235350029
31,SABAPATHY K,GEN,RAMANATHAPURAM,2764,5,SP,4,M,TAMIL NADU,674387,671727,2660,1147726,565257,582469,0.2411725446665842,2768,0.4104468205941099
37,MARIPITCHAI K,GEN,RAMANATHAPURAM,2456,15,IND,1,M,TAMIL NADU,674387,671727,2660,1147726,565257,582469,0.21407548491538922,2457,0.36433086640163587
35,TOOTHAI SELVAM M,GEN,RAMANATHAPURAM,2208,13,IND,1,M,TAMIL NADU,674387,671727,2660,1147726,565257,582469,0.19246754016202472,2209,0.32755672929638324
30,BOSE G,SC,RAMANATHAPURAM,2149,14,IND,1,M,TAMIL NADU,674387,671727,2660,1147726,565257,582469,0.18732694040215173,2150,0.3188080434527949
55,KARUPPAIAH P,SC,RAMANATHAPURAM,1750,8,IND,0,M,TAMIL NADU,674387,671727,2660,1147726,565257,582469,0.15247541660640257,1750,0.2594949190894842
56,MUTHUKKARUNGAN M,GEN,RAMANATHAPURAM,1558,17,IND,0,M,TAMIL NADU,674387,671727,2660,1147726,565257,582469,0.13574668518444297,1558,0.2310246193950951
29,ANKAJSAMY A,GEN,RAMANATHAPURAM,1323,6,IND,0,M,TAMIL NADU,674387,671727,2660,1147726,565257,582469,0.11527141495444035,1323,0.19617815883165007
33,DHANABALAN A,GEN,RAMANATHAPURAM,1040,12,IND,0,M,TAMIL NADU,674387,671727,2660,1147726,565257,582469,0.09061396186894781,1040,0.15421412334460777
27,KARUPPIYA P,GEN,RAMANATHAPURAM,965,7,IND,0,M,TAMIL NADU,674387,671727,2660,1147726,565257,582469,0.08407930115724485,965,0.143092912526487
30,SENGAIRAJU M,SC,RAMANATHAPURAM,941,10,IND,0,M,TAMIL NADU,674387,671727,2660,1147726,565257,582469,0.0819882097294999,941,0.13953412506468837
42,TAMILARASAN M,GEN,RAMANATHAPURAM,884,11,IND,2,M,TAMIL NADU,674387,671727,2660,1147726,565257,582469,0.07719612520758438,886,0.13137857046473317
30,SARAVANAMURUGAN M,GEN,RAMANATHAPURAM,812,9,IND,2,M,TAMIL NADU,674387,671727,2660,1147726,565257,582469,0.07092285092434954,814,0.12070220807933724
38,"RAVICHANDRAN, A",GEN,SIVAKASI,466677,1,MDMK,2395,M,TAMIL NADU,830643,828082,2561,1313594,638258,675336,35.70905470031075,469072,56.4709508176196
40,KANNAN P,GEN,SIVAKASI,304405,2,ADMK,150,M,TAMIL NADU,830643,828082,2561,1313594,638258,675336,23.18486533890989,304555,36.664969186521766
33,DHEEPA VALENTINA T,SC,SIVAKASI,27119,4,JD(U),11,F,TAMIL NADU,830643,828082,2561,1313594,638258,675336,2.065326120551708,27130,3.2661444206476187
28,VENKATESAN K,GEN,SIVAKASI,10156,14,IND,0,M,TAMIL NADU,830643,828082,2561,1313594,638258,675336,0.7731460405574325,10156,1.2226672589788874
51,MARIAPPAN M I,GEN,SIVAKASI,4088,13,IND,0,M,TAMIL NADU,830643,828082,2561,1313594,638258,675336,0.31120726799909254,4088,0.4921488533581816
66,PITCHAI THEVAR A,GEN,SIVAKASI,4084,12,IND,1,M,TAMIL NADU,830643,828082,2561,1313594,638258,675336,0.31097888693157855,4085,0.49178768736990497
44,JEYASEELAN S,SC,SIVAKASI,3847,3,BSP,0,M,TAMIL NADU,830643,828082,2561,1313594,638258,675336,0.292860655575467,3847,0.46313518563329853
50,GANESAN A,GEN,SIVAKASI,2156,5,IND,1,M,TAMIL NADU,830643,828082,2561,1313594,638258,675336,0.16420598754257404,2157,0.2596783455708409
57,THIAGARAJAN (ALIAS) YOGA NADAR P I D,GEN,SIVAKASI,1615,11,IND,1,M,TAMIL NADU,830643,828082,2561,1313594,638258,675336,0.12302126836754734,1616,0.1945480790183027
52,DHASTHAGEER M,GEN,SIVAKASI,901,10,IND,0,M,TAMIL NADU,830643,828082,2561,1313594,638258,675336,0.06859044727670803,901,0.10847018514572446
38,SETHURAJ P,GEN,SIVAKASI,824,9,IND,1,M,TAMIL NADU,830643,828082,2561,1313594,638258,675336,0.06280479356635307,825,0.0993206467760518
47,CHELLAPPA K,GEN,SIVAKASI,783,8,IND,1,M,TAMIL NADU,830643,828082,2561,1313594,638258,675336,0.05968358564366159,784,0.09438471160293893
39,KANNAN V,GEN,SIVAKASI,779,6,IND,0,M,TAMIL NADU,830643,828082,2561,1313594,638258,675336,0.05930295053113824,779,0.09378276828914467
51,SANKARAN M,GEN,SIVAKASI,648,7,IND,0,M,TAMIL NADU,830643,828082,2561,1313594,638258,675336,0.04933031058302641,648,0.07801185346773525
52,"DHANUSKODI ATHITHAN, R",GEN,TIRUNELVELI,367823,3,INC,2304,M,TAMIL NADU,633782,631284,2498,1086290,529102,557188,34.07257730440306,370127,58.399733662363396
37,"AMIRTHA GANESAN, R",GEN,TIRUNELVELI,202888,1,ADMK,164,M,TAMIL NADU,633782,631284,2498,1086290,529102,557188,18.692246085299505,203052,32.03814560842687
52,APPAVU M,GEN,TIRUNELVELI,39310,4,JD(U),23,M,TAMIL NADU,633782,631284,2498,1086290,529102,557188,3.620856309088733,39333,6.206077168490111
41,SRIDHAR BABU C,GEN,TIRUNELVELI,5774,14,IND,0,M,TAMIL NADU,633782,631284,2498,1086290,529102,557188,0.5315339366099292,5774,0.9110388114525183
41,KASIPANDIAN T,SC,TIRUNELVELI,3606,2,BSP,0,M,TAMIL NADU,633782,631284,2498,1086290,529102,557188,0.3319555551464158,3606,0.5689653540176276
33,THIRUMALAI NAMBI K,ST,TIRUNELVELI,1903,12,IND,1,M,TAMIL NADU,633782,631284,2498,1086290,529102,557188,0.175275478923676,1904,0.30041875597602963
59,"SHANMUGANATHAN, K G",GEN,TIRUNELVELI,1648,9,IND,2,M,TAMIL NADU,633782,631284,2498,1086290,529102,557188,0.15189314087398392,1650,0.26034188411788284
36,"MUTHUKUMAR, A",GEN,TIRUNELVELI,1518,13,IND,0,M,TAMIL NADU,633782,631284,2498,1086290,529102,557188,0.13974168960406522,1518,0.23951453338845216
33,SURESH S,GEN,TIRUNELVELI,1505,5,JP,0,M,TAMIL NADU,633782,631284,2498,1086290,529102,557188,0.13854495576687625,1505,0.2374633549075234
30,CHINNADURAI G,GEN,TIRUNELVELI,1383,10,IND,3,M,TAMIL NADU,633782,631284,2498,1086290,529102,557188,0.12759023833414648,1386,0.21868718265902154
33,SULAIMAN SAIT ALIM A,GEN,TIRUNELVELI,1355,11,IND,0,M,TAMIL NADU,633782,631284,2498,1086290,529102,557188,0.1247364884146959,1355,0.21379591089680677
57,KALYANA SUNTHARAM A,GEN,TIRUNELVELI,967,8,IND,1,M,TAMIL NADU,633782,631284,2498,1086290,529102,557188,0.08911064264607058,968,0.15273390534915793
45,"ARI PUTHIRAN, A",SC,TIRUNELVELI,820,6,IND,0,M,TAMIL NADU,633782,631284,2498,1086290,529102,557188,0.07548628819191928,820,0.1293820272585842
54,"RAJAGOPALAN, N",GEN,TIRUNELVELI,784,7,IND,0,M,TAMIL NADU,633782,631284,2498,1086290,529102,557188,0.07217225602739599,784,0.1237018406960122
51,"APPADURAI, M",SC,TENKASI (SC),345745,1,CPI,2255,M,TAMIL NADU,712150,709688,2462,1084708,529115,555593,32.08236686739657,348000,48.86610966790704
53,MURUGESAN S,SC,TENKASI (SC),225701,2,ADMK,123,M,TAMIL NADU,712150,709688,2462,1084708,529115,555593,20.81887475707748,225824,31.710173418521382
52,"KRISHNASAMY DR , K",SC,TENKASI (SC),101048,4,JD(U),74,M,TAMIL NADU,712150,709688,2462,1084708,529115,555593,9.322508914841599,101122,14.199536614477287
31,VADIVEL KUMAR M,SC,TENKASI (SC),14440,13,IND,1,M,TAMIL NADU,712150,709688,2462,1084708,529115,555593,1.3313260342875686,14441,2.027803131362775
33,LAKSHMANAN R,SC,TENKASI (SC),5599,12,IND,0,M,TAMIL NADU,712150,709688,2462,1084708,529115,555593,0.5161757818694064,5599,0.7862107702029066
43,LUKE JAYAKUMAR P,SC,TENKASI (SC),4756,3,BSP,3,M,TAMIL NADU,712150,709688,2462,1084708,529115,555593,0.438735585982587,4759,0.6682580916941656
40,CHANDRAN S,SC,TENKASI (SC),2448,5,JP,1,M,TAMIL NADU,712150,709688,2462,1084708,529115,555593,0.22577504729383394,2449,0.34388822579512746
46,RAMAKRISHNAN S,SC,TENKASI (SC),2285,11,IND,0,M,TAMIL NADU,712150,709688,2462,1084708,529115,555593,0.21065577095402635,2285,0.3208593695148494
71,BALASUNDARAM S,SC,TENKASI (SC),2150,10,IND,3,M,TAMIL NADU,712150,709688,2462,1084708,529115,555593,0.198486597314669,2153,0.30232394860633294
47,CHELLAMMAL A,SC,TENKASI (SC),1663,9,IND,0,F,TAMIL NADU,712150,709688,2462,1084708,529115,555593,0.15331314971402443,1663,0.23351821947623394
28,SARAVANAN T,SC,TENKASI (SC),1434,8,IND,2,M,TAMIL NADU,712150,709688,2462,1084708,529115,555593,0.1323858586827054,1436,0.20164291230780032
51,GOPALAKRISHNAN E,SC,TENKASI (SC),1378,7,IND,0,M,TAMIL NADU,712150,709688,2462,1084708,529115,555593,0.1270387975381393,1378,0.1934985606964825
55,AMIRTHA RAJ T,SC,TENKASI (SC),1041,6,IND,0,M,TAMIL NADU,712150,709688,2462,1084708,529115,555593,0.0959705284740225,1041,0.1461770694376185
28,RADHIKA SELVI V,GEN,TIRUCHENDUR,392308,3,DMK,2176,F,TAMIL NADU,631008,628693,2315,1031560,495885,535675,38.241498313234324,394484,62.516481566002334
51,THAMODARAN T,GEN,TIRUCHENDUR,212672,2,ADMK,131,M,TAMIL NADU,631008,628693,2315,1031560,495885,535675,20.629241149327232,212803,33.72429509610021
28,ZIYAD N M,GEN,TIRUCHENDUR,5128,18,IND,0,M,TAMIL NADU,631008,628693,2315,1031560,495885,535675,0.4971111714296793,5128,0.8126679851919468
33,RAMANATHAN S,SC,TIRUCHENDUR,4066,1,BSP,5,M,TAMIL NADU,631008,628693,2315,1031560,495885,535675,0.3946450036837411,4071,0.6451582230336224
53,AHAMED LEBBAI M M,GEN,TIRUCHENDUR,3297,4,IND,1,M,TAMIL NADU,631008,628693,2315,1031560,495885,535675,0.3197099538562953,3298,0.5226558141893606
60,MOHIDEEN S A,GEN,TIRUCHENDUR,2096,16,IND,0,M,TAMIL NADU,631008,628693,2315,1031560,495885,535675,0.20318740548295783,2096,0.33216694558547594
67,MANICKAVASAGAM,GEN,TIRUCHENDUR,1807,14,IND,0,M,TAMIL NADU,631008,628693,2315,1031560,495885,535675,0.17517158478421033,1807,0.28636720929053194
62,MOHAMUD YOUSUF P,GEN,TIRUCHENDUR,1385,15,IND,0,M,TAMIL NADU,631008,628693,2315,1031560,495885,535675,0.1342626701306759,1385,0.21949008570414322
70,RAMAKRISHANAN P,GEN,TIRUCHENDUR,934,17,IND,1,M,TAMIL NADU,631008,628693,2315,1031560,495885,535675,0.0906394199077126,935,0.1481756174248187
33,ANTONY ROSARY M,GEN,TIRUCHENDUR,685,5,IND,0,M,TAMIL NADU,631008,628693,2315,1031560,495885,535675,0.0664042808949552,685,0.10855646838074952
55,SADAKATHULLA S M,GEN,TIRUCHENDUR,652,8,IND,0,M,TAMIL NADU,631008,628693,2315,1031560,495885,535675,0.06320524254527124,652,0.1033267407069324
38,MANIYAN S S,GEN,TIRUCHENDUR,651,13,IND,0,M,TAMIL NADU,631008,628693,2315,1031560,495885,535675,0.06310830198922021,651,0.10316826411075612
40,KENNADY A,GEN,TIRUCHENDUR,596,7,IND,0,M,TAMIL NADU,631008,628693,2315,1031560,495885,535675,0.05777657140641359,596,0.0944520513210609
29,SELVAKUMAR V,GEN,TIRUCHENDUR,538,10,IND,0,M,TAMIL NADU,631008,628693,2315,1031560,495885,535675,0.052154019155453875,538,0.08526040874283686
72,THIYAGARAJ A,GEN,TIRUCHENDUR,515,11,IND,0,M,TAMIL NADU,631008,628693,2315,1031560,495885,535675,0.0499243863662802,515,0.0816154470307825
49,SIVANANNAINTHA PERUMAL R,GEN,TIRUCHENDUR,479,9,IND,0,M,TAMIL NADU,631008,628693,2315,1031560,495885,535675,0.04643452634844313,479,0.07591028956843653
54,BENJAMIN,GEN,TIRUCHENDUR,476,12,IND,0,M,TAMIL NADU,631008,628693,2315,1031560,495885,535675,0.04614370468029005,476,0.0754348597799077
59,ESTHER,GEN,TIRUCHENDUR,408,6,IND,1,M,TAMIL NADU,631008,628693,2315,1031560,495885,535675,0.03964868742487107,409,0.06481692783609716
49,BELLARMIN A V,GEN,NAGERCOIL,407073,2,CPM,3018,M,TAMIL NADU,673555,670197,3358,1110014,556476,553538,36.94466916633484,410091,60.884560280897624
52,RADHAKRISHNAN P,GEN,NAGERCOIL,245475,1,BJP,322,M,TAMIL NADU,673555,670197,3358,1110014,556476,553538,22.14359458529352,245797,36.492491333298695
37,BALASUBRAMANIAN T,GEN,NAGERCOIL,4610,3,ABHM,2,M,TAMIL NADU,673555,670197,3358,1110014,556476,553538,0.4154902550778639,4612,0.6847250781302194
55,GEORGE THOMAS R,GEN,NAGERCOIL,4516,11,IND,3,M,TAMIL NADU,673555,670197,3358,1110014,556476,553538,0.40711198237139357,4519,0.6709177424263795
58,JAMALUDHEEN B,GEN,NAGERCOIL,3336,10,IND,0,M,TAMIL NADU,673555,670197,3358,1110014,556476,553538,0.3005367499869371,3336,0.4952824936345213
31,SIVAKUMAR B,SC,NAGERCOIL,1754,5,IND,4,M,TAMIL NADU,673555,670197,3358,1110014,556476,553538,0.15837638083843986,1758,0.2610031845951704
52,MURUGAN V N,GEN,NAGERCOIL,1618,9,IND,0,M,TAMIL NADU,673555,670197,3358,1110014,556476,553538,0.1457639273018178,1618,0.24021794805175523
55,MANIKANTA PRASAD M,GEN,NAGERCOIL,713,4,SHS,4,M,TAMIL NADU,673555,670197,3358,1110014,556476,553538,0.06459377989827156,717,0.10645010429734766
39,PRABHAKARAN K,SC,NAGERCOIL,400,8,IND,1,M,TAMIL NADU,673555,670197,3358,1110014,556476,553538,0.0361256704870389,401,0.059534856099353425
27,SUBASH P,SC,NAGERCOIL,352,6,IND,3,M,TAMIL NADU,673555,670197,3358,1110014,556476,553538,0.03198157861072023,355,0.05270542123508845
45,THANKAMONY C,GEN,NAGERCOIL,350,7,IND,1,M,TAMIL NADU,673555,670197,3358,1110014,556476,553538,0.03162122279538816,351,0.052111557333848015
64,KHAGEN DAS,GEN,TRIPURA WEST,493591,2,CPM,3252,M,TRIPURA,701159,697530,3629,1041596,539530,502066,47.70016397912434,496843,70.8602471051502
53,NIRMALA DASGUPTA,GEN,TRIPURA WEST,112022,3,INC,185,M,TRIPURA,701159,697530,3629,1041596,539530,502066,10.77260281337486,112207,16.00307490882952
52,AMAL MALLIK,GEN,TRIPURA WEST,67211,1,AITC,168,M,TRIPURA,701159,697530,3629,1041596,539530,502066,6.4688228449418,67379,9.609660576274425
32,RAMU BANIK,GEN,TRIPURA WEST,10786,6,IND,1,M,TRIPURA,701159,697530,3629,1041596,539530,502066,1.0356222566138888,10787,1.538452761784417
57,BRAJALAL DEBNATH,GEN,TRIPURA WEST,7016,5,IND,7,M,TRIPURA,701159,697530,3629,1041596,539530,502066,0.6742537413738148,7023,1.0016273056467933
55,RAKHALRAJ DATTA,GEN,TRIPURA WEST,6904,4,AMB,16,M,TRIPURA,701159,697530,3629,1041596,539530,502066,0.6643650705263845,6920,0.9869373423146532
59,BAJU BAN RIYAN,ST,TRIPURA EAST (ST),411241,2,CPM,2989,M,TRIPURA,623094,619546,3548,936626,483838,452788,44.22576353848815,414230,66.47953599296414
63,PULIN BIHARI DEWAN,ST,TRIPURA EAST (ST),103216,1,BJP,278,M,TRIPURA,623094,619546,3548,936626,483838,452788,11.049661230843475,103494,16.60969291952739
56,JADU MOHAN TRIPURA,ST,TRIPURA EAST (ST),76679,3,INC,248,M,TRIPURA,623094,619546,3548,936626,483838,452788,8.213203562574604,76927,12.345970270938253
46,DIJA RAJ TRIPURA,ST,TRIPURA EAST (ST),14025,6,IND,2,M,TRIPURA,623094,619546,3548,936626,483838,452788,1.4976095047542988,14027,2.2511852144299254
30,KARNA DHAN CHAKMA,ST,TRIPURA EAST (ST),7926,4,AMB,15,M,TRIPURA,623094,619546,3548,936626,483838,452788,0.8478304040246588,7941,1.274446552205606
50,CHARAI MUNI JAMATIA,ST,TRIPURA EAST (ST),6459,5,CPI(ML)(L),16,M,TRIPURA,623094,619546,3548,936626,483838,452788,0.6913111530109137,6475,1.0391690499346806
53,MUNSHIRAM S/O SRI RAMCHARAN SINGH,SC,BIJNOR (SC),301597,3,RLD,2,M,UTTAR PRADESH,705737,705729,8,1355437,729667,625770,22.25105261255226,301599,42.735324915655546
43,GHAN SHYAM CHANDR KHARWAR,SC,BIJNOR (SC),221421,1,BSP,3,M,UTTAR PRADESH,705737,705729,8,1355437,729667,625770,16.335986106325855,221424,31.374860606713266
48,SHEESH RAM SINGH RAVI,SC,BIJNOR (SC),101338,4,BJP,2,M,UTTAR PRADESH,705737,705729,8,1355437,729667,625770,7.476555531537062,101340,14.359456851490002
61,JIRAJ SINGH,SC,BIJNOR (SC),32395,2,INC,1,M,UTTAR PRADESH,705737,705729,8,1355437,729667,625770,2.390077886320058,32396,4.5903785687869565
36,MUNSHIRAM S/O SHRI MAKHHAN,SC,BIJNOR (SC),9191,16,IND,0,M,UTTAR PRADESH,705737,705729,8,1355437,729667,625770,0.6780838947143983,9191,1.3023265040659622
27,SURAJ KUMAR,SC,BIJNOR (SC),6634,11,MUL,0,M,UTTAR PRADESH,705737,705729,8,1355437,729667,625770,0.48943624823580884,6634,0.9400102304399515
64,HARKES SINGH,SC,BIJNOR (SC),5672,12,PHSP,0,M,UTTAR PRADESH,705737,705729,8,1355437,729667,625770,0.41846282785551814,5672,0.8036988283170643
33,MAHENDER KUMAR,SC,BIJNOR (SC),5113,7,MC,0,M,UTTAR PRADESH,705737,705729,8,1355437,729667,625770,0.37722151601291687,5113,0.7244908514078191
43,MAN SINGH ASHOK,SC,BIJNOR (SC),3662,15,IND,0,M,UTTAR PRADESH,705737,705729,8,1355437,729667,625770,0.27017116988838286,3662,0.5188901814698677
35,JAI MALA,SC,BIJNOR (SC),3622,14,IND,0,F,UTTAR PRADESH,705737,705729,8,1355437,729667,625770,0.2672200921178926,3622,0.5132223477017642
48,VIJAY SINGH,SC,BIJNOR (SC),3268,9,BKD,0,M,UTTAR PRADESH,705737,705729,8,1355437,729667,625770,0.24110305384905384,3268,0.46306201885404896
62,SATYA NARAYAN,SC,BIJNOR (SC),3173,10,RPI(A),0,M,UTTAR PRADESH,705737,705729,8,1355437,729667,625770,0.2340942441441395,3173,0.44960091365480337
46,UDIT RAJ,SC,BIJNOR (SC),2995,5,IJP,0,M,UTTAR PRADESH,705737,705729,8,1355437,729667,625770,0.22096194806545785,2995,0.4243790533867432
40,GHAN SHYAM,SC,BIJNOR (SC),2362,13,IND,0,M,UTTAR PRADESH,705737,705729,8,1355437,729667,625770,0.17426114234744958,2362,0.33468558400650666
48,BHISHAN PARSAD,SC,BIJNOR (SC),2314,6,BRPP,0,M,UTTAR PRADESH,705737,705729,8,1355437,729667,625770,0.17071984902286125,2314,0.32788418348478254
32,RATAN SINGH,SC,BIJNOR (SC),972,8,IBSP,0,M,UTTAR PRADESH,705737,705729,8,1355437,729667,625770,0.0717111898229132,972,0.137728360564913
35,HARISH NAGPAL,GEN,AMROHA,287521,16,IND,1,M,UTTAR PRADESH,885159,885155,4,1342541,721579,620962,21.416254699111608,287522,32.48252573831368
36,MAHMOOD MADNI,GEN,AMROHA,269638,3,RLD,0,M,UTTAR PRADESH,885159,885155,4,1342541,721579,620962,20.084153854519155,269638,30.462097770005165
53,ALEY HASAN,GEN,AMROHA,168698,1,BSP,0,M,UTTAR PRADESH,885159,885155,4,1342541,721579,620962,12.565575278520358,168698,19.0584968350319
50,CHETAN CHAUHAN,GEN,AMROHA,130516,2,BJP,3,M,UTTAR PRADESH,885159,885155,4,1342541,721579,620962,9.721788757289348,130519,14.745260456031065
63,VIKRAM SINGH,GEN,AMROHA,7949,4,INC,0,M,UTTAR PRADESH,885159,885155,4,1342541,721579,620962,0.5920862007193821,7949,0.8980307492778135
31,SANJAY,GEN,AMROHA,6040,14,IND,0,M,UTTAR PRADESH,885159,885155,4,1342541,721579,620962,0.4498931503767855,6040,0.6823632816251092
44,SARFARAJ AHMAD,GEN,AMROHA,4074,15,IND,0,M,UTTAR PRADESH,885159,885155,4,1342541,721579,620962,0.30345441964156034,4074,0.4602562929372011
34,RANVEER,GEN,AMROHA,2358,11,IND,0,M,UTTAR PRADESH,885159,885155,4,1342541,721579,620962,0.1756370941371623,2358,0.2663928175615906
40,RAMESH SINGH,SC,AMROHA,1579,12,IND,0,M,UTTAR PRADESH,885159,885155,4,1342541,721579,620962,0.11761279543790468,1579,0.1783860300804714
48,SHAVEER,GEN,AMROHA,1246,13,IND,0,M,UTTAR PRADESH,885159,885155,4,1342541,721579,620962,0.09280908367044284,1246,0.14076567034849108
50,NASIM KHAN,GEN,AMROHA,1203,7,RJD,0,M,UTTAR PRADESH,885159,885155,4,1342541,721579,620962,0.08960620197074057,1203,0.13590778605877588
30,MATLUB,GEN,AMROHA,1108,8,RSBP,0,M,UTTAR PRADESH,885159,885155,4,1342541,721579,620962,0.08253006798302621,1108,0.1251752510001028
31,NARENDRA SANI,GEN,AMROHA,962,6,SHS,0,M,UTTAR PRADESH,885159,885155,4,1342541,721579,620962,0.07165516732822312,962,0.10868103922572103
43,JABAR SINGH,GEN,AMROHA,942,5,IJP,0,M,UTTAR PRADESH,885159,885155,4,1342541,721579,620962,0.07016545490975695,942,0.10642155816073721
63,YAD RAM,GEN,AMROHA,676,9,LP(S),0,M,UTTAR PRADESH,885159,885155,4,1342541,721579,620962,0.05035227974415679,676,0.07637045999645262
37,NARESH,GEN,AMROHA,645,10,IND,0,M,UTTAR PRADESH,885159,885155,4,1342541,721579,620962,0.04804322549553421,645,0.07286826434572771
70,DR SHAFIQURRAHMAN BARQ,GEN,MORADABAD,218079,3,SP,0,M,UTTAR PRADESH,655175,655173,2,1353266,734666,618600,16.11501360412513,218079,33.28561071469455
51,CHANDRA VIJAY SINGH URF BABY RAJA,GEN,MORADABAD,182237,2,BJP,2,M,UTTAR PRADESH,655175,655173,2,1353266,734666,618600,13.466605973991811,182239,27.815316518487425
53,IFTAKAR MOHAMMAD KHAN,GEN,MORADABAD,150616,1,BSP,0,M,UTTAR PRADESH,655175,655173,2,1353266,734666,618600,11.129814833151796,150616,22.988667149998093
50,DR MASOOD AHMAD,GEN,MORADABAD,42018,5,NLP,0,M,UTTAR PRADESH,655175,655173,2,1353266,734666,618600,3.104932807001728,42018,6.413248368756438
50,PARMESHWAR LAL,GEN,MORADABAD,38170,11,IND,0,M,UTTAR PRADESH,655175,655173,2,1353266,734666,618600,2.8205836842128598,38170,5.8259243713511655
26,MOHD SALIM,GEN,MORADABAD,6764,14,IND,0,M,UTTAR PRADESH,655175,655173,2,1353266,734666,618600,0.4998278239459204,6764,1.0323959247529286
35,ASHA PAL,GEN,MORADABAD,5479,4,LP(S),0,F,UTTAR PRADESH,655175,655173,2,1353266,734666,618600,0.4048723606445444,5479,0.8362651200061053
40,RAJESH SAINI,GEN,MORADABAD,2860,7,SHS,0,M,UTTAR PRADESH,655175,655173,2,1353266,734666,618600,0.21134056423496936,2860,0.4365245926660816
31,MOHD NASIR,GEN,MORADABAD,2212,6,INLD,0,M,UTTAR PRADESH,655175,655173,2,1353266,734666,618600,0.16345640842229098,2212,0.3376197199221582
30,BRAHM DEV,SC,MORADABAD,2156,13,IND,0,M,UTTAR PRADESH,655175,655173,2,1353266,734666,618600,0.15931827150020764,2156,0.3290723852405846
46,FAEEM AKHTAR,GEN,MORADABAD,1548,12,IND,0,F,UTTAR PRADESH,655175,655173,2,1353266,734666,618600,0.11438992777473166,1548,0.23627275155492805
47,NUTAN VIJAY,GEN,MORADABAD,1168,10,IND,0,M,UTTAR PRADESH,655175,655173,2,1353266,734666,618600,0.08630971294630915,1168,0.17827298050139276
25,JAY PRAKASH,GEN,MORADABAD,989,9,IND,0,M,UTTAR PRADESH,655175,655173,2,1353266,734666,618600,0.07308245385607855,989,0.15095203571564847
26,AZAM ANSARI,GEN,MORADABAD,877,8,IND,0,M,UTTAR PRADESH,655175,655173,2,1353266,734666,618600,0.06480618001191192,877,0.13385736635250123
42,P JAYA PRADA NAHATA,GEN,RAMPUR,289389,2,SP,1,F,UTTAR PRADESH,810596,810586,10,1420598,758706,661892,20.370998692100088,289390,35.70089168957162
64,BAGUM NOOR BANO ALIAS MEHTAB ZAMANI,GEN,RAMPUR,203912,3,INC,4,F,UTTAR PRADESH,810596,810586,10,1420598,758706,661892,14.354236736923465,203916,25.156304743670088
46,AFROZ ALI KHAN,GEN,RAMPUR,126405,1,BSP,1,M,UTTAR PRADESH,810596,810586,10,1420598,758706,661892,8.898083764724433,126406,15.594204757980549
63,RAJENDRA KUMAR SHARMA,GEN,RAMPUR,121781,4,BJP,4,M,UTTAR PRADESH,810596,810586,10,1420598,758706,661892,8.572798215962575,121785,15.024130392945438
51,SHIV BAHADUR SAXENA,GEN,RAMPUR,27434,11,JP,0,M,UTTAR PRADESH,810596,810586,10,1420598,758706,661892,1.9311585684338568,27434,3.3844233132164483
40,NAND KISHOR,SC,RAMPUR,6077,16,IND,0,M,UTTAR PRADESH,810596,810586,10,1420598,758706,661892,0.42777759788483444,6077,0.7496952859377545
32,GHAN SHYAM SINGH,SC,RAMPUR,4632,15,IND,0,M,UTTAR PRADESH,810596,810586,10,1420598,758706,661892,0.3260598705615523,4632,0.571431391223248
53,RAIS AHMAD,GEN,RAMPUR,4332,17,IND,0,M,UTTAR PRADESH,810596,810586,10,1420598,758706,661892,0.304942003297203,4332,0.5344215860922087
30,ANURAG,GEN,RAMPUR,4090,5,SHS,0,M,UTTAR PRADESH,810596,810586,10,1420598,758706,661892,0.2879069237039613,4090,0.5045670099531703
30,MOHD REHAN,GEN,RAMPUR,3901,19,IND,0,M,UTTAR PRADESH,810596,810586,10,1420598,758706,661892,0.2746026673274213,3901,0.4812508327206155
32,KAUSHAL KUMAR,GEN,RAMPUR,3720,14,IND,0,M,UTTAR PRADESH,810596,810586,10,1420598,758706,661892,0.2618615540779306,3720,0.45892158362488833
64,KALLU,GEN,RAMPUR,3692,13,IND,0,M,UTTAR PRADESH,810596,810586,10,1420598,758706,661892,0.259890553133258,3692,0.45546733514599136
32,RAZA SHAN KHAN,GEN,RAMPUR,3031,18,IND,0,M,UTTAR PRADESH,810596,810586,10,1420598,758706,661892,0.21336085226080848,3031,0.3739223978406012
34,VEENA SAGAR,SC,RAMPUR,1748,10,AD,0,F,UTTAR PRADESH,810596,810586,10,1420598,758706,661892,0.1230467732602749,1748,0.21564379789685614
39,NOOR MOHAMMAD,GEN,RAMPUR,1724,8,JD(S),0,M,UTTAR PRADESH,810596,810586,10,1420598,758706,661892,0.12135734387912694,1724,0.21268301348637297
30,AMAR SINGH GAUTAM,SC,RAMPUR,1472,12,IND,0,M,UTTAR PRADESH,810596,810586,10,1420598,758706,661892,0.1036183353770736,1472,0.1815947771762999
37,MAHAVIR SINGH,GEN,RAMPUR,1347,9,LP(S),0,M,UTTAR PRADESH,810596,810586,10,1420598,758706,661892,0.09481922401692808,1347,0.16617402503836684
48,GURNAM SINGH,GEN,RAMPUR,1084,6,IJP,0,M,UTTAR PRADESH,810596,810586,10,1420598,758706,661892,0.07630589371518191,1084,0.13372876254015564
39,GOMTI,GEN,RAMPUR,815,7,RPD,0,F,UTTAR PRADESH,810596,810586,10,1420598,758706,661892,0.057370206068148764,815,0.10054330393932365
56,PRO RAM GOPAL YADAV,GEN,SAMBHAL,357047,4,SP,2,M,UTTAR PRADESH,759384,759382,2,1249017,678959,570058,28.58640034523149,357049,47.01824110068161
38,TARANNUM AQEEL,GEN,SAMBHAL,158988,3,BSP,0,F,UTTAR PRADESH,759384,759382,2,1249017,678959,570058,12.729050125018315,158988,20.936443222401316
51,DHARAMPAL YADAV D P YADAV,GEN,SAMBHAL,137273,5,RPD,0,M,UTTAR PRADESH,759384,759382,2,1249017,678959,570058,10.990482915764957,137273,18.07688863605238
28,OMVEER SINGH,GEN,SAMBHAL,74815,2,BJP,0,M,UTTAR PRADESH,759384,759382,2,1249017,678959,570058,5.989910465590141,74815,9.852064304752272
45,ASHOK YADAV,GEN,SAMBHAL,12063,1,INC,0,M,UTTAR PRADESH,759384,759382,2,1249017,678959,570058,0.96579950473052,12063,1.5885243829208937
43,HABIBURREHMAN,GEN,SAMBHAL,5836,14,IND,0,M,UTTAR PRADESH,759384,759382,2,1249017,678959,570058,0.46724744338948154,5836,0.7685176406139713
32,AJAY,SC,SAMBHAL,2544,8,IND,0,M,UTTAR PRADESH,759384,759382,2,1249017,678959,570058,0.2036801740889035,2544,0.33500837520938026
38,SHAQEEL ALLAM SAIFI,GEN,SAMBHAL,2224,7,NBNP,0,M,UTTAR PRADESH,759384,759382,2,1249017,678959,570058,0.1780600264047647,2224,0.2928689569440494
47,BHAGWAN SAHAY,GEN,SAMBHAL,1952,6,RSBP,0,M,UTTAR PRADESH,759384,759382,2,1249017,678959,570058,0.15628290087324673,1952,0.2570504514185182
28,BHUVNESH,GEN,SAMBHAL,1756,12,IND,0,M,UTTAR PRADESH,759384,759382,2,1249017,678959,570058,0.1405905604167117,1756,0.231240057731003
28,MANOJ,GEN,SAMBHAL,1743,13,IND,0,M,UTTAR PRADESH,759384,759382,2,1249017,678959,570058,0.13954974191704356,1743,0.22952814386397397
42,NOOR MUHAMMAD KURESHI,GEN,SAMBHAL,1171,11,IND,0,M,UTTAR PRADESH,759384,759382,2,1249017,678959,570058,0.09375372793164544,1171,0.15420393371469507
33,TOUSEEF MU KHAN,GEN,SAMBHAL,1030,9,IND,0,M,UTTAR PRADESH,759384,759382,2,1249017,678959,570058,0.08246485035832178,1030,0.13563625254153366
40,NARESH KUMAR SHARMA,GEN,SAMBHAL,940,10,IND,0,M,UTTAR PRADESH,759384,759382,2,1249017,678959,570058,0.07525918382215775,940,0.12378454115440937
51,SALEEM IQBAL SHERVANI,GEN,BUDAUN,265712,4,SP,1,M,UTTAR PRADESH,590009,590006,3,1200435,661174,539261,22.13472616176636,265713,45.03541471401284
49,BRIJPAL SINGH SHAKYA,GEN,BUDAUN,214389,2,BJP,2,M,UTTAR PRADESH,590009,590006,3,1200435,661174,539261,17.85944261871738,214391,36.33690333537285
53,PREM PAL SINGH YADAV,GEN,BUDAUN,75886,1,BSP,0,M,UTTAR PRADESH,590009,590006,3,1200435,661174,539261,6.321541774440098,75886,12.861837700780834
36,MAHBOOB HUSAIN ANSARI,GEN,BUDAUN,20359,3,INC,0,M,UTTAR PRADESH,590009,590006,3,1200435,661174,539261,1.6959685447358666,20359,3.450625329444127
39,RAO GOVIND SINGH YADAV,GEN,BUDAUN,4532,9,IND,0,M,UTTAR PRADESH,590009,590006,3,1200435,661174,539261,0.3775298121097769,4532,0.7681238760764666
40,ANOOP SAXENA,GEN,BUDAUN,2929,5,JP,0,M,UTTAR PRADESH,590009,590006,3,1200435,661174,539261,0.24399488518745288,2929,0.4964331052577164
38,RAJENDRA SINGH PAL,GEN,BUDAUN,2481,6,LP(S),0,M,UTTAR PRADESH,590009,590006,3,1200435,661174,539261,0.20667508028339726,2481,0.4205020601380656
37,HULASI,GEN,BUDAUN,2146,8,ASP,0,M,UTTAR PRADESH,590009,590006,3,1200435,661174,539261,0.1787685297413021,2146,0.3637232652383269
49,RIYASAT KHAN,GEN,BUDAUN,1572,7,SAP,0,M,UTTAR PRADESH,590009,590006,3,1200435,661174,539261,0.13095252970798085,1572,0.2664366136787744
49,KUNWAR SARVRAJ SINGH,GEN,AONLA,153322,7,JD(U),0,M,UTTAR PRADESH,536458,536458,0,1145865,639436,506429,13.380459303670152,153322,28.580429409198853
65,RAJVEER SINGH,GEN,AONLA,146451,3,SP,0,M,UTTAR PRADESH,536458,536458,0,1145865,639436,506429,12.78082496629184,146451,27.299620846366352
35,SUDHIR KUMAR MAURYA,GEN,AONLA,142198,4,BSP,0,M,UTTAR PRADESH,536458,536458,0,1145865,639436,506429,12.409664314731666,142198,26.50682812074757
45,ALAUDDEEN KHAN,GEN,AONLA,47973,1,INC,0,M,UTTAR PRADESH,536458,536458,0,1145865,639436,506429,4.1866188425338065,47973,8.942545362358285
32,JAI PAL SINGH,GEN,AONLA,17379,11,IND,0,M,UTTAR PRADESH,536458,536458,0,1145865,639436,506429,1.5166708120066499,17379,3.239582595468797
47,NANHE LAL,GEN,AONLA,8656,2,NCP,0,M,UTTAR PRADESH,536458,536458,0,1145865,639436,506429,0.7554118504361335,8656,1.6135466336600444
31,MAHARAJ SINGH,GEN,AONLA,7132,12,IND,0,M,UTTAR PRADESH,536458,536458,0,1145865,639436,506429,0.6224118897077753,7132,1.3294610202476242
45,ANIL KUMAR,GEN,AONLA,4152,8,IND,0,M,UTTAR PRADESH,536458,536458,0,1145865,639436,506429,0.362346349700881,4152,0.7739655294543095
25,VINOD KUMAR,SC,AONLA,2901,5,ASP,0,M,UTTAR PRADESH,536458,536458,0,1145865,639436,506429,0.2531711850872485,2901,0.5407692680508073
38,SHYAM SINGH,GEN,AONLA,2563,6,RKSP,0,M,UTTAR PRADESH,536458,536458,0,1145865,639436,506429,0.22367381846901685,2563,0.4777634036588139
36,KUNWAR SEN,GEN,AONLA,1937,10,IND,0,M,UTTAR PRADESH,536458,536458,0,1145865,639436,506429,0.16904260100448135,1937,0.36107206901565453
58,KALAWATI,GEN,AONLA,1794,9,IND,0,F,UTTAR PRADESH,536458,536458,0,1145865,639436,506429,0.15656294589676795,1794,0.3344157417728881
54,SANTOSH GANGWAR,GEN,BAREILLY,269643,4,BJP,8,M,UTTAR PRADESH,822848,822839,9,1556024,849295,706729,17.329488491180083,269651,32.77045092167691
57,AKBAR AHMED DEMPI,GEN,BAREILLY,210007,1,BSP,0,M,UTTAR PRADESH,822848,822839,9,1556024,849295,706729,13.496385659861287,210007,25.521967605195613
47,PRAVEEN SINGH ARON,GEN,BAREILLY,191342,3,INC,0,M,UTTAR PRADESH,822848,822839,9,1556024,849295,706729,12.296854033099747,191342,23.253626429182546
48,ISLAM SABIR,GEN,BAREILLY,120473,2,SP,1,M,UTTAR PRADESH,822848,822839,9,1556024,849295,706729,7.742425566700771,120474,14.641100178890875
31,HARI OM SINGH,SC,BAREILLY,9450,15,IND,0,M,UTTAR PRADESH,822848,822839,9,1556024,849295,706729,0.6073171107900649,9450,1.1484502605584508
41,SAKIR HUSAIN,GEN,BAREILLY,3671,14,IND,0,M,UTTAR PRADESH,822848,822839,9,1556024,849295,706729,0.23592181097463794,3671,0.4461334292603252
33,OMKAR SINGH,SC,BAREILLY,3144,8,IND,0,M,UTTAR PRADESH,822848,822839,9,1556024,849295,706729,0.20205343876444065,3144,0.382087578750875
60,GULJARI LAL,SC,BAREILLY,3069,5,NSP,0,M,UTTAR PRADESH,822848,822839,9,1556024,849295,706729,0.19723346169467823,3069,0.37297289414326823
47,NEM CHANDRA,GEN,BAREILLY,3005,6,AD,0,M,UTTAR PRADESH,822848,822839,9,1556024,849295,706729,0.19312041459514764,3005,0.36519502994477715
48,SHAKEEL AHMAD ANSARI,GEN,BAREILLY,2659,13,IND,0,M,UTTAR PRADESH,822848,822839,9,1556024,849295,706729,0.17088425371331034,2659,0.3231459516216847
26,YOGENDRA PATEL,GEN,BAREILLY,2444,12,IND,0,M,UTTAR PRADESH,822848,822839,9,1556024,849295,706729,0.15706698611332473,2444,0.2970171890798787
25,VRAHASPATI GIRI,GEN,BAREILLY,1450,7,SHS,0,M,UTTAR PRADESH,822848,822839,9,1556024,849295,706729,0.09318622334874012,1450,0.17621723574706386
26,JANISH,GEN,BAREILLY,987,11,IND,0,M,UTTAR PRADESH,822848,822839,9,1556024,849295,706729,0.06343089823807345,987,0.11994924943610485
67,CHHADAMMI LAL SAGAR,SC,BAREILLY,807,10,IND,0,M,UTTAR PRADESH,822848,822839,9,1556024,849295,706729,0.05186295327064364,807,0.09807400637784865
63,CHIRAUNJI LAL,SC,BAREILLY,688,9,IND,0,M,UTTAR PRADESH,822848,822839,9,1556024,849295,706729,0.04421525631995393,688,0.08361204013377926
47,MANEKA GANDHI,GEN,PILIBHIT,255611,2,BJP,4,F,UTTAR PRADESH,677107,677096,11,1285919,689992,595927,19.878001647071084,255615,37.751049686386345
42,SATYAPAL GANGWAR,GEN,PILIBHIT,152890,3,SP,5,M,UTTAR PRADESH,677107,677096,11,1285919,689992,595927,11.889940190634091,152895,22.58062610488446
40,ANIS AHMAD KHAN ALIAS PHOOL BABU,GEN,PILIBHIT,121267,1,BSP,2,M,UTTAR PRADESH,677107,677096,11,1285919,689992,595927,9.43053178310609,121269,17.909872442612468
43,V M SINGH,GEN,PILIBHIT,106186,4,INC,0,M,UTTAR PRADESH,677107,677096,11,1285919,689992,595927,8.257596318275102,106186,15.68230722766121
38,KRISHNA ADHIKARI,GEN,PILIBHIT,11804,5,CPI(ML)(L),0,F,UTTAR PRADESH,677107,677096,11,1285919,689992,595927,0.9179427320072259,11804,1.743299064992682
38,MOTIRAM RAJPUT,GEN,PILIBHIT,11027,14,IND,0,M,UTTAR PRADESH,677107,677096,11,1285919,689992,595927,0.8575190194716774,11027,1.6285461529713916
28,MAHENDRA SINGH,GEN,PILIBHIT,4967,13,IND,0,M,UTTAR PRADESH,677107,677096,11,1285919,689992,595927,0.3862607209318783,4967,0.7335620514926001
39,SATYENDRA,GEN,PILIBHIT,3194,9,AD,0,M,UTTAR PRADESH,677107,677096,11,1285919,689992,595927,0.24838267418087764,3194,0.4717127425945973
39,BABU RAM,SC,PILIBHIT,2272,12,IND,0,M,UTTAR PRADESH,677107,677096,11,1285919,689992,595927,0.17668297925452536,2272,0.33554519448181747
35,PARAMJEET SHARMA,GEN,PILIBHIT,2203,11,IND,0,M,UTTAR PRADESH,677107,677096,11,1285919,689992,595927,0.17131716694441876,2203,0.3253547814451778
31,KULBINDER SINGH,GEN,PILIBHIT,2030,10,IND,0,M,UTTAR PRADESH,677107,677096,11,1285919,689992,595927,0.15786375347125287,2030,0.29980490528084924
43,PURANLAL,SC,PILIBHIT,1363,6,RSBP,0,M,UTTAR PRADESH,677107,677096,11,1285919,689992,595927,0.1059942344735555,1363,0.2012975792599988
40,MAHAVIR SINGH,GEN,PILIBHIT,1251,8,ABRS,0,M,UTTAR PRADESH,677107,677096,11,1285919,689992,595927,0.09728451014410705,1251,0.18475661896864157
37,MANOHAR LAL,SC,PILIBHIT,1031,7,EKD(UP),0,M,UTTAR PRADESH,677107,677096,11,1285919,689992,595927,0.08017612306840477,1031,0.15226544696776137
30,KUNWAR JITIN PRASAD,GEN,SHAHJAHANPUR,220763,1,INC,0,M,UTTAR PRADESH,633853,633853,0,1240983,645811,595172,17.78936536600421,220763,34.82873789348634
55,RAM MURTI SINGH VERMA,GEN,SHAHJAHANPUR,138931,2,SP,0,M,UTTAR PRADESH,633853,633853,0,1240983,645811,595172,11.195237968610368,138931,21.91848898719419
58,SATYA PAL SINGH YADAV,GEN,SHAHJAHANPUR,127472,3,BSP,0,M,UTTAR PRADESH,633853,633853,0,1240983,645811,595172,10.271857068146783,127472,20.110656571791882
50,SURESH KUMAR KHANNA,GEN,SHAHJAHANPUR,103541,5,BJP,0,M,UTTAR PRADESH,633853,633853,0,1240983,645811,595172,8.343466429435376,103541,16.335175505992712
43,MOH SALEEM,GEN,SHAHJAHANPUR,7492,4,CPI,0,M,UTTAR PRADESH,633853,633853,0,1240983,645811,595172,0.6037149582226348,7492,1.1819775247573174
48,AJAY PAL,GEN,SHAHJAHANPUR,5189,6,PSJP,0,M,UTTAR PRADESH,633853,633853,0,1240983,645811,595172,0.418136267781267,5189,0.8186440704705981
43,PRAMOD,SC,SHAHJAHANPUR,4503,16,IND,0,M,UTTAR PRADESH,633853,633853,0,1240983,645811,595172,0.3628575089263914,4503,0.71041708408732
43,MAHESH SAXENA,GEN,SHAHJAHANPUR,3746,17,IND,0,M,UTTAR PRADESH,633853,633853,0,1240983,645811,595172,0.3018574791113174,3746,0.5909887623786587
43,D R VERMA,SC,SHAHJAHANPUR,2224,10,AD,0,M,UTTAR PRADESH,633853,633853,0,1240983,645811,595172,0.17921276923213292,2224,0.3508699966711525
41,RAM RAKCH PAL,GEN,SHAHJAHANPUR,2128,8,LP(S),0,M,UTTAR PRADESH,633853,633853,0,1240983,645811,595172,0.17147696624369552,2128,0.33572452918894446
38,SURENDRA NATH,GEN,SHAHJAHANPUR,1771,26,IND,0,M,UTTAR PRADESH,633853,633853,0,1240983,645811,595172,0.14270944888044396,1771,0.2794023219894834
25,DESH RAJ,SC,SHAHJAHANPUR,1690,15,IND,0,M,UTTAR PRADESH,633853,633853,0,1240983,645811,595172,0.13618236510894993,1690,0.2666233338013703
33,UDIT YADAV,GEN,SHAHJAHANPUR,1605,14,IND,0,M,UTTAR PRADESH,633853,633853,0,1240983,645811,595172,0.12933295621293764,1605,0.2532132844681653
38,MUNESHWAR,SC,SHAHJAHANPUR,1523,18,IND,0,M,UTTAR PRADESH,633853,633853,0,1240983,645811,595172,0.12272529116031405,1523,0.24027653099377932
29,ASHOK,SC,SHAHJAHANPUR,1478,12,IND,0,M,UTTAR PRADESH,633853,633853,0,1240983,645811,595172,0.119099133509484,1478,0.2331770931114943
30,RAKESH KUMAR,SC,SHAHJAHANPUR,1478,19,IND,0,M,UTTAR PRADESH,633853,633853,0,1240983,645811,595172,0.119099133509484,1478,0.2331770931114943
43,DR AMAR SINGH KUSHWAHA,GEN,SHAHJAHANPUR,1200,11,IND,0,M,UTTAR PRADESH,633853,633853,0,1240983,645811,595172,0.09669753735546739,1200,0.18931834352760024
32,RAMESH CHANDRA,SC,SHAHJAHANPUR,1172,7,RPI,0,M,UTTAR PRADESH,633853,633853,0,1240983,645811,595172,0.09444126148383983,1172,0.18490091551195623
33,AHIVARAN LAL,SC,SHAHJAHANPUR,1016,13,IND,0,M,UTTAR PRADESH,633853,633853,0,1240983,645811,595172,0.08187058162762907,1016,0.16028953085336822
33,RAM SEWAK,SC,SHAHJAHANPUR,908,9,EKD(UP),0,M,UTTAR PRADESH,633853,633853,0,1240983,645811,595172,0.07316780326563699,908,0.14325087993588417
34,VERENDRA,SC,SHAHJAHANPUR,888,21,IND,0,M,UTTAR PRADESH,633853,633853,0,1240983,645811,595172,0.07155617764304588,888,0.1400955742104242
32,RAJESH YADAV,GEN,SHAHJAHANPUR,709,20,IND,0,M,UTTAR PRADESH,633853,633853,0,1240983,645811,595172,0.057132128320855326,709,0.11185558796755715
50,SARNAM SINGH,GEN,SHAHJAHANPUR,692,24,IND,0,M,UTTAR PRADESH,633853,633853,0,1240983,645811,595172,0.05576224654165287,692,0.10917357810091613
59,SHRI KRISHNA PATHAK,GEN,SHAHJAHANPUR,647,22,IND,0,M,UTTAR PRADESH,633853,633853,0,1240983,645811,595172,0.052136088890822836,647,0.10207414021863113
29,SUMAT RANJAN,SC,SHAHJAHANPUR,603,25,IND,0,M,UTTAR PRADESH,633853,633853,0,1240983,645811,595172,0.04859051252112237,603,0.09513246762261912
30,SATYA PAL,SC,SHAHJAHANPUR,484,23,IND,0,M,UTTAR PRADESH,633853,633853,0,1240983,645811,595172,0.039001340066705185,484,0.0763583985561321
44,RAVI PRAKASH VERMA,GEN,KHERI,224598,2,SP,4,M,UTTAR PRADESH,706718,706706,12,1437563,790708,646855,15.623802226406774,224602,31.780993267470194
36,DAUD AHMAD,GEN,KHERI,212842,1,BSP,0,M,UTTAR PRADESH,706718,706706,12,1437563,790708,646855,14.805751121863878,212842,30.116963201729686
45,VINAY KATIYAR,GEN,KHERI,195842,4,BJP,7,M,UTTAR PRADESH,706718,706706,12,1437563,790708,646855,13.623681188233142,195849,27.712468056565704
60,RAI SINGH,GEN,KHERI,19746,3,INC,1,M,UTTAR PRADESH,706718,706706,12,1437563,790708,646855,1.3736441463782805,19747,2.7941838187226025
52,VIJAY TIWARI,GEN,KHERI,12421,6,SHS,0,M,UTTAR PRADESH,706718,706706,12,1437563,790708,646855,0.8640316980890578,12421,1.7575610073607861
45,HARISH KUMAR GUPTA,GEN,KHERI,9456,16,IND,0,M,UTTAR PRADESH,706718,706706,12,1437563,790708,646855,0.6577798677344924,9456,1.338016012044408
42,RAMDARASH,GEN,KHERI,6739,5,CPI(ML)(L),0,M,UTTAR PRADESH,706718,706706,12,1437563,790708,646855,0.46877945523083164,6739,0.9535628072300408
28,OM PRAKASH VERMA,GEN,KHERI,5670,9,IND,0,M,UTTAR PRADESH,706718,706706,12,1437563,790708,646855,0.3944174968331823,5670,0.8023002102677448
42,SUKHRAJIYA DEVI (ALIAS) SUKHRANI,SC,KHERI,5060,15,IND,0,F,UTTAR PRADESH,706718,706706,12,1437563,790708,646855,0.35198457389345716,5060,0.7159857255652183
44,HANSRAM PATEL,GEN,KHERI,3227,8,AD,0,M,UTTAR PRADESH,706718,706706,12,1437563,790708,646855,0.22447711856802105,3227,0.4566177739918893
40,NARESH SINGH BHADORIYA,GEN,KHERI,2323,13,IND,0,M,UTTAR PRADESH,706718,706706,12,1437563,790708,646855,0.16159291801472353,2323,0.3287025376458503
26,SANJAY PASI,SC,KHERI,2307,7,RSBP,0,M,UTTAR PRADESH,706718,706706,12,1437563,790708,646855,0.16047992331466515,2307,0.32643855116184956
27,JITENDRA,GEN,KHERI,1904,12,IND,0,M,UTTAR PRADESH,706718,706706,12,1437563,790708,646855,0.13244636930694514,1904,0.2694143915960822
38,SHIV PRASAD VERMA,GEN,KHERI,1811,14,IND,0,M,UTTAR PRADESH,706718,706706,12,1437563,790708,646855,0.12597708761285592,1811,0.25625497015782817
41,KESARI,SC,KHERI,1390,10,IND,0,F,UTTAR PRADESH,706718,706706,12,1437563,790708,646855,0.09669141456757026,1390,0.19668382579756
48,JAGDESH JAISAWAL,GEN,KHERI,1370,11,IND,0,M,UTTAR PRADESH,706718,706706,12,1437563,790708,646855,0.0953001711924973,1370,0.19385384269255912
63,ILIYAS AZMI,GEN,SHAHABAD,210167,1,BSP,4,M,UTTAR PRADESH,579629,579606,23,1258003,702218,555785,16.706716915619438,210171,36.259572933721394
58,SATYA DEV SINGH,GEN,SHAHABAD,163789,4,BJP,13,M,UTTAR PRADESH,579629,579606,23,1258003,702218,555785,13.020795657879988,163802,28.259800665598167
53,BABU KHAN,GEN,SHAHABAD,156570,2,SP,4,M,UTTAR PRADESH,579629,579606,23,1258003,702218,555785,12.446234229966064,156574,27.012796116136357
40,MRADUL SHUKLA,GEN,SHAHABAD,17039,3,INC,2,M,UTTAR PRADESH,579629,579606,23,1258003,702218,555785,1.354607262462808,17041,2.9399840242637962
32,HARI RAM,SC,SHAHABAD,8933,15,IND,0,M,UTTAR PRADESH,579629,579606,23,1258003,702218,555785,0.7100936961199616,8933,1.5411582236223516
25,GOPI CHANDRA,GEN,SHAHABAD,4570,6,AD,0,M,UTTAR PRADESH,579629,579606,23,1258003,702218,555785,0.36327417343201884,4570,0.7884353612396896
30,GOPAL,GEN,SHAHABAD,3674,5,ABHM,0,M,UTTAR PRADESH,579629,579606,23,1258003,702218,555785,0.29205017794075216,3674,0.6338537236749714
60,S R DARAPURI,SC,SHAHABAD,2843,7,RPI,0,M,UTTAR PRADESH,579629,579606,23,1258003,702218,555785,0.2259931017652581,2843,0.49048615579965804
25,MANJU,GEN,SHAHABAD,2745,12,IND,0,F,UTTAR PRADESH,579629,579606,23,1258003,702218,555785,0.21820297725840082,2745,0.473578789191017
36,RAHAT AZIZ,GEN,SHAHABAD,2354,14,IND,0,M,UTTAR PRADESH,579629,579606,23,1258003,702218,555785,0.18712197029736813,2354,0.4061218469055206
48,HIRA LAL VERMA,SC,SHAHABAD,2088,9,RSBP,0,M,UTTAR PRADESH,579629,579606,23,1258003,702218,555785,0.16597734663589833,2088,0.3602304232534949
50,RAM DAYAL,SC,SHAHABAD,1613,13,IND,0,M,UTTAR PRADESH,579629,579606,23,1258003,702218,555785,0.12821909009755939,1613,0.2782814524463062
26,INDRA BHUSHAN,SC,SHAHABAD,1232,10,IND,0,M,UTTAR PRADESH,579629,579606,23,1258003,702218,555785,0.09793299380049174,1232,0.21254975165148743
65,MANOHAR LAL,SC,SHAHABAD,996,8,IJP,0,M,UTTAR PRADESH,579629,579606,23,1258003,702218,555785,0.07917310213091702,996,0.1718340524714947
44,GANGA SAGAR,SC,SHAHABAD,993,11,IND,0,M,UTTAR PRADESH,579629,579606,23,1258003,702218,555785,0.07893462893172751,993,0.1713164800242914
43,RAJESH VERMA,GEN,SITAPUR,171733,4,BSP,0,M,UTTAR PRADESH,596569,596563,6,1292685,694062,598623,13.284984354270376,171733,28.786779064953087
51,MUKHTAR ANEES,GEN,SITAPUR,166499,3,SP,0,M,UTTAR PRADESH,596569,596563,6,1292685,694062,598623,12.88009066400554,166499,27.909428750069143
64,JANARDAN PRASAD MISHRA,GEN,SITAPUR,137819,2,BJP,3,M,UTTAR PRADESH,596569,596563,6,1292685,694062,598623,10.661684787864019,137822,23.102440790587508
52,RAJA MOHD AMIR MOHD KHAN,GEN,SITAPUR,68824,1,INC,3,M,UTTAR PRADESH,596569,596563,6,1292685,694062,598623,5.324344291145948,68827,11.537139878203527
42,OM PRAKASH SRIVASTAVA BABLU,GEN,SITAPUR,27881,5,AD,0,M,UTTAR PRADESH,596569,596563,6,1292685,694062,598623,2.1568286164069357,27881,4.673558297531383
37,HARERAM FAUJI,GEN,SITAPUR,6590,16,IND,0,M,UTTAR PRADESH,596569,596563,6,1292685,694062,598623,0.5097916352398303,6590,1.1046500907690477
48,JADUNATH YADAV,GEN,SITAPUR,2873,13,IND,0,M,UTTAR PRADESH,596569,596563,6,1292685,694062,598623,0.22225058695660582,2873,0.4815872095264756
61,HARI PRAPANNACHARYA MISHRA,GEN,SITAPUR,2292,15,IND,0,M,UTTAR PRADESH,596569,596563,6,1292685,694062,598623,0.17730537601967997,2292,0.38419696631906786
32,ANUJ KUMAR,GEN,SITAPUR,2005,10,IND,0,M,UTTAR PRADESH,596569,596563,6,1292685,694062,598623,0.1551035248339696,2005,0.33608853292745683
29,SUNIT KUMAR,GEN,SITAPUR,1959,14,IND,0,M,UTTAR PRADESH,596569,596563,6,1292685,694062,598623,0.15154503997493587,1959,0.32837777356852266
42,DWIJENDRA DUTT,GEN,SITAPUR,1951,6,BKD,0,M,UTTAR PRADESH,596569,596563,6,1292685,694062,598623,0.15092617304293002,1951,0.32703677194088193
62,SIYARAM,GEN,SITAPUR,1349,8,RJD,0,M,UTTAR PRADESH,596569,596563,6,1292685,694062,598623,0.10435643640948877,1349,0.22612639946091737
41,KUNJ BIHARI,GEN,SITAPUR,1317,12,IND,0,M,UTTAR PRADESH,596569,596563,6,1292685,694062,598623,0.10188096868146532,1317,0.22076239295035446
27,VINOD KUMAR,GEN,SITAPUR,1232,7,MNVP,0,M,UTTAR PRADESH,596569,596563,6,1292685,694062,598623,0.09530550752890302,1232,0.20651425065667173
40,SURESH,GEN,SITAPUR,1179,9,SAP,0,M,UTTAR PRADESH,596569,596563,6,1292685,694062,598623,0.09120551410436417,1179,0.19763011487355192
29,KAPIL KUMAR,GEN,SITAPUR,1060,11,IND,0,M,UTTAR PRADESH,596569,596563,6,1292685,694062,598623,0.08199986849077695,1060,0.17768271566239613
36,ASHOK KUMAR RAWAT,SC,MISRIKH (SC),207062,1,BSP,0,M,UTTAR PRADESH,550849,550846,3,1234107,684169,549938,16.778285837451694,207062,37.58961167216424
45,SUSHILA SAROJ,SC,MISRIKH (SC),187659,4,SP,0,F,UTTAR PRADESH,550849,550846,3,1234107,684169,549938,15.206055876840502,187659,34.06723076560001
69,PARAGI LAL CHAU,SC,MISRIKH (SC),75711,2,BJP,3,M,UTTAR PRADESH,550849,550846,3,1234107,684169,549938,6.135124426001959,75714,13.744964591022221
57,RAM LAL RAHI,SC,MISRIKH (SC),50240,3,INC,0,M,UTTAR PRADESH,550849,550846,3,1234107,684169,549938,4.0709598114264,50240,9.12046677038535
39,SUSHILA DEVI,SC,MISRIKH (SC),9806,12,IND,0,F,UTTAR PRADESH,550849,550846,3,1234107,684169,549938,0.7945826415375652,9806,1.7801611693948796
27,VEERENDRA KUMAR,SC,MISRIKH (SC),4101,6,AD,0,M,UTTAR PRADESH,550849,550846,3,1234107,684169,549938,0.33230505944784366,4101,0.7444871462052214
30,SUNILA,SC,MISRIKH (SC),4051,7,CPI(ML)(L),0,F,UTTAR PRADESH,550849,550846,3,1234107,684169,549938,0.328253546896663,4051,0.7354102485436118
29,NAND RAM,SC,MISRIKH (SC),4040,5,MNVP,0,M,UTTAR PRADESH,550849,550846,3,1234107,684169,549938,0.3273622141354032,4040,0.7334133310580576
61,RAM ASREY,SC,MISRIKH (SC),2602,11,IND,0,M,UTTAR PRADESH,550849,550846,3,1234107,684169,549938,0.2108407131634453,2602,0.4723617543101648
30,UDAY RAJ,SC,MISRIKH (SC),2100,8,IND,0,M,UTTAR PRADESH,550849,550846,3,1234107,684169,549938,0.17016352714959077,2100,0.38122970178760424
35,MOTI LAL,SC,MISRIKH (SC),1801,9,IND,0,M,UTTAR PRADESH,550849,550846,3,1234107,684169,549938,0.14593548209352997,1801,0.32694985377117863
29,RAJ KUMAR,SC,MISRIKH (SC),1673,10,IND,0,M,UTTAR PRADESH,550849,550846,3,1234107,684169,549938,0.1355636099625073,1673,0.303712995757458
37,USHA VERMA,SC,HARDOI (SC),203429,2,SP,16,F,UTTAR PRADESH,522103,522063,40,1213260,680329,532931,16.76845853320805,203445,38.96644914892272
54,SHIV PRASAD VERMA,SC,HARDOI (SC),164238,4,BSP,4,M,UTTAR PRADESH,522103,522063,40,1213260,680329,532931,13.537246756672106,164242,31.457777488349997
36,ANITA VERMA,SC,HARDOI (SC),116455,1,BJP,18,F,UTTAR PRADESH,522103,522063,40,1213260,680329,532931,9.60000329690256,116473,22.30843339341088
81,CHAND RAM,SC,HARDOI (SC),9400,3,INC,2,M,UTTAR PRADESH,522103,522063,40,1213260,680329,532931,0.7749369467385392,9402,1.8007940961840865
54,LACHHIMAN,SC,HARDOI (SC),7771,11,IND,0,M,UTTAR PRADESH,522103,522063,40,1213260,680329,532931,0.640505744852711,7771,1.488403629168957
42,RAJENDRA KUMAR S/O SHANKER,SC,HARDOI (SC),7287,10,IND,0,M,UTTAR PRADESH,522103,522063,40,1213260,680329,532931,0.6006132238761683,7287,1.3957016144324013
46,UDIT RAJ,SC,HARDOI (SC),6267,5,IJP,0,M,UTTAR PRADESH,522103,522063,40,1213260,680329,532931,0.516542208595025,6267,1.200337864367759
27,USHA,SC,HARDOI (SC),2002,7,IND,0,F,UTTAR PRADESH,522103,522063,40,1213260,680329,532931,0.16500997313024413,2002,0.3834492427739354
35,GAYA CHARAN,SC,HARDOI (SC),1845,8,IND,0,M,UTTAR PRADESH,522103,522063,40,1213260,680329,532931,0.15206963058206815,1845,0.3533785479110444
43,RAJENDRA KUMAR S/O JALIM,SC,HARDOI (SC),1728,9,IND,0,M,UTTAR PRADESH,522103,522063,40,1213260,680329,532931,0.142426190593937,1728,0.33096917658010006
48,SHRI KRISHNA,SC,HARDOI (SC),1641,6,RSBP,0,M,UTTAR PRADESH,522103,522063,40,1213260,680329,532931,0.13525542752583947,1641,0.3143057978981159
76,ATAL BIHARI VAJPAYEE,GEN,LUCKNOW,324666,1,BJP,48,M,UTTAR PRADESH,578556,578501,55,1639922,884529,755393,19.800575881048,324714,56.12490407151598
52,MADHU GUPTA,GEN,LUCKNOW,106337,3,SP,2,F,UTTAR PRADESH,578556,578501,55,1639922,884529,755393,6.484393769947595,106339,18.38007038212377
80,JETHMALANI RAM BOOLCHAND,GEN,LUCKNOW,57683,20,IND,2,M,UTTAR PRADESH,578556,578501,55,1639922,884529,755393,3.5175453466689266,57685,9.970512793921419
29,NASIR ALI SIDDIQUI,GEN,LUCKNOW,53565,2,BSP,1,M,UTTAR PRADESH,578556,578501,55,1639922,884529,755393,3.266374864170369,53566,9.258567882797863
34,KRISHNAPAL,SC,LUCKNOW,6928,6,SAP,0,M,UTTAR PRADESH,578556,578501,55,1639922,884529,755393,0.42245911695800165,6928,1.1974640311395957
45,SHEKH AJIJ AHMED MO AHMED ALIAS AJIJ,GEN,LUCKNOW,4051,17,IND,0,M,UTTAR PRADESH,578556,578501,55,1639922,884529,755393,0.24702394382171833,4051,0.7001915112798069
43,SALAHUDDIN,GEN,LUCKNOW,3965,32,IND,0,M,UTTAR PRADESH,578556,578501,55,1639922,884529,755393,0.24177979196571545,3965,0.6853269173597716
41,ARUN KUMAR PATEL,GEN,LUCKNOW,2802,4,AD,2,M,UTTAR PRADESH,578556,578501,55,1639922,884529,755393,0.1709837419096762,2804,0.4846548994392937
60,AJAY CHATURVEDI,GEN,LUCKNOW,2110,16,IND,0,M,UTTAR PRADESH,578556,578501,55,1639922,884529,755393,0.1286646560019318,2110,0.364701083386915
61,DOMAI,GEN,LUCKNOW,1203,21,IND,0,M,UTTAR PRADESH,578556,578501,55,1639922,884529,755393,0.07335714747408718,1203,0.20793147076514631
32,AJAY KUMAR PANDEY,GEN,LUCKNOW,1043,15,IND,0,M,UTTAR PRADESH,578556,578501,55,1639922,884529,755393,0.06360058588152363,1043,0.18027641230926653
61,D P PAL,GEN,LUCKNOW,1026,25,IND,0,M,UTTAR PRADESH,578556,578501,55,1639922,884529,755393,0.06256395121231376,1026,0.1773380623483293
39,JAFFAR ALI,GEN,LUCKNOW,1018,19,IND,0,M,UTTAR PRADESH,578556,578501,55,1639922,884529,755393,0.06207612313268558,1018,0.1759553094255353
38,NAND KUMAR RAJPOOT (LODHI),GEN,LUCKNOW,981,9,JP,0,M,UTTAR PRADESH,578556,578501,55,1639922,884529,755393,0.059819918264405254,981,0.1695600771576131
32,MOHD KAMRAN SIDDIQUI,GEN,LUCKNOW,918,18,IND,0,M,UTTAR PRADESH,578556,578501,55,1639922,884529,755393,0.055978272137333356,918,0.15867089789061042
29,"ASKARI ""SHAKTI""",GEN,LUCKNOW,885,5,RKSP,0,M,UTTAR PRADESH,578556,578501,55,1639922,884529,755393,0.05396598130886713,885,0.1529670420840852
47,VIJAY NARAYAN PAL (DR V N PAL),GEN,LUCKNOW,864,14,IJP,0,M,UTTAR PRADESH,578556,578501,55,1639922,884529,755393,0.05268543259984316,864,0.14933731566175099
68,KHEM SINGH ARYA,GEN,LUCKNOW,829,7,ABRS,0,M,UTTAR PRADESH,578556,578501,55,1639922,884529,755393,0.050551184751469885,829,0.14328777162452727
26,PRADEEP KUMAR RAWAT,SC,LUCKNOW,753,10,RSBP,0,M,UTTAR PRADESH,578556,578501,55,1639922,884529,755393,0.045916817995002204,753,0.13015161885798435
43,FAGURAM,GEN,LUCKNOW,671,27,IND,0,M,UTTAR PRADESH,578556,578501,55,1639922,884529,755393,0.04091658017881338,671,0.11597840139934597
29,NEELAM SINGH,GEN,LUCKNOW,639,23,IND,0,F,UTTAR PRADESH,578556,578501,55,1639922,884529,755393,0.038965267860300676,639,0.11044738970816999
49,MAHATMA PREMCHANDRA SINGH,SC,LUCKNOW,621,26,IND,0,M,UTTAR PRADESH,578556,578501,55,1639922,884529,755393,0.03786765468113727,621,0.10733619563188353
44,RAVI SHANKAR DIKSHIT,GEN,LUCKNOW,604,30,IND,0,M,UTTAR PRADESH,578556,578501,55,1639922,884529,755393,0.036831020011927396,604,0.10439784567094629
50,RAM KUMAR SHUKL,GEN,LUCKNOW,598,31,IND,0,M,UTTAR PRADESH,578556,578501,55,1639922,884529,755393,0.03646514895220627,598,0.10336078097885079
53,R K BHARDWAJ,GEN,LUCKNOW,597,11,KMM,0,M,UTTAR PRADESH,578556,578501,55,1639922,884529,755393,0.03640417044225274,597,0.10318793686350154
56,RAM SHARAN,GEN,LUCKNOW,572,13,BNRP,0,M,UTTAR PRADESH,578556,578501,55,1639922,884529,755393,0.03487970769341468,572,0.09886683397977032
40,NARESH SINGH BHADORIA,GEN,LUCKNOW,548,22,IND,0,M,UTTAR PRADESH,578556,578501,55,1639922,884529,755393,0.03341622345453015,548,0.09471857521138835
47,JEETU RAM RATNA JEETU PASI,SC,LUCKNOW,487,8,VP,0,M,UTTAR PRADESH,578556,578501,55,1639922,884529,755393,0.0296965343473653,487,0.08417508417508417
61,MAHESH CHANDRA SHARMA,GEN,LUCKNOW,450,29,IND,0,M,UTTAR PRADESH,578556,578501,55,1639922,884529,755393,0.027440329479084983,450,0.07777985190716197
62,MAHESH KUMAR NIMBEKAR,SC,LUCKNOW,395,12,SHSP,0,M,UTTAR PRADESH,578556,578501,55,1639922,884529,755393,0.024086511431641262,395,0.06827342556295328
44,MANGAT RAM,GEN,LUCKNOW,366,28,IND,0,M,UTTAR PRADESH,578556,578501,55,1639922,884529,755393,0.022318134642989117,366,0.06326094621782506
42,K PADMARAJAN,GEN,LUCKNOW,326,24,IND,0,M,UTTAR PRADESH,578556,578501,55,1639922,884529,755393,0.019878994244848232,326,0.056347181603855115
47,JAI PRAKASH,SC,MOHANLALGANJ (SC),148572,1,SP,6,M,UTTAR PRADESH,571879,571848,31,1278376,690420,587956,11.622402172756685,148578,25.980670736292115
37,RADHE LAL,SC,MOHANLALGANJ (SC),146009,3,BSP,1,M,UTTAR PRADESH,571879,571848,31,1278376,690420,587956,11.421522306426278,146010,25.531624696832722
54,MAST RAM,SC,MOHANLALGANJ (SC),115972,2,BJP,17,M,UTTAR PRADESH,571879,571848,31,1278376,690420,587956,9.07315218683705,115989,20.28208764441429
36,REENA CHOUDHARY,SC,MOHANLALGANJ (SC),103922,4,INC,5,F,UTTAR PRADESH,571879,571848,31,1278376,690420,587956,8.12961131936144,103927,18.172900211408358
43,KAUSHAL KISHORE,SC,MOHANLALGANJ (SC),28757,6,RCP,0,M,UTTAR PRADESH,571879,571848,31,1278376,690420,587956,2.2494946713642934,28757,5.028511275986704
34,RADHE SHYAM,SC,MOHANLALGANJ (SC),12807,10,IND,0,M,UTTAR PRADESH,571879,571848,31,1278376,690420,587956,1.0018179315005915,12807,2.2394597458553296
26,ARCHANA,SC,MOHANLALGANJ (SC),5042,5,AD,2,F,UTTAR PRADESH,571879,571848,31,1278376,690420,587956,0.39456310193558075,5044,0.8820047597481286
48,BABU LAL,SC,MOHANLALGANJ (SC),4654,9,IND,0,M,UTTAR PRADESH,571879,571848,31,1278376,690420,587956,0.36405564560035547,4654,0.8138085154377063
43,CHHAVI NATH,SC,MOHANLALGANJ (SC),3574,8,IND,0,M,UTTAR PRADESH,571879,571848,31,1278376,690420,587956,0.27957345882588536,3574,0.6249573773473059
26,REENA CHOUDHARY D/O KALLO,SC,MOHANLALGANJ (SC),2539,7,MNVP,0,F,UTTAR PRADESH,571879,571848,31,1278376,690420,587956,0.19861136316701816,2539,0.4439750366773391
28,BRAJESH PATHAK,GEN,UNNAO,178360,3,BSP,6,M,UTTAR PRADESH,547566,547514,52,1303203,709651,593552,13.686739517941565,178366,32.5743380706618
35,DEEPAK KUMAR,GEN,UNNAO,160596,1,SP,9,M,UTTAR PRADESH,547566,547514,52,1303203,709651,593552,12.323866657765521,160605,29.330710818421892
60,DEVI BUX SINGH,GEN,UNNAO,94684,2,BJP,27,M,UTTAR PRADESH,547566,547514,52,1303203,709651,593552,7.2675554000412825,94711,17.296727700405064
66,SHIV PAL SINGH,GEN,UNNAO,83463,4,INC,10,M,UTTAR PRADESH,547566,547514,52,1303203,709651,593552,6.405218526967786,83473,15.244372367897203
34,SANDHYA KUSHWAHA,GEN,UNNAO,7072,9,AD,0,F,UTTAR PRADESH,547566,547514,52,1303203,709651,593552,0.5426629619483687,7072,1.291533805970422
35,HARISHCHANDRA MISRA,GEN,UNNAO,5458,16,IND,0,M,UTTAR PRADESH,547566,547514,52,1303203,709651,593552,0.4188142599426183,5458,0.9967748180128057
63,RAM AUTAR,SC,UNNAO,3781,14,IND,0,M,UTTAR PRADESH,547566,547514,52,1303203,709651,593552,0.2901313149217735,3781,0.6905103676999668
32,AMAR PAL,SC,UNNAO,2543,5,IJP,0,M,UTTAR PRADESH,547566,547514,52,1303203,709651,593552,0.1951346029743639,2543,0.4644189011005066
45,SHIVSHANKAR LAL,GEN,UNNAO,2364,15,IND,0,M,UTTAR PRADESH,547566,547514,52,1303203,709651,593552,0.18139921409020696,2364,0.4317287779007462
55,DR KAILASH SHANKER TRIVEDI,GEN,UNNAO,2077,13,IND,0,M,UTTAR PRADESH,547566,547514,52,1303203,709651,593552,0.15937655146588828,2077,0.3793150049491751
28,UMESH KUMAR,SC,UNNAO,1606,12,IND,0,M,UTTAR PRADESH,547566,547514,52,1303203,709651,593552,0.12323482987684957,1606,0.29329797686488934
68,VED PRATAP SINGH,GEN,UNNAO,1480,8,ABJS,0,M,UTTAR PRADESH,547566,547514,52,1303203,709651,593552,0.11356634384666088,1480,0.2702870521544435
41,RAJESH TRIPATHI,GEN,UNNAO,1175,7,BKD,0,M,UTTAR PRADESH,547566,547514,52,1303203,709651,593552,0.09016246893231522,1175,0.21458600424423724
30,ATUL KUMAR,GEN,UNNAO,1044,10,IND,0,M,UTTAR PRADESH,547566,547514,52,1303203,709651,593552,0.08011031282156349,1044,0.19066194760083716
59,K N SINGH,GEN,UNNAO,1011,6,RJD,0,M,UTTAR PRADESH,547566,547514,52,1303203,709651,593552,0.0775780902898474,1011,0.18463527684333944
61,ASHOK KUMAR,GEN,UNNAO,800,11,IND,0,M,UTTAR PRADESH,547566,547514,52,1303203,709651,593552,0.06138721289008696,800,0.14610110927267217
58,SONIA GANDHI,GEN,RAE BARELI,378107,4,INC,0,F,UTTAR PRADESH,643560,643560,0,1329169,703114,626055,28.446871692012078,378107,58.752408477841996
48,ASHOK KUMAR SINGH,GEN,RAE BARELI,128342,1,SP,0,M,UTTAR PRADESH,643560,643560,0,1329169,703114,626055,9.6558075007768,128342,19.94250730312636
36,RAJESH YADAV,GEN,RAE BARELI,57543,3,BSP,0,M,UTTAR PRADESH,643560,643560,0,1329169,703114,626055,4.329246318564457,57543,8.941357449188887
64,GIRISH NARAYAN PANDAY,GEN,RAE BARELI,31290,2,BJP,0,M,UTTAR PRADESH,643560,643560,0,1329169,703114,626055,2.354102450478457,31290,4.862017527503263
38,HORI LAL,SC,RAE BARELI,15160,16,IND,0,M,UTTAR PRADESH,643560,643560,0,1329169,703114,626055,1.1405622610819242,15160,2.355646715146995
29,INDRA PAL SINGH,SC,RAE BARELI,9969,5,AD,0,M,UTTAR PRADESH,643560,643560,0,1329169,703114,626055,0.7500174921323022,9969,1.549039716576543
46,SHIV BALAK,SC,RAE BARELI,3873,13,IND,0,M,UTTAR PRADESH,643560,643560,0,1329169,703114,626055,0.29138506841492695,3873,0.6018086891665113
35,SONA DEVI,SC,RAE BARELI,3238,7,RSBP,0,F,UTTAR PRADESH,643560,643560,0,1329169,703114,626055,0.24361085761103368,3238,0.5031387904779664
60,HIRA LAL,SC,RAE BARELI,3202,15,IND,0,M,UTTAR PRADESH,643560,643560,0,1329169,703114,626055,0.24090239841585231,3202,0.49754490645782834
63,HARI SHANKER,SC,RAE BARELI,2900,14,IND,0,M,UTTAR PRADESH,643560,643560,0,1329169,703114,626055,0.21818143516738656,2900,0.4506184349555597
36,SHYAM SUNDER PASI ADVOCATE,SC,RAE BARELI,1982,12,IND,0,M,UTTAR PRADESH,643560,643560,0,1329169,703114,626055,0.1491157256902621,1982,0.30797439244204117
40,RAM SAJIWAN,SC,RAE BARELI,1874,11,IND,0,M,UTTAR PRADESH,643560,643560,0,1329169,703114,626055,0.14099034810471806,1874,0.2911927403816272
32,SURESH KUMAR,SC,RAE BARELI,1707,6,BKRP,0,M,UTTAR PRADESH,643560,643560,0,1329169,703114,626055,0.12842610683818234,1707,0.265243333954876
58,PURNMASI,SC,RAE BARELI,1608,9,IND,0,M,UTTAR PRADESH,643560,643560,0,1329169,703114,626055,0.12097784405143365,1608,0.24986015289949653
39,JAAFAR ALI,GEN,RAE BARELI,1401,8,IND,0,M,UTTAR PRADESH,643560,643560,0,1329169,703114,626055,0.10540420367914087,1401,0.21769531978370316
47,BRIJLAL,SC,RAE BARELI,1364,10,IND,0,M,UTTAR PRADESH,643560,643560,0,1329169,703114,626055,0.1026205095063156,1364,0.2119460500963391
38,"AKSHAY PRATAP SINGH ""GOPAL JI""",GEN,PRATAPGARH,238128,1,SP,9,M,UTTAR PRADESH,572548,572522,26,1332216,712707,619509,17.875254463240196,238137,41.59249530170396
43,RAJKUMARI RATNA SINGH,GEN,PRATAPGARH,168857,3,INC,8,F,UTTAR PRADESH,572548,572522,26,1332216,712707,619509,12.675497066541762,168865,29.493597043391993
50,"SHIV PRAKASH MISHRA ""SENANI""",GEN,PRATAPGARH,82876,4,BSP,0,M,UTTAR PRADESH,572548,572522,26,1332216,712707,619509,6.2209131251989165,82876,14.474943585515973
65,ROSHAN LAL,SC,PRATAPGARH,22115,6,AD,0,M,UTTAR PRADESH,572548,572522,26,1332216,712707,619509,1.6600160934863415,22115,3.862558248391401
69,RAMASHANKAR SINGH,GEN,PRATAPGARH,20828,2,BJP,8,M,UTTAR PRADESH,572548,572522,26,1332216,712707,619509,1.5640106409170886,20836,3.639170864276882
38,SURENDRA BAHADUR,GEN,PRATAPGARH,12954,15,IND,0,M,UTTAR PRADESH,572548,572522,26,1332216,712707,619509,0.9723648417373758,12954,2.262517727771296
68,DR SRI RAM PAL,GEN,PRATAPGARH,4777,14,IND,1,M,UTTAR PRADESH,572548,572522,26,1332216,712707,619509,0.35865054916019623,4778,0.8345151847530686
38,SHYAM NARAYAN,GEN,PRATAPGARH,4252,13,IND,0,M,UTTAR PRADESH,572548,572522,26,1332216,712707,619509,0.3191674623334354,4252,0.7426451581352131
58,RAM MILAN,GEN,PRATAPGARH,3578,12,IND,0,M,UTTAR PRADESH,572548,572522,26,1332216,712707,619509,0.26857506590522856,3578,0.6249257704157556
43,TEJ BAHADUR SINGH,GEN,PRATAPGARH,3173,5,JVP,0,M,UTTAR PRADESH,572548,572522,26,1332216,712707,619509,0.238174590306677,3173,0.5541893430769124
50,MUHEED,GEN,PRATAPGARH,2588,10,IND,0,M,UTTAR PRADESH,572548,572522,26,1332216,712707,619509,0.19426279221988024,2588,0.45201450358747214
32,RAJESH KUMAR,GEN,PRATAPGARH,2526,11,IND,0,M,UTTAR PRADESH,572548,572522,26,1332216,712707,619509,0.18960889225170693,2526,0.4411857171800443
39,ASHOK KUMAR,GEN,PRATAPGARH,2118,8,IND,0,M,UTTAR PRADESH,572548,572522,26,1332216,712707,619509,0.1589832279450179,2118,0.3699253163053578
35,PRADEEP KUMAR SINGH,GEN,PRATAPGARH,2030,9,IND,0,M,UTTAR PRADESH,572548,572522,26,1332216,712707,619509,0.1523776925063203,2030,0.3545554259206215
51,KUNWAR AMRESH SINGH,GEN,PRATAPGARH,1722,7,IND,0,M,UTTAR PRADESH,572548,572522,26,1332216,712707,619509,0.1292583184708786,1722,0.30076080957404444
33,RAHUL GANDHI,GEN,AMETHI,390158,3,INC,21,M,UTTAR PRADESH,589596,589559,37,1324991,699957,625034,29.447671720034325,390179,66.17734855731722
33,CHANDRA PARKASH MISHRA MATIYARI,GEN,AMETHI,99326,1,BSP,0,M,UTTAR PRADESH,589596,589559,37,1324991,699957,625034,7.496352805415282,99326,16.846450790032495
50,RAM VILASHDAS VEDANTI,GEN,AMETHI,55422,2,BJP,16,M,UTTAR PRADESH,589596,589559,37,1324991,699957,625034,4.184028419815681,55438,9.402709652032918
42,SHRI RAM,SC,AMETHI,12320,12,IND,0,M,UTTAR PRADESH,589596,589559,37,1324991,699957,625034,0.9298176364971535,12320,2.089566414968894
29,UDAI RAJ MAURYA SATYAPATHI JI,GEN,AMETHI,11280,4,AD,0,M,UTTAR PRADESH,589596,589559,37,1324991,699957,625034,0.851326537312329,11280,1.9131744448741173
27,SHASHILESH,GEN,AMETHI,4859,11,IND,0,M,UTTAR PRADESH,589596,589559,37,1324991,699957,625034,0.36671947205679134,4859,0.8241236372024233
41,SHYAM LAL,SC,AMETHI,3837,10,IND,0,M,UTTAR PRADESH,589596,589559,37,1324991,699957,625034,0.28958687266555017,3837,0.6507846050515946
45,MOHD SABIR KHAN,GEN,AMETHI,3229,5,RSBP,0,M,UTTAR PRADESH,589596,589559,37,1324991,699957,625034,0.24369976852672962,3229,0.5476631456115713
49,RAM DULARE,SC,AMETHI,2615,9,IND,0,M,UTTAR PRADESH,589596,589559,37,1324991,699957,625034,0.1973598311233812,2615,0.44352404019023195
30,RADHAY SHYAM,SC,AMETHI,2539,8,IND,0,M,UTTAR PRADESH,589596,589559,37,1324991,699957,625034,0.19162394310602862,2539,0.43063385776022906
34,RAJESH KUMAR RAWQT,SC,AMETHI,2124,7,IND,0,M,UTTAR PRADESH,589596,589559,37,1324991,699957,625034,0.16030297564285342,2124,0.360246677385871
38,JIYA LAL,SC,AMETHI,1850,6,IND,0,M,UTTAR PRADESH,589596,589559,37,1324991,699957,625034,0.1396235898960823,1850,0.3137741775724394
28,MOHD TAHIR,GEN,SULTANPUR,261563,1,BSP,1,M,UTTAR PRADESH,721049,721002,47,1465273,792361,672912,17.850871475827372,261564,36.27548197140555
45,SHAILENDRA PRATAP SINGH,GEN,SULTANPUR,159744,3,SP,10,M,UTTAR PRADESH,721049,721002,47,1465273,792361,672912,10.902678203993386,159754,22.155775821060704
56,CAPTAIN SATISH SHARMA,GEN,SULTANPUR,154241,4,INC,4,M,UTTAR PRADESH,721049,721002,47,1465273,792361,672912,10.526707309832366,154245,21.391750075237606
49,VEENA PANDEY,GEN,SULTANPUR,91296,2,BJP,32,F,UTTAR PRADESH,721049,721002,47,1465273,792361,672912,6.232831697574445,91328,12.665990799515706
27,SARVENDRA VEER VIKRAM,GEN,SULTANPUR,14628,15,IND,0,M,UTTAR PRADESH,721049,721002,47,1465273,792361,672912,0.998312259899691,14628,2.02871094752229
59,ALGU RAM VARMA,GEN,SULTANPUR,12207,6,AD,0,M,UTTAR PRADESH,721049,721002,47,1465273,792361,672912,0.8330870766062024,12207,1.6929501323765792
72,RAM KUMAR PANDEY,GEN,SULTANPUR,5252,12,IND,0,M,UTTAR PRADESH,721049,721002,47,1465273,792361,672912,0.35843150047806793,5252,0.7283832305432779
44,RAM NATH,SC,SULTANPUR,5126,13,IND,0,M,UTTAR PRADESH,721049,721002,47,1465273,792361,672912,0.34983242030665956,5126,0.7109086899780735
37,MOHD ARSAD PAVAR,GEN,SULTANPUR,4098,5,NLP,0,M,UTTAR PRADESH,721049,721002,47,1465273,792361,672912,0.2796748455748519,4098,0.5683386288587877
36,SHYAM NARAYAN,SC,SULTANPUR,3925,14,IND,0,M,UTTAR PRADESH,721049,721002,47,1465273,792361,672912,0.2678681720061722,3925,0.5443458072891024
31,MURLI,SC,SULTANPUR,2554,11,IND,0,M,UTTAR PRADESH,721049,721002,47,1465273,792361,672912,0.17430199014108635,2554,0.35420616352009365
42,RAQM PIYARE PASI,SC,SULTANPUR,1882,7,BKRP,0,M,UTTAR PRADESH,721049,721002,47,1465273,792361,672912,0.12844022922690856,1882,0.261008613839004
27,DHARMENDRA KUMAR,SC,SULTANPUR,1621,10,IND,0,M,UTTAR PRADESH,721049,721002,47,1465273,792361,672912,0.11062784887184846,1621,0.22481135123965224
25,KAMATA PRASHAD,SC,SULTANPUR,1448,9,IND,0,M,UTTAR PRADESH,721049,721002,47,1465273,792361,672912,0.09882117530316877,1448,0.20081852966996697
40,ARVIND TIWARI,GEN,SULTANPUR,1417,8,IND,0,M,UTTAR PRADESH,721049,721002,47,1465273,792361,672912,0.0967055285943302,1417,0.19651923794360718
48,MAYA WATI,SC,AKBARPUR (SC),325014,3,BSP,5,F,UTTAR PRADESH,741572,741544,28,1446088,777470,668618,22.475741448653196,325019,43.828380791076256
47,SHANKH LAL MANJHI,SC,AKBARPUR (SC),266742,4,SP,8,M,UTTAR PRADESH,741572,741544,28,1446088,777470,668618,18.446318619613745,266750,35.97088347456484
53,TRIVENI RAM,SC,AKBARPUR (SC),60880,2,BJP,15,M,UTTAR PRADESH,741572,741544,28,1446088,777470,668618,4.211016203716509,60895,8.211609931335055
51,PUSHPA KANAUJIA,SC,AKBARPUR (SC),29254,5,AD,0,F,UTTAR PRADESH,741572,741544,28,1446088,777470,668618,2.0229750886529727,29254,3.9448630746576194
30,JAISRAJ GAUTAM,SC,AKBARPUR (SC),28312,1,INC,0,M,UTTAR PRADESH,741572,741544,28,1446088,777470,668618,1.9578338247741491,28312,3.81783562486178
28,KARUNA SHANKAR,SC,AKBARPUR (SC),11108,12,IND,0,M,UTTAR PRADESH,741572,741544,28,1446088,777470,668618,0.7681413579256587,11108,1.4978990576774744
27,SHRI NIWAS,SC,AKBARPUR (SC),5419,10,SBSP,0,M,UTTAR PRADESH,741572,741544,28,1446088,777470,668618,0.3747351475152273,5419,0.7307449580081232
38,RAM LAL RAHI,SC,AKBARPUR (SC),3706,8,RSMD,0,M,UTTAR PRADESH,741572,741544,28,1446088,777470,668618,0.2562776262578764,3706,0.499749181468556
26,RAM NIRANJAN,SC,AKBARPUR (SC),3164,6,MNVP,0,M,UTTAR PRADESH,741572,741544,28,1446088,777470,668618,0.218797196297874,3164,0.4266612008004617
35,RAM LAUT,SC,AKBARPUR (SC),3016,9,RSBP,0,M,UTTAR PRADESH,741572,741544,28,1446088,777470,668618,0.2085626877479102,3016,0.40670359722319616
33,ASHA RAM,SC,AKBARPUR (SC),2940,11,IND,0,M,UTTAR PRADESH,741572,741544,28,1446088,777470,668618,0.20330712930333425,2940,0.39645509808892465
60,RAM PRATAP,SC,AKBARPUR (SC),1989,7,RPI,0,M,UTTAR PRADESH,741572,741544,28,1446088,777470,668618,0.13754349666133733,1989,0.26821401023771124
70,MITRASEN,GEN,FAIZABAD,207278,3,BSP,7,M,UTTAR PRADESH,686599,686485,114,1326533,717092,609441,15.626071873070629,207285,30.190110967245804
48,LALLU SINGH,GEN,FAIZABAD,173717,4,BJP,82,M,UTTAR PRADESH,686599,686485,114,1326533,717092,609441,13.101747186085836,173799,25.313028419790882
47,ASHOK KUMAR SINGH,GEN,FAIZABAD,137136,1,SP,12,M,UTTAR PRADESH,686599,686485,114,1326533,717092,609441,10.338830620874113,137148,19.974978116775585
53,NIRMAL KHATRI,GEN,FAIZABAD,95262,2,INC,12,M,UTTAR PRADESH,686599,686485,114,1326533,717092,609441,7.182180918228194,95274,13.876221783020364
44,SIYA RAM NISHAD,GEN,FAIZABAD,19168,10,AD,1,M,UTTAR PRADESH,686599,686485,114,1326533,717092,609441,1.445045091226528,19169,2.7918770636135504
35,RAM NIHAL,GEN,FAIZABAD,13331,16,IND,0,M,UTTAR PRADESH,686599,686485,114,1326533,717092,609441,1.00495049878141,13331,1.9415990993287204
55,HUBRAJ,SC,FAIZABAD,8753,17,IND,0,M,UTTAR PRADESH,686599,686485,114,1326533,717092,609441,0.6598403507489071,8753,1.2748343647456521
40,RAJENDRA PRASAD,SC,FAIZABAD,5363,14,IND,0,M,UTTAR PRADESH,686599,686485,114,1326533,717092,609441,0.40428696459115604,5363,0.7810963895956737
30,OM PRAKASH CHAURASIA 'ADVOCATE',GEN,FAIZABAD,5100,5,RSMD,0,M,UTTAR PRADESH,686599,686485,114,1326533,717092,609441,0.3844608464320149,5100,0.7427916440309409
35,SURESH KUMAR,SC,FAIZABAD,4177,11,RSBP,0,M,UTTAR PRADESH,686599,686485,114,1326533,717092,609441,0.31488097167578943,4177,0.6083609210033804
58,DEVENDRA BAHADUR RAI,GEN,FAIZABAD,3969,13,IND,0,M,UTTAR PRADESH,686599,686485,114,1326533,717092,609441,0.29920099989973864,3969,0.5780666735605499
55,RAM ACHHAIBER YADAV,GEN,FAIZABAD,3613,15,IND,0,M,UTTAR PRADESH,686599,686485,114,1326533,717092,609441,0.27236412512919017,3613,0.5262169038987822
40,SATY NARAYAN,GEN,FAIZABAD,2242,9,BLKD,0,M,UTTAR PRADESH,686599,686485,114,1326533,717092,609441,0.16901200347070144,2242,0.3265370325328176
42,DURGA PRASAD TEWARI 'AFAT',GEN,FAIZABAD,2215,6,ABJS,0,M,UTTAR PRADESH,686599,686485,114,1326533,717092,609441,0.16697662251900255,2215,0.3226046061820655
34,ANGAD KUMAR,GEN,FAIZABAD,1992,12,IND,0,M,UTTAR PRADESH,686599,686485,114,1326533,717092,609441,0.15016588354756347,1992,0.2901256774332616
33,RUPENDRA KUMAR,GEN,FAIZABAD,1742,8,IJP,0,M,UTTAR PRADESH,686599,686485,114,1326533,717092,609441,0.13131976362442546,1742,0.2537143223337057
36,RAKESH SRIVASTAVA,GEN,FAIZABAD,1427,7,SJP(R),0,M,UTTAR PRADESH,686599,686485,114,1326533,717092,609441,0.1075736525212716,1427,0.20783601490826525
41,KAMLA PRASAD,SC,BARA BANKI (SC),196368,2,BSP,2,M,UTTAR PRADESH,540251,540219,32,1214993,653172,561821,16.162233033441346,196370,36.34791976322117
54,RAM SAGAR,SC,BARA BANKI (SC),175441,4,SP,7,M,UTTAR PRADESH,540251,540219,32,1214993,653172,561821,14.440247803896813,175448,32.47527538125797
38,RAM NARESH RAWAT,SC,BARA BANKI (SC),115974,3,BJP,20,M,UTTAR PRADESH,540251,540219,32,1214993,653172,561821,9.54688627835716,115994,21.470390614732782
63,ANAND PRAKASH GAUTAM,SC,BARA BANKI (SC),24754,1,INC,3,M,UTTAR PRADESH,540251,540219,32,1214993,653172,561821,2.0376249081270426,24757,4.582499615919267
36,SOHAN LAL,SC,BARA BANKI (SC),9259,11,IND,0,M,UTTAR PRADESH,540251,540219,32,1214993,653172,561821,0.7620620036494038,9259,1.7138330146542997
33,RAM SINGH,SC,BARA BANKI (SC),4673,7,AD,0,M,UTTAR PRADESH,540251,540219,32,1214993,653172,561821,0.3846112693653379,4673,0.8649683202807583
30,ANIL KUMAR,SC,BARA BANKI (SC),3614,5,RSBP,0,M,UTTAR PRADESH,540251,540219,32,1214993,653172,561821,0.2974502733760606,3614,0.6689483221687698
38,JAGAT JEET,SC,BARA BANKI (SC),3287,9,IND,0,M,UTTAR PRADESH,540251,540219,32,1214993,653172,561821,0.2705365380705897,3287,0.6084209006554361
25,RAJESH KUMAR,SC,BARA BANKI (SC),2785,10,IND,0,M,UTTAR PRADESH,540251,540219,32,1214993,653172,561821,0.2292194276016405,2785,0.5155011281793093
43,GURU LAL,SC,BARA BANKI (SC),2565,8,IND,0,M,UTTAR PRADESH,540251,540219,32,1214993,653172,561821,0.2111123273961249,2565,0.4747793155403692
38,GUDDI RAJ PAASI,SC,BARA BANKI (SC),1499,6,BKRP,0,F,UTTAR PRADESH,540251,540219,32,1214993,653172,561821,0.12337519640030847,1499,0.2774636233898688
63,BENI PRASAD VERMA,GEN,KAISERGANJ,219919,3,SP,1,M,UTTAR PRADESH,569950,569938,12,1272807,694193,578614,17.278346206455495,219920,38.585840863233614
51,ARIF MOHAMMAD KHAN,GEN,KAISERGANJ,207251,1,BJP,9,M,UTTAR PRADESH,569950,569938,12,1272807,694193,578614,16.283694228582966,207260,36.36459338538468
57,FARID MAHFOOZ KI,GEN,KAISERGANJ,112027,2,BSP,0,M,UTTAR PRADESH,569950,569938,12,1272807,694193,578614,8.801570073074707,112027,19.65558382314238
45,GYANENDRA PRATAP SINGH,GEN,KAISERGANJ,10152,4,INC,2,M,UTTAR PRADESH,569950,569938,12,1272807,694193,578614,0.797764311478488,10154,1.7815597859461356
57,SHRI PAL,SC,KAISERGANJ,9226,11,IND,0,M,UTTAR PRADESH,569950,569938,12,1272807,694193,578614,0.7248545930372791,9226,1.6187384858320906
34,SURESH CHANDRA,SC,KAISERGANJ,2587,10,IND,0,M,UTTAR PRADESH,569950,569938,12,1272807,694193,578614,0.2032515534562585,2587,0.45389946486533905
26,VED PRAKASH,SC,KAISERGANJ,2455,9,IND,0,M,UTTAR PRADESH,569950,569938,12,1272807,694193,578614,0.19288077454005204,2455,0.4307395385560137
37,ARJUN SINGH PATEL,GEN,KAISERGANJ,2178,5,AD,0,M,UTTAR PRADESH,569950,569938,12,1272807,694193,578614,0.17111785211740665,2178,0.38213878410386876
33,DURGESH SINGH,GEN,KAISERGANJ,1528,7,IND,0,M,UTTAR PRADESH,569950,569938,12,1272807,694193,578614,0.1200496226057839,1528,0.2680936924291605
44,DHANI RAM,SC,KAISERGANJ,1324,8,IND,0,M,UTTAR PRADESH,569950,569938,12,1272807,694193,578614,0.10402205518982846,1324,0.23230107904202124
43,UDAI PRATAP,GEN,KAISERGANJ,1291,6,IND,0,M,UTTAR PRADESH,569950,569938,12,1272807,694193,578614,0.10142936046077684,1291,0.22651109746468986
54,RUBAB SAYEDA,GEN,BAHRAICH,188949,5,SP,0,F,UTTAR PRADESH,549537,549535,2,1423646,775608,648038,13.27218985618616,188949,34.38330813029878
53,BHAGAT RAM MISHRA,GEN,BAHRAICH,162613,4,BSP,2,M,UTTAR PRADESH,549537,549535,2,1423646,775608,648038,11.42243226195276,162615,29.591274108931703
50,PADAM SEN CHAUDHARY,GEN,BAHRAICH,143780,3,BJP,0,M,UTTAR PRADESH,549537,549535,2,1423646,775608,648038,10.099420782975542,143780,26.16384338088245
57,D R ABDUL RAHMAN KHAN,GEN,BAHRAICH,22087,1,INC,0,M,UTTAR PRADESH,549537,549535,2,1423646,775608,648038,1.5514390515619754,22087,4.019201618817295
35,GHANSHYAM,SC,BAHRAICH,10055,10,IND,0,M,UTTAR PRADESH,549537,549535,2,1423646,775608,648038,0.7062851298707684,10055,1.8297221115229731
63,KEDAR CHAUHAN,GEN,BAHRAICH,6314,6,SBSP,0,M,UTTAR PRADESH,549537,549535,2,1423646,775608,648038,0.44350913078110715,6314,1.1489672214973696
31,PRAMOD KUMAR PATEL,GEN,BAHRAICH,5034,7,AD,0,M,UTTAR PRADESH,549537,549535,2,1423646,775608,648038,0.3535991391118298,5034,0.9160438696575481
48,GANGA RAM,GEN,BAHRAICH,4145,2,NCP,0,M,UTTAR PRADESH,549537,549535,2,1423646,775608,648038,0.291153840210277,4145,0.7542713229500471
30,BRIJENDRA KUMAR SINGH,GEN,BAHRAICH,3432,8,RJD,0,M,UTTAR PRADESH,549537,549535,2,1423646,775608,648038,0.24107116516324986,3432,0.6245257371205215
43,AKHILESH KUMAR,GEN,BAHRAICH,3126,9,IND,0,M,UTTAR PRADESH,549537,549535,2,1423646,775608,648038,0.21957705777981323,3126,0.5688424983213142
47,BRIJ BHUSHAN SHARAN SINGH,GEN,BALRAMPUR,270941,3,BJP,0,M,UTTAR PRADESH,698106,698106,0,1316006,723229,592777,20.588128017653414,270941,38.81086826355883
41,RIZWAN ZAHEER ALIAS RIJJU BHAYA,GEN,BALRAMPUR,218328,4,BSP,0,M,UTTAR PRADESH,698106,698106,0,1316006,723229,592777,16.590197917030775,218328,31.274333697174928
60,DR MOHD UMAR,GEN,BALRAMPUR,165090,1,SP,0,M,UTTAR PRADESH,698106,698106,0,1316006,723229,592777,12.544775631722043,165090,23.648271179448393
36,SRI RAM,GEN,BALRAMPUR,9363,14,IND,0,M,UTTAR PRADESH,698106,698106,0,1316006,723229,592777,0.711470920345348,9363,1.341200333473713
58,EKBAL SIDDIQUI,GEN,BALRAMPUR,9286,2,INC,0,M,UTTAR PRADESH,698106,698106,0,1316006,723229,592777,0.7056198831920218,9286,1.3301704898683007
29,AMEER HAIDER KHAN,GEN,BALRAMPUR,4874,5,AIMF,0,M,UTTAR PRADESH,698106,698106,0,1316006,723229,592777,0.3703630530559891,4874,0.6981747757503874
30,MOHD SHAJID,GEN,BALRAMPUR,3838,12,IND,0,M,UTTAR PRADESH,698106,698106,0,1316006,723229,592777,0.29164000772032955,3838,0.5497732436048394
53,PUJARAM SONKER ADVOCATE,SC,BALRAMPUR,3427,6,AD,0,M,UTTAR PRADESH,698106,698106,0,1316006,723229,592777,0.260409147070758,3427,0.49089966280192404
49,HOLI RAM,SC,BALRAMPUR,3127,13,IND,0,M,UTTAR PRADESH,698106,698106,0,1316006,723229,592777,0.23761289842143574,3127,0.44792624615746035
38,MOHD RAEES,GEN,BALRAMPUR,2468,11,IND,0,M,UTTAR PRADESH,698106,698106,0,1316006,723229,592777,0.18753713888842452,2468,0.35352797426178834
45,MOHD AHSAN,GEN,BALRAMPUR,2352,8,IND,0,M,UTTAR PRADESH,698106,698106,0,1316006,723229,592777,0.17872258941068658,2352,0.33691158649259567
32,JAFER ALI,GEN,BALRAMPUR,1852,9,IND,0,M,UTTAR PRADESH,698106,698106,0,1316006,723229,592777,0.14072884166181612,1852,0.2652892254184894
35,ARJUN,GEN,BALRAMPUR,1587,7,IND,0,M,UTTAR PRADESH,698106,698106,0,1316006,723229,592777,0.1205921553549148,1587,0.22732937404921316
32,POORAN,SC,BALRAMPUR,1573,10,IND,0,M,UTTAR PRADESH,698106,698106,0,1316006,723229,592777,0.11952833041794643,1573,0.22532394793913818
37,KIRTI VARDHAN SINGH ALIAS RAJA BHAIYA,GEN,GONDA,251938,1,SP,9,M,UTTAR PRADESH,606654,606622,32,1391430,754077,637353,18.10705533156537,251947,41.53059239698411
37,GHAN SHYAM SHUKLA,GEN,GONDA,214927,2,BJP,22,M,UTTAR PRADESH,606654,606622,32,1391430,754077,637353,15.448064221699978,214949,35.43189363294398
64,FAZLUL BARI ALIAS BANNE BHAI,GEN,GONDA,69543,3,BSP,0,M,UTTAR PRADESH,606654,606622,32,1391430,754077,637353,4.997951747482805,69543,11.463371213245113
38,VINAY KUMAR PANDEY ALIAS BINNOO,GEN,GONDA,28803,4,INC,1,M,UTTAR PRADESH,606654,606622,32,1391430,754077,637353,2.070100544044616,28804,4.748011222212332
43,SHRI KANT,GEN,GONDA,16874,15,IND,0,M,UTTAR PRADESH,606654,606622,32,1391430,754077,637353,1.2127092271979187,16874,2.7814866464244856
48,SURESH CHANDRA TRIPATHI ADVOCATE,GEN,GONDA,6002,5,CPI,0,M,UTTAR PRADESH,606654,606622,32,1391430,754077,637353,0.4313547932702328,6002,0.9893613163351762
43,RAM DAUL,GEN,GONDA,4460,8,AD,0,M,UTTAR PRADESH,606654,606622,32,1391430,754077,637353,0.3205335518136018,4460,0.7351801850807873
35,SANJEEV KUMAR,GEN,GONDA,4050,14,IND,0,M,UTTAR PRADESH,606654,606622,32,1391430,754077,637353,0.29106746296975056,4050,0.6675963564074415
33,SANYAJ KUMAR ALIAS SANJAY KUMAR,GEN,GONDA,2791,13,IND,0,M,UTTAR PRADESH,606654,606622,32,1391430,754077,637353,0.20058500966631448,2791,0.4600645507983133
58,GHAN SHYAM SHUKLA,GEN,GONDA,1660,9,IND,0,M,UTTAR PRADESH,606654,606622,32,1391430,754077,637353,0.1193017255629101,1660,0.2736320868237908
49,RAM HAUSILA,GEN,GONDA,1624,12,IND,0,M,UTTAR PRADESH,606654,606622,32,1391430,754077,637353,0.1167144592254012,1624,0.267697896989058
43,RAM KRIPAL RAHUL,GEN,GONDA,1030,7,NMNP,0,M,UTTAR PRADESH,606654,606622,32,1391430,754077,637353,0.07402456465650446,1030,0.1697837647159666
38,CHANDRA KISHOR,GEN,GONDA,995,6,BVP,0,M,UTTAR PRADESH,606654,606622,32,1391430,754077,637353,0.07150916682837082,995,0.16401441348775414
31,YOURAJ,GEN,GONDA,993,11,IND,0,M,UTTAR PRADESH,606654,606622,32,1391430,754077,637353,0.07136542980962032,993,0.16368473627471342
44,NITYA NAND SHUKLA,GEN,GONDA,932,10,IND,0,M,UTTAR PRADESH,606654,606622,32,1391430,754077,637353,0.06698145073773025,932,0.1536295812769717
52,LAL MANI PRASAD,SC,BASTI (SC),155221,3,BSP,2,M,UTTAR PRADESH,576404,576389,15,1416526,786406,630120,10.958005712567225,155223,26.92954941325876
49,SRIRAM CHAUHAN,SC,BASTI (SC),129841,4,BJP,8,M,UTTAR PRADESH,576404,576389,15,1416526,786406,630120,9.166721966275238,129849,22.527428678496335
43,RATNAKAR DHUSIYA,SC,BASTI (SC),127746,2,SP,3,M,UTTAR PRADESH,576404,576389,15,1416526,786406,630120,9.018471951803214,127749,22.16310088063233
37,UMED SINGH,SC,BASTI (SC),102335,1,INC,1,M,UTTAR PRADESH,576404,576389,15,1416526,786406,630120,7.224434990956749,102336,17.754214058195295
48,RAM NAWAL,SC,BASTI (SC),24205,7,BKD,0,M,UTTAR PRADESH,576404,576389,15,1416526,786406,630120,1.7087579049025574,24205,4.199311593951465
30,HARI PAL,SC,BASTI (SC),11669,13,IND,0,M,UTTAR PRADESH,576404,576389,15,1416526,786406,630120,0.8237759137495535,11669,2.02444813013095
57,RAM MILAN GOND,SC,BASTI (SC),6513,8,AD,0,M,UTTAR PRADESH,576404,576389,15,1416526,786406,630120,0.4597868305982382,6513,1.1299366416610572
53,RAM DAS,SC,BASTI (SC),3797,12,IND,0,M,UTTAR PRADESH,576404,576389,15,1416526,786406,630120,0.26805014521441894,3797,0.6587393564236196
39,GAURA,SC,BASTI (SC),3661,10,IND,0,F,UTTAR PRADESH,576404,576389,15,1416526,786406,630120,0.2584491918962306,3661,0.6351447942762368
42,NAND KUMAR NAG,SC,BASTI (SC),3587,11,IND,0,M,UTTAR PRADESH,576404,576389,15,1416526,786406,630120,0.25322514376721644,3587,0.6223065766372198
30,RAMESH,SC,BASTI (SC),3258,5,MNVP,0,M,UTTAR PRADESH,576404,576389,15,1416526,786406,630120,0.22999930816659914,3258,0.5652285549718601
26,VIJAY,SC,BASTI (SC),2761,9,ABHM,0,M,UTTAR PRADESH,576404,576389,15,1416526,786406,630120,0.19491347140821982,2761,0.47900430947738043
58,RAM DULAREY SONKAR,SC,BASTI (SC),1795,6,RJD,1,M,UTTAR PRADESH,576404,576389,15,1416526,786406,630120,0.1267890599960749,1796,0.31158701188749555
53,MOHD MUQUEEM,GEN,DOMARIAGANJ,202544,3,BSP,0,M,UTTAR PRADESH,643129,643127,2,1350045,740016,610029,15.002759167287017,202544,31.493526182150084
47,JAGDAMBIKA PAL,GEN,DOMARIAGANJ,149641,1,INC,1,M,UTTAR PRADESH,643129,643127,2,1350045,740016,610029,11.084223118488643,149642,23.26780474834753
54,BRIJ BHUSHAN TIWARI,GEN,DOMARIAGANJ,133439,2,SP,0,M,UTTAR PRADESH,643129,643127,2,1350045,740016,610029,9.884040902340292,133439,20.74840350847186
73,RAM PAL SINGH,GEN,DOMARIAGANJ,115103,4,BJP,1,M,UTTAR PRADESH,643129,643127,2,1350045,740016,610029,8.52593802428808,115104,17.897498013617795
40,MOHD SAMEEM,GEN,DOMARIAGANJ,13345,12,IND,0,M,UTTAR PRADESH,643129,643127,2,1350045,740016,610029,0.9884855689995519,13345,2.0750113896278974
54,VASUDEV NISHAD,GEN,DOMARIAGANJ,5980,7,BEP,0,M,UTTAR PRADESH,643129,643127,2,1350045,740016,610029,0.4429481980230288,5980,0.9298290078662291
35,RAM SAMUJH,GEN,DOMARIAGANJ,4680,11,IND,0,M,UTTAR PRADESH,643129,643127,2,1350045,740016,610029,0.3466551114962834,4680,0.7276922670257444
55,RAM KRIPAL MAURYA,GEN,DOMARIAGANJ,4613,10,IND,0,M,UTTAR PRADESH,643129,643127,2,1350045,740016,610029,0.341692313959905,4613,0.7172744503824271
36,MOLVI MAHPHOOJURRAHMAN FALAHI,GEN,DOMARIAGANJ,4415,5,RJD,0,M,UTTAR PRADESH,643129,643127,2,1350045,740016,610029,0.32702613616583154,4415,0.6864874698544149
43,BHOOP NARYAN URF SHAMBHOOSINGH,GEN,DOMARIAGANJ,3560,9,IND,0,M,UTTAR PRADESH,643129,643127,2,1350045,740016,610029,0.2636949138732413,3560,0.5535436903016346
28,RAM BRIKSH SINGH LODHI,GEN,DOMARIAGANJ,3531,6,AD,0,M,UTTAR PRADESH,643129,643127,2,1350045,740016,610029,0.2615468373276446,3531,0.5490344860828854
30,ANIL KUMAR,GEN,DOMARIAGANJ,2276,8,IND,0,M,UTTAR PRADESH,643129,643127,2,1350045,740016,610029,0.16858697302682504,2276,0.3538947862714945
40,BHALCHANDRA YADAVA,GEN,KHALILABAD,234712,1,BSP,0,M,UTTAR PRADESH,700715,700710,5,1397045,780616,616429,16.800604132293522,234712,33.49607186944763
38,BHISHMA SHANKAR TIWARI ALIAS KUSHAL,GEN,KHALILABAD,207687,2,SP,2,M,UTTAR PRADESH,700715,700710,5,1397045,780616,616429,14.866307098196552,207689,29.639582426521482
53,RAM PRASAD CHAUDHARY,GEN,KHALILABAD,177415,3,BJP,2,M,UTTAR PRADESH,700715,700710,5,1397045,780616,616429,12.699447762956812,177417,25.319423731474277
40,MOHAMMAD ARSHAD KHAN,GEN,KHALILABAD,45350,4,NLP,1,M,UTTAR PRADESH,700715,700710,5,1397045,780616,616429,3.2462089624886814,45351,6.472103494287977
46,SHIVPUJAN ARYA,SC,KHALILABAD,14643,14,IND,0,M,UTTAR PRADESH,700715,700710,5,1397045,780616,616429,1.0481408973941426,14643,2.0897226404458307
42,RAMCHET CHAURASIA,GEN,KHALILABAD,4864,13,IND,0,M,UTTAR PRADESH,700715,700710,5,1397045,780616,616429,0.3481634449856662,4864,0.694148120134434
36,BHAGWAN DAS,SC,KHALILABAD,4025,12,IND,0,M,UTTAR PRADESH,700715,700710,5,1397045,780616,616429,0.28810811391186397,4025,0.5744132778661796
41,BABOO RAM,GEN,KHALILABAD,2890,11,IND,0,M,UTTAR PRADESH,700715,700710,5,1397045,780616,616429,0.20686520477149983,2890,0.412435869076586
41,RADHE SHYAM PATEL,GEN,KHALILABAD,2548,5,AD,0,M,UTTAR PRADESH,700715,700710,5,1397045,780616,616429,0.1823849625459452,2548,0.36362857937963367
38,PHOOLA DEVI,GEN,KHALILABAD,1509,10,IND,0,F,UTTAR PRADESH,700715,700710,5,1397045,780616,616429,0.10801370034608765,1509,0.21535146243479875
25,RAM NATH CHAURASIA,GEN,KHALILABAD,1386,7,RSMD,0,M,UTTAR PRADESH,700715,700710,5,1397045,780616,616429,0.09920940270356358,1386,0.1977979635087018
40,RAM KEWAL NIGAM,SC,KHALILABAD,1372,6,SSD,0,M,UTTAR PRADESH,700715,700710,5,1397045,780616,616429,0.09820728752473971,1372,0.19580000428134123
43,KESHAVA RAM,SC,KHALILABAD,1174,8,IND,0,M,UTTAR PRADESH,700715,700710,5,1397045,780616,616429,0.08403451570994491,1174,0.16754315235152664
58,GABBOO,SC,KHALILABAD,1135,9,IND,0,M,UTTAR PRADESH,700715,700710,5,1397045,780616,616429,0.08124290914036413,1135,0.1619774087895935
60,MAHAVEER PRASAD,SC,BANSGAON (SC),180387,1,INC,1,M,UTTAR PRADESH,632109,632098,11,1441224,770646,670578,12.516305584697452,180388,28.53748325051534
49,SADAL PRASAD,SC,BANSGAON (SC),163946,3,BSP,1,M,UTTAR PRADESH,632109,632098,11,1441224,770646,670578,11.375539125077019,163947,25.936507785840735
46,SABHAWATI PASWAN,SC,BANSGAON (SC),135499,4,SP,2,F,UTTAR PRADESH,632109,632098,11,1441224,770646,670578,9.4018001365506,135501,21.436334556223688
60,RAJ NARAYAN,SC,BANSGAON (SC),126890,2,BJP,7,M,UTTAR PRADESH,632109,632098,11,1441224,770646,670578,8.804807580223477,126897,20.075176907780147
64,RAM PRASAD,SC,BANSGAON (SC),10813,9,IND,0,M,UTTAR PRADESH,632109,632098,11,1441224,770646,670578,0.7502650524831671,10813,1.7106226932380335
40,DWARIKA PRASAD,SC,BANSGAON (SC),4604,5,ASP,0,M,UTTAR PRADESH,632109,632098,11,1441224,770646,670578,0.31945068913645625,4604,0.7283553944019149
39,JOKHAN,SC,BANSGAON (SC),3412,7,IND,0,M,UTTAR PRADESH,632109,632098,11,1441224,770646,670578,0.23674321271363788,3412,0.5397803226975094
37,RAM JAS,SC,BANSGAON (SC),3313,8,IND,0,M,UTTAR PRADESH,632109,632098,11,1441224,770646,670578,0.2298740515006689,3313,0.5241184669099791
30,SUDARSHAN,SC,BANSGAON (SC),3234,6,ABHM,0,M,UTTAR PRADESH,632109,632098,11,1441224,770646,670578,0.22439259962365324,3234,0.5116206223926569
30,ADITYA NATH,GEN,GORAKHPUR,353619,1,BJP,28,M,UTTAR PRADESH,689248,689217,31,1432002,769309,662693,24.695985061473376,353647,51.30910789730257
50,JAMUNA NISHAD,GEN,GORAKHPUR,211606,2,SP,2,M,UTTAR PRADESH,689248,689217,31,1432002,769309,662693,14.777074333695065,211608,30.70128603927759
38,PRADEEP KUMAR NISHAD,GEN,GORAKHPUR,70448,3,BSP,1,M,UTTAR PRADESH,689248,689217,31,1432002,769309,662693,4.919616034055818,70449,10.221139560796694
59,SHARDENDU PANDEY,GEN,GORAKHPUR,33477,4,INC,0,M,UTTAR PRADESH,689248,689217,31,1432002,769309,662693,2.337776064558569,33477,4.857032592042342
31,RAM MILAN,SC,GORAKHPUR,8785,9,IND,0,M,UTTAR PRADESH,689248,689217,31,1432002,769309,662693,0.6134767968201161,8785,1.274577510562236
42,CHANDRA BHAN SINGH PATEL,GEN,GORAKHPUR,3225,6,AD,0,M,UTTAR PRADESH,689248,689217,31,1432002,769309,662693,0.2252091826687393,3225,0.46790124889734896
31,GOPAL RAJBHAR,GEN,GORAKHPUR,3081,5,SBSP,0,M,UTTAR PRADESH,689248,689217,31,1432002,769309,662693,0.21515333079143742,3081,0.4470089140628627
30,RAM KISHUM,GEN,GORAKHPUR,2716,8,IND,0,M,UTTAR PRADESH,689248,689217,31,1432002,769309,662693,0.1896645395746654,2716,0.3940526486837829
59,MAHANTH RAMDAS BRAHMCHARI,GEN,GORAKHPUR,2260,7,ABHM,0,M,UTTAR PRADESH,689248,689217,31,1432002,769309,662693,0.15782100862987622,2260,0.32789358837457633
40,PANKAJ,GEN,MAHARAJGANJ,228697,3,BJP,5,M,UTTAR PRADESH,746622,746614,8,1311205,712260,598945,17.44212384791089,228702,30.631564566808905
39,AKHILESH,GEN,MAHARAJGANJ,163902,1,SP,1,M,UTTAR PRADESH,746622,746614,8,1311205,712260,598945,12.50018113109697,163903,21.952607879221347
56,HARSH VARDHAN,GEN,MAHARAJGANJ,161552,4,INC,2,M,UTTAR PRADESH,746622,746614,8,1311205,712260,598945,12.32103294297993,161554,21.637990844095135
58,TALAT AJIZ,GEN,MAHARAJGANJ,157438,2,BSP,0,F,UTTAR PRADESH,746622,746614,8,1311205,712260,598945,12.00712321871866,157438,21.086707865559813
32,RAM NIVAS,GEN,MAHARAJGANJ,11993,10,IND,0,M,UTTAR PRADESH,746622,746614,8,1311205,712260,598945,0.914654840394904,11993,1.6063014483902163
30,OM PRAKASH,GEN,MAHARAJGANJ,6217,5,BEP,0,M,UTTAR PRADESH,746622,746614,8,1311205,712260,598945,0.4741440125685915,6217,0.8326837409023575
43,PASHUPATI NATH,GEN,MAHARAJGANJ,5093,8,IND,0,M,UTTAR PRADESH,746622,746614,8,1311205,712260,598945,0.38842133762455144,5093,0.6821390208164239
40,GAURI SHANKAR,GEN,MAHARAJGANJ,4328,6,AD,0,M,UTTAR PRADESH,746622,746614,8,1311205,712260,598945,0.33007805796957757,4328,0.5796775342810686
48,RANJEET,GEN,MAHARAJGANJ,4220,9,IND,0,M,UTTAR PRADESH,746622,746614,8,1311205,712260,598945,0.321841359665346,4220,0.5652123832407832
36,AMAR JEET,SC,MAHARAJGANJ,3174,7,IND,0,M,UTTAR PRADESH,746622,746614,8,1311205,712260,598945,0.2420674112743621,3174,0.42511471668394446
49,BALESHWAR YADAV,GEN,PADRAUNA,206848,7,NLP,2,M,UTTAR PRADESH,790050,790041,9,1501706,821863,679843,13.774333990807788,206850,26.1818872223277
39,KUNWAR RATANJEET PRATAP NARAYAN,GEN,PADRAUNA,198428,2,INC,0,M,UTTAR PRADESH,790050,790041,9,1501706,821863,679843,13.213505173449397,198428,25.115878741851784
32,N P KUSHWAHA,GEN,PADRAUNA,168869,1,BSP,0,M,UTTAR PRADESH,790050,790041,9,1501706,821863,679843,11.245143856387335,168869,21.374469970255046
73,RAM NAGINA MISHRA,GEN,PADRAUNA,115969,4,BJP,6,M,UTTAR PRADESH,790050,790041,9,1501706,821863,679843,7.722883174203206,115975,14.679450667679262
44,RAM AAWAD YADAV,GEN,PADRAUNA,66651,3,SP,1,M,UTTAR PRADESH,790050,790041,9,1501706,821863,679843,4.438418705126037,66652,8.436428074172522
26,RAM LAKHAN,GEN,PADRAUNA,16631,8,IND,0,M,UTTAR PRADESH,790050,790041,9,1501706,821863,679843,1.1074737665028973,16631,2.1050566419846843
42,DR PRABHAKAR MISHRA,GEN,PADRAUNA,8902,6,SHS,0,M,UTTAR PRADESH,790050,790041,9,1501706,821863,679843,0.592792464037568,8902,1.1267641288526042
25,AMIRUDDIN,GEN,PADRAUNA,7743,5,AD,0,M,UTTAR PRADESH,790050,790041,9,1501706,821863,679843,0.5156135754934721,7743,0.9800645528764002
58,MOHAN SINGH,GEN,DEORIA,237663,2,SP,1,M,UTTAR PRADESH,729788,729775,13,1569719,854827,714892,15.140544263017775,237664,32.566169901396016
59,SRIPRAKASH MANI,GEN,DEORIA,185428,4,BJP,10,M,UTTAR PRADESH,729788,729775,13,1569719,854827,714892,11.813451961784242,185438,25.409845050891494
68,DEVI PRASAD,GEN,DEORIA,132496,1,BSP,1,M,UTTAR PRADESH,729788,729775,13,1569719,854827,714892,8.440810106777073,132497,18.155546542283513
40,RAMASHISH RAI,GEN,DEORIA,105187,3,INC,1,M,UTTAR PRADESH,729788,729775,13,1569719,854827,714892,6.701071975302586,105188,14.41350090711275
43,CHANDRIKA PRASAD,GEN,DEORIA,26161,5,AD,0,M,UTTAR PRADESH,729788,729775,13,1569719,854827,714892,1.6666040227582133,26161,3.5847396778242446
40,HAROON,GEN,DEORIA,11158,9,NLP,0,M,UTTAR PRADESH,729788,729775,13,1569719,854827,714892,0.7108278615471941,11158,1.528937170794806
36,RAM BHAJAN,SC,DEORIA,10498,12,IND,0,M,UTTAR PRADESH,729788,729775,13,1569719,854827,714892,0.6687821196022983,10498,1.4384999479300837
27,SURESH,GEN,DEORIA,9200,8,SBSP,0,M,UTTAR PRADESH,729788,729775,13,1569719,854827,714892,0.586092160444003,9200,1.2606400762961298
59,KADAM PRASAD,GEN,DEORIA,3798,10,IND,0,M,UTTAR PRADESH,729788,729775,13,1569719,854827,714892,0.2419541331919917,3798,0.5204251097579023
49,MOHAN,GEN,DEORIA,3529,11,IND,0,M,UTTAR PRADESH,729788,729775,13,1569719,854827,714892,0.22481730806596595,3529,0.4835650901357655
33,VIJAY,GEN,DEORIA,2343,7,JP,0,M,UTTAR PRADESH,729788,729775,13,1569719,854827,714892,0.14926238390438035,2343,0.3210521411697644
44,NAND LAL YADAV,GEN,DEORIA,2314,6,IJP,0,M,UTTAR PRADESH,729788,729775,13,1569719,854827,714892,0.14741491948558946,2314,0.31707838440752656
66,HARIKEVAL PRASAD,GEN,SALEMPUR,195559,3,SP,11,M,UTTAR PRADESH,669623,669579,44,1484606,801608,682998,13.173192079245268,195570,29.205986054839812
49,BHOLA PANDEY,GEN,SALEMPUR,179298,1,INC,19,M,UTTAR PRADESH,669623,669579,44,1484606,801608,682998,12.078423500915395,179317,26.778799413998623
43,RAM SHANKER RAJBHAR VIDYARTHI JI,GEN,SALEMPUR,132010,2,BSP,3,M,UTTAR PRADESH,669623,669579,44,1484606,801608,682998,8.892123566791458,132013,19.714525934742387
57,RAJDHARI,GEN,SALEMPUR,104910,7,JD(U),7,M,UTTAR PRADESH,669623,669579,44,1484606,801608,682998,7.066992858711335,104917,15.668069943834068
42,GULAG CHAND GUPTA,GEN,SALEMPUR,23220,5,SBSP,0,M,UTTAR PRADESH,669623,669579,44,1484606,801608,682998,1.5640513375265896,23220,3.4676228265755507
48,BHOLA,GEN,SALEMPUR,9067,15,IND,0,M,UTTAR PRADESH,669623,669579,44,1484606,801608,682998,0.6107344305492501,9067,1.3540454852954573
38,RAJESH SAHANI,GEN,SALEMPUR,6039,8,CPI(ML)(L),1,M,UTTAR PRADESH,669623,669579,44,1484606,801608,682998,0.4068419499853833,6040,0.9020000806423913
38,KAILASH,SC,SALEMPUR,3395,14,IND,0,M,UTTAR PRADESH,669623,669579,44,1484606,801608,682998,0.22868020201992986,3395,0.5070017009571057
38,ONKAR NATH,GEN,SALEMPUR,3212,4,ABHM,1,M,UTTAR PRADESH,669623,669579,44,1484606,801608,682998,0.21642105716937693,3213,0.4798222283284774
38,UPENDRA,GEN,SALEMPUR,2922,13,IND,0,M,UTTAR PRADESH,669623,669579,44,1484606,801608,682998,0.19681989699624008,2922,0.43636493967501117
69,GAURI SHANKER TRIPATHI,GEN,SALEMPUR,2758,6,JP,2,M,UTTAR PRADESH,669623,669579,44,1484606,801608,682998,0.18590791092047315,2760,0.41217222228029804
38,SAUKAT ALI,GEN,SALEMPUR,2182,10,AD,0,M,UTTAR PRADESH,669623,669579,44,1484606,801608,682998,0.1469750223291567,2182,0.3258549960201486
56,RAM BADAN KAUL,SC,SALEMPUR,2114,9,ASP,0,M,UTTAR PRADESH,669623,669579,44,1484606,801608,682998,0.14239468249488416,2114,0.31570002822483695
51,HEERA LAL,GEN,SALEMPUR,1768,11,LPSP,0,M,UTTAR PRADESH,669623,669579,44,1484606,801608,682998,0.11908883569108572,1768,0.26402916267810395
31,UTTAM VIHARI KUSHWAHA,GEN,SALEMPUR,1125,12,IND,0,M,UTTAR PRADESH,669623,669579,44,1484606,801608,682998,0.0757776810817146,1125,0.16800498190773017
65,CHANDRA SHEKHAR,GEN,BALLIA,270021,4,SJP(R),115,M,UTTAR PRADESH,619762,619531,231,1430300,793732,636568,18.88666713276935,270136,43.5870543853931
60,KAPILDEO YADAV,GEN,BALLIA,189070,1,BSP,12,M,UTTAR PRADESH,619762,619531,231,1430300,793732,636568,13.219744109627351,189082,30.508808219929584
58,PARMATMA NAND TIWARI ALIAS P N TIWARI,GEN,BALLIA,109401,2,BJP,98,M,UTTAR PRADESH,619762,619531,231,1430300,793732,636568,7.655666643361532,109499,17.667911230440073
40,OM PRAKASH,GEN,BALLIA,28265,3,SBSP,1,M,UTTAR PRADESH,619762,619531,231,1430300,793732,636568,1.976228763196532,28266,4.560783010252322
40,SURESH,GEN,BALLIA,5266,15,IND,0,M,UTTAR PRADESH,619762,619531,231,1430300,793732,636568,0.3681745088442984,5266,0.8496810065799452
38,RAJESH KUMAR SINGH KUSHWAHA,GEN,BALLIA,4730,6,RSD,0,M,UTTAR PRADESH,619762,619531,231,1430300,793732,636568,0.33069985317765505,4730,0.7631961946682758
39,MOHAN RAM,SC,BALLIA,2229,5,ASP,1,M,UTTAR PRADESH,619762,619531,231,1430300,793732,636568,0.15591134726980355,2230,0.3598155420951914
34,SURENDAR ALIAS SHWETA,SC,BALLIA,2075,14,IND,1,M,UTTAR PRADESH,619762,619531,231,1430300,793732,636568,0.1451443753058799,2076,0.33496729389668933
44,SRIRAM CHAUDHARY,GEN,BALLIA,2008,7,CPI(ML)(L),0,M,UTTAR PRADESH,619762,619531,231,1430300,793732,636568,0.14039012794518632,2008,0.3239953401467015
47,SUBHASH,SC,BALLIA,1536,13,IND,2,M,UTTAR PRADESH,619762,619531,231,1430300,793732,636568,0.10752988883451024,1538,0.24815977746296158
32,HARENDRA YADAV JI MAHARAJ,GEN,BALLIA,1458,8,AD,0,M,UTTAR PRADESH,619762,619531,231,1430300,793732,636568,0.10193665664545899,1458,0.23525159658062286
37,VIRENDRA,GEN,BALLIA,967,12,IND,0,M,UTTAR PRADESH,619762,619531,231,1430300,793732,636568,0.06760819408515696,967,0.1560276364152691
38,MILAN,SC,BALLIA,890,11,IND,0,M,UTTAR PRADESH,619762,619531,231,1430300,793732,636568,0.06222470810319514,890,0.1436035123160181
45,MAHESHWAR,GEN,BALLIA,870,10,IND,1,M,UTTAR PRADESH,619762,619531,231,1430300,793732,636568,0.060896315458295464,871,0.14053781935646265
46,KAILASH CHAUDHARI,GEN,BALLIA,745,9,IND,0,M,UTTAR PRADESH,619762,619531,231,1430300,793732,636568,0.05208697476053975,745,0.12020743446677917
48,CHANDRADEO PRASAD RAJBHAR,GEN,GHOSI,201445,2,SP,23,M,UTTAR PRADESH,721582,721463,119,1427284,781662,645622,14.115480871361271,201468,27.920319520165414
55,BAL KRISHNA,GEN,GHOSI,180444,3,BSP,12,M,UTTAR PRADESH,721582,721463,119,1427284,781662,645622,12.643314154716231,180456,25.008384355485585
49,SUDHA RAI,GEN,GHOSI,136773,5,INC,21,F,UTTAR PRADESH,721582,721463,119,1427284,781662,645622,9.584217296627722,136794,18.95751279826825
48,BHARAT LAL RAHI KUSHWAHA,GEN,GHOSI,53937,4,BJP,47,M,UTTAR PRADESH,721582,721463,119,1427284,781662,645622,3.782288598484955,53984,7.481339612130014
36,AKSHAY KUMAR RAJBHAR,GEN,GHOSI,52069,6,SBSP,3,M,UTTAR PRADESH,721582,721463,119,1427284,781662,645622,3.6483278730792192,52072,7.216366261907864
49,ATUL KUMAR SINGH ANJAN,GEN,GHOSI,30921,1,CPI,2,M,UTTAR PRADESH,721582,721463,119,1427284,781662,645622,2.166562506130525,30923,4.285445036045799
29,SIDDHARTH RAI,GEN,GHOSI,18102,11,RJD,8,M,UTTAR PRADESH,721582,721463,119,1427284,781662,645622,1.2688434817457492,18110,2.5097632701480914
30,RAMESH,GEN,GHOSI,12263,16,IND,0,M,UTTAR PRADESH,721582,721463,119,1427284,781662,645622,0.8591842968883557,12263,1.6994603523923821
43,ZIYAUDDIN,GEN,GHOSI,8336,8,AD,0,M,UTTAR PRADESH,721582,721463,119,1427284,781662,645622,0.5840463425639186,8336,1.155239459964356
68,MUNNAR,GEN,GHOSI,4115,10,ABHM,1,M,UTTAR PRADESH,721582,721463,119,1427284,781662,645622,0.28837988795502506,4116,0.5704133417962199
63,HESHAMUDDIN,GEN,GHOSI,2803,23,IND,0,M,UTTAR PRADESH,721582,721463,119,1427284,781662,645622,0.19638698394993567,2803,0.3884520401007786
30,KAUSHALENDRA,GEN,GHOSI,2303,14,IND,0,M,UTTAR PRADESH,721582,721463,119,1427284,781662,645622,0.161355413498645,2303,0.31915984600502784
36,AKHLAQ AHMAD GULSHAN,GEN,GHOSI,2076,7,PSJP,1,M,UTTAR PRADESH,721582,721463,119,1427284,781662,645622,0.14552114365466157,2077,0.2878397742737485
42,RAJENDRA KUMAR AGRAWAL,GEN,GHOSI,2026,17,IND,0,M,UTTAR PRADESH,721582,721463,119,1427284,781662,645622,0.14194792346862992,2026,0.2807719704759819
38,RAMA SANKAR,SC,GHOSI,1993,15,IND,0,M,UTTAR PRADESH,721582,721463,119,1427284,781662,645622,0.13963583981884473,1993,0.27619868566566236
41,RAM ASHISH,SC,GHOSI,1736,19,IND,0,M,UTTAR PRADESH,721582,721463,119,1427284,781662,645622,0.12162961260688131,1736,0.2405824979004465
30,HEMANT KUMAR,SC,GHOSI,1695,12,BRPP,0,M,UTTAR PRADESH,721582,721463,119,1427284,781662,645622,0.11875702382987549,1695,0.23490053798459498
37,KANHAIYA LAL,SC,GHOSI,1694,13,IND,0,M,UTTAR PRADESH,721582,721463,119,1427284,781662,645622,0.11868696068897291,1694,0.23476195359640345
42,RAM AWADH,GEN,GHOSI,1672,18,IND,1,M,UTTAR PRADESH,721582,721463,119,1427284,781662,645622,0.1172156347300187,1673,0.23185168144438192
63,PREM PRAKASH,SC,GHOSI,1630,9,ASP,0,M,UTTAR PRADESH,721582,721463,119,1427284,781662,645622,0.11420291967120769,1630,0.22589255275214737
50,HARI LAL,GEN,GHOSI,1451,22,IND,0,M,UTTAR PRADESH,721582,721463,119,1427284,781662,645622,0.10166161744964562,1451,0.2010859472658686
32,RAM PRAKASH,SC,GHOSI,1024,20,IND,0,M,UTTAR PRADESH,721582,721463,119,1427284,781662,645622,0.07174465628424337,1024,0.1419104135080975
38,RAMU RAJBHAR,GEN,GHOSI,955,21,IND,0,M,UTTAR PRADESH,721582,721463,119,1427284,781662,645622,0.06691029956196524,955,0.1323480907228839
43,RAMAKANT YADAV,GEN,AZAMGARH,258210,2,BSP,6,M,UTTAR PRADESH,711430,711356,74,1425023,773683,651340,18.120128587398238,258216,36.29534880452047
50,DURGA PRASAD YADAV,GEN,AZAMGARH,251221,1,SP,27,M,UTTAR PRADESH,711430,711356,74,1425023,773683,651340,17.63115402347892,251248,35.31591302025498
72,RAM NARESH YADAV,GEN,AZAMGARH,97174,3,INC,11,M,UTTAR PRADESH,711430,711356,74,1425023,773683,651340,6.8198899245836735,97185,13.660514737922213
42,DR KRISHAN MOHAN TRIPATHI,GEN,AZAMGARH,40536,5,SBSP,0,M,UTTAR PRADESH,711430,711356,74,1425023,773683,651340,2.8445856663366134,40536,5.697819883895815
47,SHAH MOHAMMAD,GEN,AZAMGARH,34705,4,BJP,30,M,UTTAR PRADESH,711430,711356,74,1425023,773683,651340,2.437504517470946,34735,4.882419914819448
38,RAM NAYAN,SC,AZAMGARH,10102,13,IND,0,M,UTTAR PRADESH,711430,711356,74,1425023,773683,651340,0.7089008387934791,10102,1.4199569880381766
38,RAM KISHUN NISHAD,GEN,AZAMGARH,4180,10,IND,0,M,UTTAR PRADESH,711430,711356,74,1425023,773683,651340,0.29332859890682467,4180,0.5875490209859016
46,RAMTAJEE RAJBHAR,SC,AZAMGARH,3492,12,IND,0,F,UTTAR PRADESH,711430,711356,74,1425023,773683,651340,0.24504867640732816,3492,0.49084238786669104
60,RAJPATI VISHWAKARMA,GEN,AZAMGARH,3438,6,AD,0,M,UTTAR PRADESH,711430,711356,74,1425023,773683,651340,0.24125926388556534,3438,0.48325204166256697
38,RAM JATAN RAM,SC,AZAMGARH,2720,11,IND,0,M,UTTAR PRADESH,711430,711356,74,1425023,773683,651340,0.19087411220731176,2720,0.38232854954106515
49,VASDEV MAURYA,GEN,AZAMGARH,2463,7,RSMD,0,M,UTTAR PRADESH,711430,711356,74,1425023,773683,651340,0.1728393155759591,2463,0.34620412408810425
28,SADRE ALAM AZMI,GEN,AZAMGARH,1666,8,RSBP,0,M,UTTAR PRADESH,711430,711356,74,1425023,773683,651340,0.11691039372697845,1666,0.2341762365939024
48,DAN BAHADUR YADAV,GEN,AZAMGARH,1449,9,IND,0,M,UTTAR PRADESH,711430,711356,74,1425023,773683,651340,0.10168256933396864,1449,0.20367428981066302
54,DAROGA PRASAD SAROJ,SC,LALGANJ (SC),283445,2,SP,28,M,UTTAR PRADESH,763618,763526,92,1558349,838475,719874,18.190597869925156,283473,37.12235699001333
50,DR BALIRAM,SC,LALGANJ (SC),240734,3,BSP,8,M,UTTAR PRADESH,763618,763526,92,1558349,838475,719874,15.448529180562248,240742,31.5264962324094
58,KALPNATH,SC,LALGANJ (SC),162415,1,BJP,51,M,UTTAR PRADESH,763618,763526,92,1558349,838475,719874,10.425520855726155,162466,21.275821156651624
44,GOPAL SHARAN KANNAUJIA,SC,LALGANJ (SC),31063,4,SBSP,1,M,UTTAR PRADESH,763618,763526,92,1558349,838475,719874,1.9933917241901526,31064,4.068002587681275
45,DEEPCHANDRA VISHARAD,SC,LALGANJ (SC),15329,6,LJNSP,2,M,UTTAR PRADESH,763618,763526,92,1558349,838475,719874,0.9837975960455585,15331,2.0076792322863004
58,SEWARAM,SC,LALGANJ (SC),10642,10,IND,0,M,UTTAR PRADESH,763618,763526,92,1558349,838475,719874,0.6829022253680017,10642,1.393628751548549
60,CHHOTEYLAL NIRBHAYA,SC,LALGANJ (SC),9494,5,NLP,1,M,UTTAR PRADESH,763618,763526,92,1558349,838475,719874,0.6092986872645345,9495,1.2434227584996687
48,VISARJAN,SC,LALGANJ (SC),3951,9,IND,1,M,UTTAR PRADESH,763618,763526,92,1558349,838475,719874,0.2536017284959916,3952,0.5175362550385141
50,LALBIHARI MRITAK,SC,LALGANJ (SC),3400,8,IND,0,M,UTTAR PRADESH,763618,763526,92,1558349,838475,719874,0.2181796247182114,3400,0.445248802411677
32,DHRUV KANT,SC,LALGANJ (SC),3053,7,RSBP,0,M,UTTAR PRADESH,763618,763526,92,1558349,838475,719874,0.19591246890138217,3053,0.3998072334596618
43,UMAKANT YADAV,GEN,MACHHLISHAHR,237437,1,BSP,1,M,UTTAR PRADESH,676371,676338,33,1474056,793266,680790,16.10780051775509,237438,35.10469845691196
50,CHANDRA NATH SINGH,GEN,MACHHLISHAHR,182048,3,SP,8,M,UTTAR PRADESH,676371,676338,33,1474056,793266,680790,12.350684098840208,182056,26.916588676924352
69,KESHARI NATH TRIPATHI,GEN,MACHHLISHAHR,170922,2,BJP,17,M,UTTAR PRADESH,676371,676338,33,1474056,793266,680790,11.596506509929066,170939,25.27296409810592
42,SAFDAR RAZA KHAN,GEN,MACHHLISHAHR,29746,9,AD,0,M,UTTAR PRADESH,676371,676338,33,1474056,793266,680790,2.0179694665602934,29746,4.397882227357472
33,DEOVRAT MISHRA,GEN,MACHHLISHAHR,18080,4,INC,7,M,UTTAR PRADESH,676371,676338,33,1474056,793266,680790,1.22702258258845,18087,2.674124112358454
27,VIJAY KUMAR,SC,MACHHLISHAHR,11492,14,IND,0,M,UTTAR PRADESH,676371,676338,33,1474056,793266,680790,0.7796175993313688,11492,1.6990675235928212
51,SITARAM PATEL,GEN,MACHHLISHAHR,6681,5,CPI,0,M,UTTAR PRADESH,676371,676338,33,1474056,793266,680790,0.4532392256467868,6681,0.9877715041005602
25,ANIL KUMAR ALIAS AWADHESHANAND,GEN,MACHHLISHAHR,4312,10,IND,0,M,UTTAR PRADESH,676371,676338,33,1474056,793266,680790,0.29252619981873146,4312,0.6375199409791371
50,JAGANNATH VERMA (PATRAKAR),GEN,MACHHLISHAHR,3401,12,IND,0,M,UTTAR PRADESH,676371,676338,33,1474056,793266,680790,0.23072393450452358,3401,0.5028305471405486
50,MATHURA PRASAD,SC,MACHHLISHAHR,3202,13,IND,0,M,UTTAR PRADESH,676371,676338,33,1474056,793266,680790,0.2172237689748558,3202,0.47340882444693816
50,REKHA GUPTA,GEN,MACHHLISHAHR,3121,8,SBSP,0,F,UTTAR PRADESH,676371,676338,33,1474056,793266,680790,0.21172872672408646,3121,0.46143314837566957
30,CHOUDHARI RAM PRAVESH NISHAD,GEN,MACHHLISHAHR,2612,7,PMSP,0,M,UTTAR PRADESH,676371,676338,33,1474056,793266,680790,0.1771981525803633,2612,0.38617859133522875
31,MUJMMIS HUSEN,GEN,MACHHLISHAHR,1646,6,NBNP,0,M,UTTAR PRADESH,676371,676338,33,1474056,793266,680790,0.11166468573785528,1646,0.24335756559639604
40,ASHOK KUMAR,SC,MACHHLISHAHR,1638,11,IND,0,M,UTTAR PRADESH,676371,676338,33,1474056,793266,680790,0.11112196551555707,1638,0.24217478277454235
57,PARASNATH YADAVA,GEN,JAUNPUR,219609,3,SP,5,M,UTTAR PRADESH,713014,712998,16,1515676,815085,700591,14.489508311802787,219614,30.800797740296826
39,OM PRAKASH DUBEY (BABA DUBEY),GEN,JAUNPUR,192488,1,BSP,1,M,UTTAR PRADESH,713014,712998,16,1515676,815085,700591,12.699877810297188,192489,26.996524612419954
30,DHANANJAY SINGH,GEN,JAUNPUR,117396,6,LJNSP,1,M,UTTAR PRADESH,713014,712998,16,1515676,815085,700591,7.745520810516232,117397,16.4648940974511
57,CHINMAYANAND,GEN,JAUNPUR,110139,2,BJP,9,M,UTTAR PRADESH,713014,712998,16,1515676,815085,700591,7.267252367920321,110148,15.44822401804172
30,KESHAV PRASAD MAURYA,GEN,JAUNPUR,28971,4,AD,0,M,UTTAR PRADESH,713014,712998,16,1515676,815085,700591,1.9114243413499983,28971,4.06317407512335
48,RAMJI MODANWAL,GEN,JAUNPUR,14597,9,SBSP,0,M,UTTAR PRADESH,713014,712998,16,1515676,815085,700591,0.963068624165059,14597,2.0472248791748826
30,RAJESH KUMAR,GEN,JAUNPUR,11181,11,IND,0,M,UTTAR PRADESH,713014,712998,16,1515676,815085,700591,0.7376906410077088,11181,1.5681319020383893
31,MAHENDRA PRASAD MAURYA,GEN,JAUNPUR,6347,8,PMSP,0,M,UTTAR PRADESH,713014,712998,16,1515676,815085,700591,0.4187570430619737,6347,0.8901648494980463
36,BHAGIRATHI,SC,JAUNPUR,4303,7,SBS,0,M,UTTAR PRADESH,713014,712998,16,1515676,815085,700591,0.2838997252711002,4303,0.6034944615393246
59,LAKSHMI NARAYAN UPADHYAY,GEN,JAUNPUR,4267,10,IJP,0,M,UTTAR PRADESH,713014,712998,16,1515676,815085,700591,0.2815245474626503,4267,0.5984454723189165
32,JAITUN BIND,GEN,JAUNPUR,3700,5,BRPP,0,M,UTTAR PRADESH,713014,712998,16,1515676,815085,700591,0.24411549697956558,3700,0.5189238920974903
45,TUFANI SAROJ,SC,SAIDPUR (SC),231967,1,SP,22,M,UTTAR PRADESH,711340,711286,54,1535355,820472,714883,15.109795454471442,231989,32.61295582984227
58,R A PRASAD,SC,SAIDPUR (SC),202178,3,BSP,1,M,UTTAR PRADESH,711340,711286,54,1535355,820472,714883,13.168224938206475,202179,28.422273455731435
42,VIDYASAGAR,SC,SAIDPUR (SC),161167,4,BJP,28,M,UTTAR PRADESH,711340,711286,54,1535355,820472,714883,10.498874853047015,161195,22.66075294514578
74,MATA PRASAD,SC,SAIDPUR (SC),45190,2,INC,3,M,UTTAR PRADESH,711340,711286,54,1535355,820472,714883,2.9434886394351794,45193,6.353220682092951
40,RAM MURTY,SC,SAIDPUR (SC),35912,9,IND,0,M,UTTAR PRADESH,711340,711286,54,1535355,820472,714883,2.3390030318721076,35912,5.048500014057975
37,KAMALA PRASAD MUSAHAR,SC,SAIDPUR (SC),10938,5,AD,0,M,UTTAR PRADESH,711340,711286,54,1535355,820472,714883,0.7124085309260725,10938,1.5376613152641494
33,VIRENDRA,SC,SAIDPUR (SC),10477,10,IND,0,M,UTTAR PRADESH,711340,711286,54,1535355,820472,714883,0.6823829016742057,10477,1.4728540501026233
43,RAMDAYAL,SC,SAIDPUR (SC),6867,8,RSMD,0,M,UTTAR PRADESH,711340,711286,54,1535355,820472,714883,0.44725812597086667,6867,0.9653611493800432
32,RAJENDRA,SC,SAIDPUR (SC),3413,7,CPI(ML)(L),0,M,UTTAR PRADESH,711340,711286,54,1535355,820472,714883,0.22229386689071906,3413,0.4797986897967217
26,NIRBHAY,SC,SAIDPUR (SC),3177,6,GGP,0,M,UTTAR PRADESH,711340,711286,54,1535355,820472,714883,0.20692282892230135,3177,0.44662186858604885
50,AFAJAL ANSARI,GEN,GHAZIPUR,415646,1,SP,41,M,UTTAR PRADESH,869184,869032,152,1476687,793021,683666,28.149973555668872,415687,47.82497146749135
44,MANOJ,GEN,GHAZIPUR,188835,3,BJP,75,M,UTTAR PRADESH,869184,869032,152,1476687,793021,683666,12.79282610329745,188910,21.734178263750827
53,UMA SHANKAR,GEN,GHAZIPUR,185097,2,BSP,23,M,UTTAR PRADESH,869184,869032,152,1476687,793021,683666,12.536170495169255,185120,21.29813710330609
40,AJAY,GEN,GHAZIPUR,34185,6,SBSP,3,M,UTTAR PRADESH,869184,869032,152,1476687,793021,683666,2.315182567463518,34188,3.9333443781753923
48,SHIVPRAKASH,GEN,GHAZIPUR,12640,5,INC,8,M,UTTAR PRADESH,869184,869032,152,1476687,793021,683666,0.8565119080753063,12648,1.4551579412414404
31,RAM BADAN,GEN,GHAZIPUR,7418,4,CPI,0,M,UTTAR PRADESH,869184,869032,152,1476687,793021,683666,0.5023407126899607,7418,0.8534441499153229
33,SONHU,GEN,GHAZIPUR,6694,16,IND,0,M,UTTAR PRADESH,869184,869032,152,1476687,793021,683666,0.45331204243011547,6694,0.7701476327221854
33,SHIVMURAT,GEN,GHAZIPUR,4129,15,IND,0,M,UTTAR PRADESH,869184,869032,152,1476687,793021,683666,0.27961240262831594,4129,0.4750432589647301
42,ANIL KUMAR,GEN,GHAZIPUR,3617,13,IND,0,M,UTTAR PRADESH,869184,869032,152,1476687,793021,683666,0.24494019382577348,3617,0.4161374346513511
59,KAMLESH,GEN,GHAZIPUR,3392,14,IND,0,M,UTTAR PRADESH,869184,869032,152,1476687,793021,683666,0.2297033833168437,3392,0.3902510860761358
45,ISHWARI PRASAD KUSHAWAHA,GEN,GHAZIPUR,2214,7,CPI(ML)(L),2,M,UTTAR PRADESH,869184,869032,152,1476687,793021,683666,0.15006565372350403,2216,0.2549517708563434
29,DR MANOJ KUMAR NISHAD,GEN,GHAZIPUR,1264,9,AD,0,M,UTTAR PRADESH,869184,869032,152,1476687,793021,683666,0.08559701548127667,1264,0.14542375377365435
30,RAJARAM,SC,GHAZIPUR,1220,11,RSBP,0,M,UTTAR PRADESH,869184,869032,152,1476687,793021,683666,0.08261737253730818,1220,0.14036153449672337
37,YOGESH NATH KUSHAWAHA,GEN,GHAZIPUR,929,10,RSMD,0,M,UTTAR PRADESH,869184,869032,152,1476687,793021,683666,0.06291109761242565,929,0.10688185700611148
61,NANDLAL,SC,GHAZIPUR,896,8,ASP,0,M,UTTAR PRADESH,869184,869032,152,1476687,793021,683666,0.060676365404449276,896,0.10308519254841322
26,AJEET SINGH,GEN,GHAZIPUR,856,12,IND,0,M,UTTAR PRADESH,869184,869032,152,1476687,793021,683666,0.05796759909175066,856,0.0984831750239305
40,KAILASH NATH SINGH YADAV,GEN,CHANDAULI,204622,3,BSP,3,M,UTTAR PRADESH,704435,704386,49,1580853,869606,711247,12.94396126648082,204625,29.0481023799215
50,ANAND RATNA MAURYA,GEN,CHANDAULI,202939,2,SP,17,M,UTTAR PRADESH,704435,704386,49,1580853,869606,711247,12.838385352717804,202956,28.81117491322833
38,SHASHIKANT RAJBHAR,GEN,CHANDAULI,181793,4,BJP,22,M,UTTAR PRADESH,704435,704386,49,1580853,869606,711247,11.501069359390153,181815,25.810046349201844
45,ASHOK SINGH,GEN,CHANDAULI,47841,1,INC,2,M,UTTAR PRADESH,704435,704386,49,1580853,869606,711247,3.026404099558909,47843,6.791684115638774
31,RAM BABU,GEN,CHANDAULI,18520,7,AD,0,M,UTTAR PRADESH,704435,704386,49,1580853,869606,711247,1.1715194265374453,18520,2.6290573296329685
40,AAN HEMANT KUSHWAHA,GEN,CHANDAULI,9957,11,RSMD,2,M,UTTAR PRADESH,704435,704386,49,1580853,869606,711247,0.6299763482120097,9959,1.413757124504035
29,TILAK,GEN,CHANDAULI,9826,6,CPI(ML)(L),0,M,UTTAR PRADESH,704435,704386,49,1580853,869606,711247,0.621563168744975,9826,1.394876745192956
29,HARINATH SHARMA,GEN,CHANDAULI,6837,10,PMSP,0,M,UTTAR PRADESH,704435,704386,49,1580853,869606,711247,0.43248803019635595,6837,0.9705650627808102
49,HAREELAL,SC,CHANDAULI,6728,14,IND,0,M,UTTAR PRADESH,704435,704386,49,1580853,869606,711247,0.42559301845269615,6728,0.9550916692100762
27,JAI PRAKASH,GEN,CHANDAULI,5689,5,LP(S),0,M,UTTAR PRADESH,704435,704386,49,1580853,869606,711247,0.35986900742826816,5689,0.8075975782009696
34,MEVALAL VISHWAKARMA,GEN,CHANDAULI,3087,12,IND,3,M,UTTAR PRADESH,704435,704386,49,1580853,869606,711247,0.19546409438448734,3090,0.4386494140694315
40,RAM SEWAK YADAV,GEN,CHANDAULI,2657,13,IND,0,M,UTTAR PRADESH,704435,704386,49,1580853,869606,711247,0.16807381837526955,2657,0.3771817130040387
62,SHIVMURAT RAM,SC,CHANDAULI,2132,8,GGP,0,M,UTTAR PRADESH,704435,704386,49,1580853,869606,711247,0.13486389942644889,2132,0.30265389993398967
59,DR SALIK TIWARI,GEN,CHANDAULI,1758,9,BLP,0,M,UTTAR PRADESH,704435,704386,49,1580853,869606,711247,0.11120578573719378,1758,0.2495617054802785
44,DR RAJESH KUMAR MISHRA,GEN,VARANASI,206902,3,INC,2,M,UTTAR PRADESH,633077,633068,9,1487696,818295,669401,13.907680063668924,206904,32.68228035452243
66,SHANKAR PRASAD JAISWAL,GEN,VARANASI,149462,4,BJP,6,M,UTTAR PRADESH,633077,633068,9,1487696,818295,669401,10.04694507480023,149468,23.609766268558168
50,ATAHAR JAMAL LARI,GEN,VARANASI,93228,6,AD,0,M,UTTAR PRADESH,633077,633068,9,1487696,818295,669401,6.266602854346587,93228,14.726170750161513
42,AMIR CHAND PATEL,GEN,VARANASI,59518,1,BSP,0,M,UTTAR PRADESH,633077,633068,9,1487696,818295,669401,4.000682935223325,59518,9.401384033853702
48,ANJANA PRAKASH,GEN,VARANASI,59104,2,SP,0,F,UTTAR PRADESH,633077,633068,9,1487696,818295,669401,3.972854669233499,59104,9.335989145080298
37,"SHALENDRA KUMAR ALIAS ""EX DY S P""",GEN,VARANASI,28532,17,IND,1,M,UTTAR PRADESH,633077,633068,9,1487696,818295,669401,1.9179321581828546,28533,4.507034689303198
31,KANHAYA,GEN,VARANASI,7550,7,SBSP,0,M,UTTAR PRADESH,633077,633068,9,1487696,818295,669401,0.5074961551284671,7550,1.1925879474376735
46,DR HEERA LAL YADAV,GEN,VARANASI,6379,5,CPM,0,M,UTTAR PRADESH,633077,633068,9,1487696,818295,669401,0.4287838375582108,6379,1.007618346583433
28,RAM PRASAD BAVLA,SC,VARANASI,5878,16,IND,0,M,UTTAR PRADESH,633077,633068,9,1487696,818295,669401,0.395107602628494,5878,0.9284810536475026
27,SURESH SINGH ALIAS SURESH,GEN,VARANASI,2733,18,IND,0,M,UTTAR PRADESH,633077,633068,9,1487696,818295,669401,0.1837068863531259,2733,0.4317010411055843
37,NARENDRA NATH DUBEY ADIG,GEN,VARANASI,2477,14,IND,0,M,UTTAR PRADESH,633077,633068,9,1487696,818295,669401,0.16649906970241232,2477,0.39126362196067777
38,DINESH CHANDRA PANDEY,GEN,VARANASI,2110,9,PMSP,0,M,UTTAR PRADESH,633077,633068,9,1487696,818295,669401,0.1418300513008034,2110,0.3332927906084094
30,DEV RAJ,GEN,VARANASI,2091,13,IND,0,M,UTTAR PRADESH,633077,633068,9,1487696,818295,669401,0.14055290865875825,2091,0.3302915759062484
42,RAMJI,GEN,VARANASI,2006,15,IND,0,M,UTTAR PRADESH,633077,633068,9,1487696,818295,669401,0.134839375786451,2006,0.31686508908079114
35,KAMAL CHAND,GEN,VARANASI,1824,8,GGP,0,M,UTTAR PRADESH,633077,633068,9,1487696,818295,669401,0.1226056936363343,1824,0.2881166114074591
41,KHAGENDRA NATH PANDEY,GEN,VARANASI,1297,11,IND,0,M,UTTAR PRADESH,633077,633068,9,1487696,818295,669401,0.08718178982802938,1297,0.20487239308962418
40,GANESH RAM,GEN,VARANASI,1069,12,IND,0,M,UTTAR PRADESH,633077,633068,9,1487696,818295,669401,0.0718560781234876,1069,0.1688578166636918
45,LALJI RAM,SC,VARANASI,908,10,PTSS,0,M,UTTAR PRADESH,633077,633068,9,1487696,818295,669401,0.061033974682999745,908,0.14342647102959039
55,LALCHANDRA,SC,ROBERTSGANJ (SC),189521,4,BSP,0,M,UTTAR PRADESH,724824,724797,27,1661132,895629,765503,11.409147497008064,189521,26.14717503835414
51,PAKAURI LAL,SC,ROBERTSGANJ (SC),179152,1,SP,7,M,UTTAR PRADESH,724824,724797,27,1661132,895629,765503,10.785356010238802,179159,24.717586614129775
38,RAM SHAKAL,SC,ROBERTSGANJ (SC),167195,3,BJP,16,M,UTTAR PRADESH,724824,724797,27,1661132,895629,765503,10.066087463247953,167211,23.069186450779775
72,BRIJ KISHOR KANAUJIYA,SC,ROBERTSGANJ (SC),65914,2,INC,2,M,UTTAR PRADESH,724824,724797,27,1661132,895629,765503,3.96813739064686,65916,9.094069732790306
42,RAM SAJIVAN NIRMAL,SC,ROBERTSGANJ (SC),41459,9,AD,2,M,UTTAR PRADESH,724824,724797,27,1661132,895629,765503,2.495948545931329,41461,5.720147235742746
36,SHRAVAN KUMAR,SC,ROBERTSGANJ (SC),18949,14,IND,0,M,UTTAR PRADESH,724824,724797,27,1661132,895629,765503,1.1407281299740177,18949,2.614289813803075
31,PREM SHANKAR,SC,ROBERTSGANJ (SC),15475,6,PMSP,0,M,UTTAR PRADESH,724824,724797,27,1661132,895629,765503,0.9315936361469167,15475,2.135001048530402
50,TEERATHRAJ,SC,ROBERTSGANJ (SC),11746,11,IND,0,M,UTTAR PRADESH,724824,724797,27,1661132,895629,765503,0.7071081647936467,11746,1.6205313289846917
36,ASHOK,SC,ROBERTSGANJ (SC),11120,5,CPI(ML)(L),0,M,UTTAR PRADESH,724824,724797,27,1661132,895629,765503,0.6694230199646988,11120,1.534165535357549
44,RAMJAG SINGH,SC,ROBERTSGANJ (SC),7291,8,RSMD,0,M,UTTAR PRADESH,724824,724797,27,1661132,895629,765503,0.43891755742469596,7291,1.0058993631557454
26,RAMESH KUMAR,SC,ROBERTSGANJ (SC),5997,13,IND,0,M,UTTAR PRADESH,724824,724797,27,1661132,895629,765503,0.3610188714683722,5997,0.8273732657859011
50,DAYA SHANKAR,SC,ROBERTSGANJ (SC),4730,12,IND,0,M,UTTAR PRADESH,724824,724797,27,1661132,895629,765503,0.2847455831324663,4730,0.652572210633202
28,AMRESH CHANDRA,SC,ROBERTSGANJ (SC),3737,10,IND,0,M,UTTAR PRADESH,724824,724797,27,1661132,895629,765503,0.22496707064820856,3737,0.5155734357581978
30,BHUPENDRA,SC,ROBERTSGANJ (SC),2511,7,VP,0,M,UTTAR PRADESH,724824,724797,27,1661132,895629,765503,0.1511619786988632,2511,0.3464289261944969
35,NARENDRA KUMAR KUSHWAHA,GEN,MIRZAPUR,201940,1,BSP,2,M,UTTAR PRADESH,728015,728003,12,1630287,891750,738537,12.386898748502565,201942,27.738714174845295
51,VEERENDRA SINGH,GEN,MIRZAPUR,165522,3,BJP,8,M,UTTAR PRADESH,728015,728003,12,1630287,891750,738537,10.153426973287525,165530,22.737168877014895
57,SHARDA PRASAD,GEN,MIRZAPUR,158011,4,SP,0,M,UTTAR PRADESH,728015,728003,12,1630287,891750,738537,9.69221983613928,158011,21.704360487077874
49,RAJESH PATI TRIPATHI,GEN,MIRZAPUR,140735,2,INC,0,M,UTTAR PRADESH,728015,728003,12,1630287,891750,738537,8.632529119106023,140735,19.33133245880923
39,PREM CHAND BIND,GEN,MIRZAPUR,21364,8,PMSP,1,M,UTTAR PRADESH,728015,728003,12,1630287,891750,738537,1.3105054508807346,21365,2.9346922796920394
38,ANWAR,GEN,MIRZAPUR,17349,5,AD,1,M,UTTAR PRADESH,728015,728003,12,1630287,891750,738537,1.064229795121963,17350,2.3831926539975137
28,SANJAY,SC,MIRZAPUR,9798,13,IND,0,M,UTTAR PRADESH,728015,728003,12,1630287,891750,738537,0.6009984745017288,9798,1.3458513904246479
32,TRIBHUVAN PRASAD CHAUHAN,GEN,MIRZAPUR,3336,11,RKSP,0,M,UTTAR PRADESH,728015,728003,12,1630287,891750,738537,0.20462654735025182,3336,0.4582323166418274
35,DR KARNAIL SINGH,GEN,MIRZAPUR,2560,12,IND,0,M,UTTAR PRADESH,728015,728003,12,1630287,891750,738537,0.15702756631194387,2560,0.3516411062958868
33,VINAY KUMAR OMAR,GEN,MIRZAPUR,1966,9,PSJP,0,M,UTTAR PRADESH,728015,728003,12,1630287,891750,738537,0.12059226381612564,1966,0.2700493808506693
42,SHARDA PRASAD RAJPASI,SC,MIRZAPUR,1835,10,BKRP,0,M,UTTAR PRADESH,728015,728003,12,1630287,891750,738537,0.11255686882125664,1835,0.2520552461144345
50,ALGU PRASAD,SC,MIRZAPUR,1823,6,RSBP,0,M,UTTAR PRADESH,728015,728003,12,1630287,891750,738537,0.11182080210416939,1823,0.2504069284286725
41,PRADEEP KUMAR,GEN,MIRZAPUR,1764,7,SHS,0,M,UTTAR PRADESH,728015,728003,12,1630287,891750,738537,0.10820180741182381,1764,0.2423026998070095
41,ATIQUE AHAMAD,GEN,PHULPUR,265420,1,SP,12,M,UTTAR PRADESH,755222,755173,49,1409517,768102,641415,18.83141530041851,265432,35.14622190561186
46,KESHARI DEVI PATEL,GEN,PHULPUR,201083,2,BSP,2,F,UTTAR PRADESH,755222,755173,49,1409517,768102,641415,14.266234461875948,201085,26.625945748402458
50,BENI MADHAV BIND,GEN,PHULPUR,151482,3,BJP,27,M,UTTAR PRADESH,755222,755173,49,1409517,768102,641415,10.749001253620921,151509,20.06151833500613
53,DR SONELAL PATEL,GEN,PHULPUR,80383,14,AD,5,M,UTTAR PRADESH,755222,755173,49,1409517,768102,641415,5.703230255470491,80388,10.64428737510295
64,RAM POOJAN PATEL,GEN,PHULPUR,11365,4,INC,2,M,UTTAR PRADESH,755222,755173,49,1409517,768102,641415,0.8064464635758207,11367,1.5051203487186549
49,KAREDEEN,SC,PHULPUR,9557,16,IND,0,M,UTTAR PRADESH,755222,755173,49,1409517,768102,641415,0.6780336810410942,9557,1.265455720304758
45,UMA DEVI VAISHYA,GEN,PHULPUR,5432,15,IND,0,F,UTTAR PRADESH,755222,755173,49,1409517,768102,641415,0.38538024018156575,5432,0.7192587080355181
27,SANJEEV KUMAR MISHRA,GEN,PHULPUR,4499,26,IND,0,M,UTTAR PRADESH,755222,755173,49,1409517,768102,641415,0.3191873528307924,4499,0.5957188747149845
28,CHAND PAL,GEN,PHULPUR,4147,17,IND,0,M,UTTAR PRADESH,755222,755173,49,1409517,768102,641415,0.2942142592107793,4147,0.5491100630013427
42,JAI PRAKASH,GEN,PHULPUR,3747,18,IND,0,M,UTTAR PRADESH,755222,755173,49,1409517,768102,641415,0.2658357437334917,3747,0.4961455042358406
43,LOK BAHADUR GOND,SC,PHULPUR,2070,12,GGP,0,M,UTTAR PRADESH,755222,755173,49,1409517,768102,641415,0.1468588175949634,2070,0.2740915916114732
32,SHESH PURI,GEN,PHULPUR,1882,13,RKSP,0,M,UTTAR PRADESH,755222,755173,49,1409517,768102,641415,0.1335209153206382,1882,0.24919824899168722
36,JAI SINGH YADAV,GEN,PHULPUR,1715,19,IND,0,M,UTTAR PRADESH,755222,755173,49,1409517,768102,641415,0.12167288510887063,1715,0.2270855457070901
35,SHAMEEM HASHMI,GEN,PHULPUR,1465,25,IND,0,M,UTTAR PRADESH,755222,755173,49,1409517,768102,641415,0.10393631293556588,1465,0.1939826964786513
60,RAM NATH PRIYADARSHI SUMAN,SC,PHULPUR,1199,9,RPI,0,M,UTTAR PRADESH,755222,755173,49,1409517,768102,641415,0.0850646001431696,1199,0.15876126489959244
48,LALTA PRASAD YADAV,GEN,PHULPUR,1057,11,RPD,0,M,UTTAR PRADESH,755222,755173,49,1409517,768102,641415,0.07499022714873252,1057,0.13995884653783922
39,DR NEERAJ,GEN,PHULPUR,994,23,IND,0,M,UTTAR PRADESH,755222,755173,49,1409517,768102,641415,0.0705206109610597,994,0.13161692853227264
45,RANJOR SINGH,GEN,PHULPUR,973,24,IND,0,M,UTTAR PRADESH,755222,755173,49,1409517,768102,641415,0.06903073889850211,973,0.12883628919708376
38,AKHILESH KUMAR TRIPATHI,GEN,PHULPUR,967,5,SVSP,0,M,UTTAR PRADESH,755222,755173,49,1409517,768102,641415,0.0686050611663428,967,0.12804182081560123
28,DIWAKAR MISHRA,GEN,PHULPUR,965,21,IND,0,M,UTTAR PRADESH,755222,755173,49,1409517,768102,641415,0.06846316858895636,965,0.12777699802177372
35,RAM SINGAR,SC,PHULPUR,952,10,BKRP,0,M,UTTAR PRADESH,755222,755173,49,1409517,768102,641415,0.06754086683594451,952,0.1260556498618949
47,DOODH NATH,GEN,PHULPUR,868,7,LP(S),0,M,UTTAR PRADESH,755222,755173,49,1409517,768102,641415,0.061581378585714115,868,0.11493309252113948
46,AWADHESH KUMAR KUSHWAHA,GEN,PHULPUR,862,6,NBNP,0,M,UTTAR PRADESH,755222,755173,49,1409517,768102,641415,0.061155700853554804,862,0.11413862413965695
40,NAGENDRA SINGH,GEN,PHULPUR,793,22,IND,0,M,UTTAR PRADESH,755222,755173,49,1409517,768102,641415,0.05626040693372269,793,0.10500223775260784
25,RAKESH CHANDRA PATEL,GEN,PHULPUR,742,8,RSBP,0,M,UTTAR PRADESH,755222,755173,49,1409517,768102,641415,0.052642146210368515,742,0.09824925651000632
31,DINESH KUMAR SAINIK,SC,PHULPUR,554,20,IND,1,M,UTTAR PRADESH,755222,755173,49,1409517,768102,641415,0.03937519022473656,555,0.07348832528713412
60,KUNWAR REWATI RAMAN SINGH URF MANI JI,GEN,ALLAHABAD,234001,2,SP,7,M,UTTAR PRADESH,656498,656450,48,1558094,863970,694124,15.018862790049894,234008,35.64489153051495
70,DR MURALI MANOHAR JOSHI,GEN,ALLAHABAD,205592,1,BJP,33,M,UTTAR PRADESH,656498,656450,48,1558094,863970,694124,13.197214032016042,205625,31.3214967905462
44,R K SINGH PATEL,GEN,ALLAHABAD,111573,4,BSP,3,M,UTTAR PRADESH,656498,656450,48,1558094,863970,694124,7.161057035069771,111576,16.995634411681376
65,SATYA PRAKASH MALVIYA,GEN,ALLAHABAD,40541,3,INC,4,M,UTTAR PRADESH,656498,656450,48,1558094,863970,694124,2.6022178379481598,40545,6.175951792693961
51,RAJ KARAN BIND,GEN,ALLAHABAD,25426,8,AD,0,M,UTTAR PRADESH,656498,656450,48,1558094,863970,694124,1.6318655998932028,25426,3.872974479739466
39,SHYAM PANDAY URF MAULA BABA,GEN,ALLAHABAD,7755,16,IND,0,M,UTTAR PRADESH,656498,656450,48,1558094,863970,694124,0.4977235006360335,7755,1.1812678789577424
39,RAJENDRA KUMAR TIWARI URF DUKAN JI,GEN,ALLAHABAD,4930,15,IND,0,M,UTTAR PRADESH,656498,656450,48,1558094,863970,694124,0.3164122318679104,4930,0.7509543060298737
40,SAMAR BAHADUR SHARMA,GEN,ALLAHABAD,3820,17,IND,0,M,UTTAR PRADESH,656498,656450,48,1558094,863970,694124,0.24517134396255935,3820,0.5818753446316668
25,MANNI LAL,SC,ALLAHABAD,2886,13,IND,0,M,UTTAR PRADESH,656498,656450,48,1558094,863970,694124,0.18522630855391267,2886,0.43960529963533784
37,KAILASH NATH,GEN,ALLAHABAD,2700,12,IND,0,M,UTTAR PRADESH,656498,656450,48,1558094,863970,694124,0.17328864625625925,2700,0.41127314934698966
51,MOHD SALMAN RASHIDI,GEN,ALLAHABAD,2696,18,IND,0,M,UTTAR PRADESH,656498,656450,48,1558094,863970,694124,0.1730319223358796,2696,0.4106638557924015
62,HARI LAL,SC,ALLAHABAD,2664,19,IND,0,M,UTTAR PRADESH,656498,656450,48,1558094,863970,694124,0.17097813097284245,2664,0.4057895073556964
32,JAGDEESH KUMAR RAJPASI,SC,ALLAHABAD,2605,5,BKRP,0,M,UTTAR PRADESH,656498,656450,48,1558094,863970,694124,0.16719145314724274,2605,0.39680242742552146
45,RAM PRAVESH SINGH KUSHWAHA,GEN,ALLAHABAD,2458,9,SSD,1,M,UTTAR PRADESH,656498,656450,48,1558094,863970,694124,0.15782103005338574,2459,0.3745632126830546
30,RAJU CHAURASIYA,GEN,ALLAHABAD,2313,14,IND,0,M,UTTAR PRADESH,656498,656450,48,1558094,863970,694124,0.14845060695952877,2313,0.35232399794058783
29,ARVIND KUMAR URF PANDA,GEN,ALLAHABAD,1253,11,IND,0,M,UTTAR PRADESH,656498,656450,48,1558094,863970,694124,0.08041876805892327,1253,0.19086120597473258
25,AMARNATH,SC,ALLAHABAD,1199,10,IND,0,M,UTTAR PRADESH,656498,656450,48,1558094,863970,694124,0.07695299513379808,1199,0.1826357429877928
25,BRIJ MOHAN SINGH,GEN,ALLAHABAD,1099,7,IJP,0,M,UTTAR PRADESH,656498,656450,48,1558094,863970,694124,0.07053489712430701,1099,0.1674034041230895
53,BALLABH DAS SHARMA,GEN,ALLAHABAD,939,6,SVSP,0,M,UTTAR PRADESH,656498,656450,48,1558094,863970,694124,0.060265940309121274,939,0.14303166193956418
45,SHAILENDRA KUMAR,SC,CHAIL (SC),196194,3,SP,12,M,UTTAR PRADESH,555376,555332,44,1484115,818941,665174,13.220404079198714,196206,35.32849817060874
40,VACHASPATI,SC,CHAIL (SC),195574,2,BSP,2,M,UTTAR PRADESH,555376,555332,44,1484115,818941,665174,13.177954538563386,195576,35.21506150787935
60,DR AMRIT LAL BHARTI,SC,CHAIL (SC),100154,1,BJP,27,M,UTTAR PRADESH,555376,555332,44,1484115,818941,665174,6.7502181434727095,100181,18.03841001411656
47,BASUDEO,SC,CHAIL (SC),18236,5,AD,1,M,UTTAR PRADESH,555376,555332,44,1484115,818941,665174,1.2288131310579031,18237,3.283721298723748
56,SHASHI PRAKASH,SC,CHAIL (SC),17816,10,LJNSP,1,M,UTTAR PRADESH,555376,555332,44,1484115,818941,665174,1.2005134373010178,17817,3.2080968569041515
30,MAHENDRA KUIMAR,SC,CHAIL (SC),11410,12,IND,0,M,UTTAR PRADESH,555376,555332,44,1484115,818941,665174,0.7688083470620538,11410,2.0544640027656937
30,PANCHAM LAL,SC,CHAIL (SC),4233,11,IND,0,M,UTTAR PRADESH,555376,555332,44,1484115,818941,665174,0.2852204849354666,4233,0.7621863386246435
39,GULAB SONKAR,SC,CHAIL (SC),3636,4,IJP,0,M,UTTAR PRADESH,555376,555332,44,1484115,818941,665174,0.24499449166675089,3636,0.6546915963239318
34,LAL CHANDRA HELA,SC,CHAIL (SC),2488,9,SHS,0,M,UTTAR PRADESH,555376,555332,44,1484115,818941,665174,0.16764199539793076,2488,0.4479847886837026
36,LAKHAN SINGH RAJ PASI,SC,CHAIL (SC),2067,8,BKRP,0,M,UTTAR PRADESH,555376,555332,44,1484115,818941,665174,0.13927492141781467,2067,0.3721802886692979
43,BAIJAL KUMAR,SC,CHAIL (SC),1804,6,JP,1,M,UTTAR PRADESH,555376,555332,44,1484115,818941,665174,0.12162130293137662,1805,0.32500504162945465
28,MAHENDRA SINGH,SC,CHAIL (SC),1720,7,RSBP,0,M,UTTAR PRADESH,555376,555332,44,1484115,818941,665174,0.11589398395676885,1720,0.3097000950707268
34,MAHENDRA PRASAD NISHAD,GEN,FATEHPUR,163564,4,BSP,4,M,UTTAR PRADESH,506699,506655,44,1279387,695686,583701,12.784872755468049,163568,32.2810978509924
56,ACHAL SINGH,GEN,FATEHPUR,110992,1,SP,8,M,UTTAR PRADESH,506699,506655,44,1279387,695686,583701,8.67603000499458,111000,21.90649675645699
55,ASHOK PATEL,GEN,FATEHPUR,101453,2,BJP,31,M,UTTAR PRADESH,506699,506655,44,1279387,695686,583701,7.932236297539369,101484,20.02845871020073
70,KHAN GUFRAN JAHIDI,GEN,FATEHPUR,92741,3,INC,0,M,UTTAR PRADESH,506699,506655,44,1279387,695686,583701,7.2488621503892094,92741,18.30297671793313
37,SATYENDRA SINGH PATEL,GEN,FATEHPUR,10860,8,AD,1,M,UTTAR PRADESH,506699,506655,44,1279387,695686,583701,0.8489221791373526,10861,2.143481633079994
29,DEVKI NANDAN ALIAS LALU MAURYA,GEN,FATEHPUR,10253,10,IND,0,M,UTTAR PRADESH,506699,506655,44,1279387,695686,583701,0.8013994201910759,10253,2.0234892904860677
37,BIRENDRA SINGH,GEN,FATEHPUR,4925,7,BKD,0,M,UTTAR PRADESH,506699,506655,44,1279387,695686,583701,0.38494997995133606,4925,0.9719774461761322
37,ANIRUDDHA SINGH,GEN,FATEHPUR,3978,5,IJP,0,M,UTTAR PRADESH,506699,506655,44,1279387,695686,583701,0.31093015639521115,3978,0.7850814783530261
70,JAGLAL,SC,FATEHPUR,3949,9,IND,0,M,UTTAR PRADESH,506699,506655,44,1279387,695686,583701,0.30866344585336575,3949,0.7793581593806185
26,GHANSHYAM PAL,GEN,FATEHPUR,3940,6,LP(S),0,M,UTTAR PRADESH,506699,506655,44,1279387,695686,583701,0.30795998396106883,3940,0.7775819569409057
57,SHYAMA CHARAN GUPT,GEN,BANDA,185087,5,SP,12,M,UTTAR PRADESH,526335,526286,49,1283915,698340,585575,14.416764349664893,185099,35.16752638528693
68,RAM SAJEEWAN,GEN,BANDA,128790,4,BSP,5,M,UTTAR PRADESH,526335,526286,49,1283915,698340,585575,10.031427314113474,128795,24.47015683927537
49,BHAIRO PRASAD MISRA,GEN,BANDA,122377,3,BJP,28,M,UTTAR PRADESH,526335,526286,49,1283915,698340,585575,9.533730815513488,122405,23.25610115230794
69,PRAKASH NARAIN,GEN,BANDA,38879,2,INC,3,M,UTTAR PRADESH,526335,526286,49,1283915,698340,585575,3.028393624188517,38882,7.387310363171744
47,LAKHAN LAL,GEN,BANDA,13786,13,IND,0,M,UTTAR PRADESH,526335,526286,49,1283915,698340,585575,1.0737470938496707,13786,2.6192443975794886
41,CHANDRA PAL,GEN,BANDA,12372,1,CPI,0,M,UTTAR PRADESH,526335,526286,49,1283915,698340,585575,0.9636151925945253,12372,2.350594203311579
50,MO SHAFIQ,GEN,BANDA,5200,9,AD,0,M,UTTAR PRADESH,526335,526286,49,1283915,698340,585575,0.4050112351674371,5200,0.987963939316215
25,AMRIT LAL,GEN,BANDA,4502,6,SVSP,0,M,UTTAR PRADESH,526335,526286,49,1283915,698340,585575,0.35064626552380807,4502,0.8553487797695384
52,MANGI,GEN,BANDA,3823,12,IND,1,M,UTTAR PRADESH,526335,526286,49,1283915,698340,585575,0.29783903140005374,3824,0.7265334815279243
36,SULTAN,GEN,BANDA,3192,10,ASP,0,M,UTTAR PRADESH,526335,526286,49,1283915,698340,585575,0.24861458897201139,3192,0.6064578642879535
36,NATTHOO URF DEVNATH,SC,BANDA,3180,11,IND,0,M,UTTAR PRADESH,526335,526286,49,1283915,698340,585575,0.24767994766008652,3180,0.604177947504916
52,TARA CHANDRA,GEN,BANDA,2776,7,LCP,0,M,UTTAR PRADESH,526335,526286,49,1283915,698340,585575,0.2162136901586164,2776,0.5274207491426564
45,BAIJNATH SAHU,GEN,BANDA,2322,8,PSJP,0,M,UTTAR PRADESH,526335,526286,49,1283915,698340,585575,0.18085309385745943,2322,0.44116389751774054
40,RAJNARAYAN ALIAS RAJJU MAHRAJ,GEN,HAMIRPUR,220906,3,SP,11,M,UTTAR PRADESH,604099,604055,44,1185235,653794,531441,18.639088450813553,220917,36.56966821663337
44,ASHOK KUMAR SINGH CHANDEL,GEN,HAMIRPUR,183746,1,BSP,17,M,UTTAR PRADESH,604099,604055,44,1185235,653794,531441,15.504351457727791,183763,30.419351794987243
42,GANGACHARAN RAJPUT,GEN,HAMIRPUR,111671,2,INC,2,M,UTTAR PRADESH,604099,604055,44,1185235,653794,531441,9.42201335600113,111673,18.485877314810985
35,SURENDRA PAL SINGH,GEN,HAMIRPUR,44404,4,BJP,14,M,UTTAR PRADESH,604099,604055,44,1185235,653794,531441,3.747611233215354,44418,7.352768337640023
38,HARGOVIND,SC,HAMIRPUR,12667,15,IND,0,M,UTTAR PRADESH,604099,604055,44,1185235,653794,531441,1.0687332048074853,12667,2.096841742826921
40,SURESH KUMAR,GEN,HAMIRPUR,10458,14,IND,0,M,UTTAR PRADESH,604099,604055,44,1185235,653794,531441,0.8823566634464896,10458,1.7311732017434227
36,LAKHAN,SC,HAMIRPUR,4827,13,IND,0,M,UTTAR PRADESH,604099,604055,44,1185235,653794,531441,0.4072610073107864,4827,0.7990412167542075
42,ASHOK,GEN,HAMIRPUR,4058,5,AD,0,M,UTTAR PRADESH,604099,604055,44,1185235,653794,531441,0.3423793593675516,4058,0.6717442008677386
38,RAKESH,GEN,HAMIRPUR,2777,10,IND,0,M,UTTAR PRADESH,604099,604055,44,1185235,653794,531441,0.23429952709800167,2777,0.45969286491121486
35,LALLU PRASAD,SC,HAMIRPUR,2023,12,IND,0,M,UTTAR PRADESH,604099,604055,44,1185235,653794,531441,0.1706834509612018,2023,0.33487888574554836
25,YOGENDRA SINGH,SC,HAMIRPUR,1470,9,IND,0,M,UTTAR PRADESH,604099,604055,44,1185235,653794,531441,0.12402603703063106,1470,0.24333759863863375
35,BALADIN,SC,HAMIRPUR,1426,8,IND,0,M,UTTAR PRADESH,604099,604055,44,1185235,653794,531441,0.12031369306508836,1426,0.2360540242576134
56,OM PRAKASH,GEN,HAMIRPUR,1383,6,IND,0,M,UTTAR PRADESH,604099,604055,44,1185235,653794,531441,0.116685720553308,1383,0.22893598565797993
36,RAM BIHARI,SC,HAMIRPUR,1307,11,IND,0,M,UTTAR PRADESH,604099,604055,44,1185235,653794,531441,0.11027349006737061,1307,0.21635526627258114
40,GIRJACHARAN,GEN,HAMIRPUR,932,7,IND,0,M,UTTAR PRADESH,604099,604055,44,1185235,653794,531441,0.07863419490649533,932,0.15427934825252154
47,CHANDRAPAL SINGH YADAV,GEN,JHANSI,238781,1,SP,1,M,UTTAR PRADESH,819646,819636,10,1526320,811087,715233,15.644294774359244,238782,29.132332738767712
65,BABU LAL KUSHWAHA,GEN,JHANSI,212483,2,BSP,0,M,UTTAR PRADESH,819646,819636,10,1526320,811087,715233,13.921261596519734,212483,25.923752449228083
65,RAJENDRA AGNIHOTRI,GEN,JHANSI,206584,3,BJP,7,M,UTTAR PRADESH,819646,819636,10,1526320,811087,715233,13.535235075213587,206591,25.204905532388374
50,RAJENDRA PRATAP URF RAJA BUNDELA,GEN,JHANSI,104582,4,INC,2,M,UTTAR PRADESH,819646,819636,10,1526320,811087,715233,6.8520362702447715,104584,12.759654777794315
44,HEERA SINGH,GEN,JHANSI,15065,16,IND,0,M,UTTAR PRADESH,819646,819636,10,1526320,811087,715233,0.9870145185806385,15065,1.8379885950764112
29,HARIDAS,SC,JHANSI,10033,15,IND,0,M,UTTAR PRADESH,819646,819636,10,1526320,811087,715233,0.6573326694271189,10033,1.2240650231929395
31,ARVIND KUMAR PATEL,GEN,JHANSI,8505,5,AD,0,M,UTTAR PRADESH,819646,819636,10,1526320,811087,715233,0.5572226007652393,8505,1.0376430800613923
55,SUNU URF SUNWA,SC,JHANSI,7578,14,IND,0,M,UTTAR PRADESH,819646,819636,10,1526320,811087,715233,0.49648828554955715,7578,0.9245454745097273
28,VINOD KUMAR,SC,JHANSI,3730,13,IND,0,M,UTTAR PRADESH,819646,819636,10,1526320,811087,715233,0.24437863619686567,3730,0.45507450777530783
68,CHAMAN LAL BABRA,SC,JHANSI,2352,11,IND,0,M,UTTAR PRADESH,819646,819636,10,1526320,811087,715233,0.1540961266313748,2352,0.28695314806636035
36,RAMJI,GEN,JHANSI,1998,12,IND,0,M,UTTAR PRADESH,819646,819636,10,1526320,811087,715233,0.13090308716389748,1998,0.2437637711890255
37,PREM PRAKASH,GEN,JHANSI,1909,6,SMSP,0,M,UTTAR PRADESH,819646,819636,10,1526320,811087,715233,0.12507206876670685,1909,0.2329054250249498
39,MATU KUSHWAHA,SC,JHANSI,1860,7,RSMD,0,M,UTTAR PRADESH,819646,819636,10,1526320,811087,715233,0.12186173279521988,1860,0.22692723444023397
64,KALOO RAM,SC,JHANSI,1489,10,IND,0,M,UTTAR PRADESH,819646,819636,10,1526320,811087,715233,0.0975549032968185,1489,0.18166379144167116
38,ASHOK,SC,JHANSI,1395,9,IND,0,M,UTTAR PRADESH,819646,819636,10,1526320,811087,715233,0.0913962995964149,1395,0.17019542583017547
32,ARVIND KUMAR,GEN,JHANSI,1292,8,IND,0,M,UTTAR PRADESH,819646,819636,10,1526320,811087,715233,0.08464804235022799,1292,0.1576290252133238
44,BHANU PRATAP SINGH VERMA,SC,JALAUN (SC),195208,4,BJP,20,M,UTTAR PRADESH,579777,579748,29,1310156,721278,588878,14.901126278092075,195228,33.67294666742558
31,GHANSHYAM KORI,SC,JALAUN (SC),168435,1,SP,2,M,UTTAR PRADESH,579777,579748,29,1310156,721278,588878,12.856255285630109,168437,29.05203207440102
40,BRIJ LAL KHABRI,SC,JALAUN (SC),157555,3,BSP,4,M,UTTAR PRADESH,579777,579748,29,1310156,721278,588878,12.025972479613115,157559,27.17579345162019
57,NATHURAM VERMA,SC,JALAUN (SC),26990,2,INC,3,M,UTTAR PRADESH,579777,579748,29,1310156,721278,588878,2.060289003752225,26993,4.655755574988314
54,RAGHUNATH PRASAD BHARTI (BARAR),SC,JALAUN (SC),9738,6,AD,0,M,UTTAR PRADESH,579777,579748,29,1310156,721278,588878,0.7432702670521678,9738,1.6796112988269627
48,RAM SHANKAR,SC,JALAUN (SC),8660,11,IND,0,M,UTTAR PRADESH,579777,579748,29,1310156,721278,588878,0.6609899889784118,8660,1.4936777416144484
29,COM KANSHIRAM VERMA (BARAR),SC,JALAUN (SC),3728,5,CPI(ML)(L),0,M,UTTAR PRADESH,579777,579748,29,1310156,721278,588878,0.2845462677726927,3728,0.6430058453508849
34,RAJU,SC,JALAUN (SC),2726,7,RSMD,0,M,UTTAR PRADESH,579777,579748,29,1310156,721278,588878,0.208066825629925,2726,0.4701807764019615
43,JILEDAR SINGH DOHARE,SC,JALAUN (SC),2561,9,IND,0,M,UTTAR PRADESH,579777,579748,29,1310156,721278,588878,0.19547290551659496,2561,0.4417215584612704
77,LAL DAS (BHANTE ANAND),SC,JALAUN (SC),2255,8,IJP,0,M,UTTAR PRADESH,579777,579748,29,1310156,721278,588878,0.17211690821551023,2255,0.3889426451894435
31,RAJENDRA KORI,SC,JALAUN (SC),1892,10,IND,0,M,UTTAR PRADESH,579777,579748,29,1310156,721278,588878,0.1444102839661842,1892,0.32633236571992336
65,RADHEY SHYAM KORI,SC,GHATAMPUR (SC),160104,4,SP,13,M,UTTAR PRADESH,504766,504722,44,1207492,668074,539418,13.260294892222888,160117,31.721035093488865
45,PYARELAL SANKHWAR,SC,GHATAMPUR (SC),149798,3,BSP,7,M,UTTAR PRADESH,504766,504722,44,1207492,668074,539418,12.406293375028572,149805,29.678108271951757
43,KAMAL RANI,SC,GHATAMPUR (SC),122826,2,BJP,19,F,UTTAR PRADESH,504766,504722,44,1207492,668074,539418,10.173566367313407,122845,24.337019529841548
42,UMAKANT MANJHI,SC,GHATAMPUR (SC),46020,5,AD,2,M,UTTAR PRADESH,504766,504722,44,1207492,668074,539418,3.811371007012883,46022,9.117492065630412
61,ASKARAN SANKHWAR,SC,GHATAMPUR (SC),12350,1,INC,3,M,UTTAR PRADESH,504766,504722,44,1207492,668074,539418,1.0230295521626644,12353,2.44727259759968
65,LALMANI BHARTI,SC,GHATAMPUR (SC),5592,9,IND,0,M,UTTAR PRADESH,504766,504722,44,1207492,668074,539418,0.463108658276825,5592,1.107840068467369
35,BENCHE LAL KORI,SC,GHATAMPUR (SC),3411,7,LP(S),0,M,UTTAR PRADESH,504766,504722,44,1207492,668074,539418,0.282486343594823,3411,0.6757586683730679
40,NANDRAM,SC,GHATAMPUR (SC),2497,6,RSBP,0,M,UTTAR PRADESH,504766,504722,44,1207492,668074,539418,0.20679226032139345,2497,0.49468466576591924
61,RAMSUMER BHARTIYA,SC,GHATAMPUR (SC),2124,8,IND,0,M,UTTAR PRADESH,504766,504722,44,1207492,668074,539418,0.1759017865128713,2124,0.42078903888138264
43,RAJA RAM PAL,GEN,BILHAUR,223186,3,BSP,9,M,UTTAR PRADESH,641397,641369,28,1369589,756698,612891,16.296494787852414,223195,34.79826067162771
56,LAL SINGH TOMAR,GEN,BILHAUR,198784,4,SP,9,M,UTTAR PRADESH,641397,641369,28,1369589,756698,612891,14.514792393922557,198793,30.993752699186306
64,SHYAM BIHARI MISHRA,GEN,BILHAUR,159673,5,BJP,8,M,UTTAR PRADESH,641397,641369,28,1369589,756698,612891,11.659045158803115,159681,24.89581335740579
51,MADAN MOHAN SHUKLA,GEN,BILHAUR,34047,2,INC,2,M,UTTAR PRADESH,641397,641369,28,1369589,756698,612891,2.4860742894401167,34049,5.308568640015466
53,SURYA BALI,SC,BILHAUR,7054,13,IND,0,M,UTTAR PRADESH,641397,641369,28,1369589,756698,612891,0.515045024456242,7054,1.0997868714696202
48,RAJ BAHADUR,GEN,BILHAUR,4777,8,AD,0,M,UTTAR PRADESH,641397,641369,28,1369589,756698,612891,0.34879076861744657,4777,0.7447805337411931
56,JANEY ALAM,GEN,BILHAUR,3776,1,NCP,0,M,UTTAR PRADESH,641397,641369,28,1369589,756698,612891,0.2757031489008746,3776,0.5887149456576816
30,BABU RAM KUREEL,SC,BILHAUR,2142,11,IND,0,M,UTTAR PRADESH,641397,641369,28,1369589,756698,612891,0.1563972841487483,2142,0.3339585311437378
25,RAJESH KUMAR,GEN,BILHAUR,2104,12,IND,0,M,UTTAR PRADESH,641397,641369,28,1369589,756698,612891,0.15362272915451278,2104,0.32803396336434376
35,PHOOL SINGH KUSHWAHA,GEN,BILHAUR,1623,10,IND,0,M,UTTAR PRADESH,641397,641369,28,1369589,756698,612891,0.1185027040959003,1623,0.2530414080514876
47,DR V N PAL,GEN,BILHAUR,1597,6,IJP,0,M,UTTAR PRADESH,641397,641369,28,1369589,756698,612891,0.11660432436300233,1597,0.24898775641295484
63,RAJA RAM YADAV,GEN,BILHAUR,1352,9,RJD,0,M,UTTAR PRADESH,641397,641369,28,1369589,756698,612891,0.09871574611069452,1352,0.21078988520370376
40,PRABHU DAYAL,SC,BILHAUR,1254,7,RSBP,0,M,UTTAR PRADESH,641397,641369,28,1369589,756698,612891,0.09156031480977139,1254,0.19551073672000335
59,SHRIPRAKASH JAISWAL,GEN,KANPUR,211104,5,INC,5,M,UTTAR PRADESH,618721,618698,23,1427231,784120,643111,14.791508872775324,211109,34.12022543278796
56,SATYA DEV PACHAURI,GEN,KANPUR,205461,3,BJP,10,M,UTTAR PRADESH,618721,618698,23,1427231,784120,643111,14.396478215509612,205471,33.20899080522562
49,HAJI MUSHTAQ SOLANKI,GEN,KANPUR,159354,2,SP,7,M,UTTAR PRADESH,618721,618698,23,1427231,784120,643111,11.165746820241433,159361,25.756520305598162
26,ANUBHAV,GEN,KANPUR,27961,1,BSP,1,M,UTTAR PRADESH,618721,618698,23,1427231,784120,643111,1.9591782969960714,27962,4.5193229258421805
57,SUBHASHINI ALI,GEN,KANPUR,4558,4,CPM,0,F,UTTAR PRADESH,618721,618698,23,1427231,784120,643111,0.3193596551644408,4558,0.7366809919171969
50,MOHD HANIM ALIS KINNER RAMKALI,GEN,KANPUR,1975,16,IND,0,M,UTTAR PRADESH,618721,618698,23,1427231,784120,643111,0.13837984180556617,1975,0.3192068799992242
38,CHANDRA PRAKASH,GEN,KANPUR,1607,6,ABHM,0,M,UTTAR PRADESH,618721,618698,23,1427231,784120,643111,0.11259564849698472,1607,0.259729344890508
37,SAROJ RAHI,SC,KANPUR,1070,15,IND,0,F,UTTAR PRADESH,618721,618698,23,1427231,784120,643111,0.074970344674408,1070,0.1729373982780607
29,SUNIL PATEL,GEN,KANPUR,957,9,AD,0,M,UTTAR PRADESH,618721,618698,23,1427231,784120,643111,0.06705291575084901,957,0.15467391603000383
29,RAVI SHANKAR BALMIKI,SC,KANPUR,945,14,IND,0,M,UTTAR PRADESH,618721,618698,23,1427231,784120,643111,0.06621212683861268,945,0.15273443118950222
61,JAGANNATH MISTRI,SC,KANPUR,822,12,IND,0,M,UTTAR PRADESH,618721,618698,23,1427231,784120,643111,0.05759404048819007,822,0.13285471157436066
41,CHANDRAMANI,GEN,KANPUR,721,11,IND,0,M,UTTAR PRADESH,618721,618698,23,1427231,784120,643111,0.050517400476867445,721,0.1165307141668054
63,RAM RATAN,SC,KANPUR,644,7,RSBP,0,M,UTTAR PRADESH,618721,618698,23,1427231,784120,643111,0.04512233829001752,644,0.10408568644025337
49,AJEET MOHAN,GEN,KANPUR,615,10,IND,0,M,UTTAR PRADESH,618721,618698,23,1427231,784120,643111,0.04309043175211301,615,0.09939859807570779
38,MANOHAR LAL,SC,KANPUR,477,13,IND,0,M,UTTAR PRADESH,618721,618698,23,1427231,784120,643111,0.033421359261394966,477,0.07709452240993922
30,SANJEEV PANDEY,GEN,KANPUR,427,8,BSDP,0,M,UTTAR PRADESH,618721,618698,23,1427231,784120,643111,0.029918072127076832,427,0.06901333557451582
33,RAGHURAJ SINGH SHAKYA,GEN,ETAWAH,367789,1,SP,18,M,UTTAR PRADESH,703946,703903,43,1264620,704412,560208,29.084388986414893,367807,52.249320260360875
42,SARITA BHADAURIA,GEN,ETAWAH,177632,3,BJP,18,F,UTTAR PRADESH,703946,703903,43,1264620,704412,560208,14.047698122756245,177650,25.236310739744244
53,SUDHEENDRA BHADAURYA,GEN,ETAWAH,130042,4,BSP,1,M,UTTAR PRADESH,703946,703903,43,1264620,704412,560208,10.283168066296595,130043,18.473434041815707
57,PROFFESSER RAJENDRA PRASAD ALIAS RAJU,GEN,ETAWAH,9477,2,INC,5,M,UTTAR PRADESH,703946,703903,43,1264620,704412,560208,0.7497904508864323,9482,1.3469783193597236
34,SHIV PRATAP SINGH,GEN,ETAWAH,4015,14,IND,1,M,UTTAR PRADESH,703946,703903,43,1264620,704412,560208,0.31756575097657797,4016,0.5704983052677336
63,M S CHANDEL,GEN,ETAWAH,3478,7,LP(S),0,M,UTTAR PRADESH,703946,703903,43,1264620,704412,560208,0.2750233271654726,3478,0.49407198847638883
26,ANIL KUMAR,GEN,ETAWAH,3451,9,IND,0,M,UTTAR PRADESH,703946,703903,43,1264620,704412,560208,0.27288829846119783,3451,0.49023646700173024
34,KUSHMA DEVI,SC,ETAWAH,1682,5,IJP,0,F,UTTAR PRADESH,703946,703903,43,1264620,704412,560208,0.13300438076260063,1682,0.23893878223613746
38,BHARAT SINGH,GEN,ETAWAH,1312,8,RSMD,0,M,UTTAR PRADESH,703946,703903,43,1264620,704412,560208,0.10374658000031631,1312,0.18637793239822373
46,GANESH GYANARTHI,GEN,ETAWAH,1239,6,AD,0,M,UTTAR PRADESH,703946,703903,43,1264620,704412,560208,0.0979740949850548,1239,0.17600781878155425
48,MAHESH MANAV,GEN,ETAWAH,1165,12,IND,0,M,UTTAR PRADESH,703946,703903,43,1264620,704412,560208,0.09212253483259793,1165,0.16549564881397152
44,RAMAKANT,GEN,ETAWAH,1107,13,IND,0,M,UTTAR PRADESH,703946,703903,43,1264620,704412,560208,0.08753617687526688,1107,0.15725638046100127
42,BRAJESH SINGH,GEN,ETAWAH,903,11,IND,0,M,UTTAR PRADESH,703946,703903,43,1264620,704412,560208,0.07140484888741283,903,0.1282768848746921
48,PRAKASH NARAYAN,GEN,ETAWAH,611,10,IND,0,M,UTTAR PRADESH,703946,703903,43,1264620,704412,560208,0.04831490882636681,611,0.08679643040801426
31,AKHILESH YADAV,GEN,KANNAUJ,464349,1,SP,18,M,UTTAR PRADESH,758627,758580,47,1346673,747469,599204,34.48253584946011,464367,61.2115044679401
37,TH RAJESH SINGH,GEN,KANNAUJ,156993,2,BSP,1,M,UTTAR PRADESH,758627,758580,47,1346673,747469,599204,11.657915470199521,156994,20.69449149582074
41,RAMANAND YADAV,GEN,KANNAUJ,112327,3,BJP,22,M,UTTAR PRADESH,758627,758580,47,1346673,747469,599204,8.342708289243195,112349,14.809517720829868
42,VINAY KUMAR SHUKLA,GEN,KANNAUJ,10495,4,INC,6,M,UTTAR PRADESH,758627,758580,47,1346673,747469,599204,0.779773560470879,10501,1.3842112131521815
48,SATYA PRAKASH RAJA,GEN,KANNAUJ,5057,10,IND,0,M,UTTAR PRADESH,758627,758580,47,1346673,747469,599204,0.375518035930029,5057,0.6665990005628589
53,ARVIND,GEN,KANNAUJ,3945,5,AD,0,M,UTTAR PRADESH,758627,758580,47,1346673,747469,599204,0.2929441668467401,3945,0.5200184016651135
41,RAM SHANKAR,GEN,KANNAUJ,2006,9,IND,0,M,UTTAR PRADESH,758627,758580,47,1346673,747469,599204,0.14895969548658064,2006,0.2644250731914366
35,MAHENDRA,SC,KANNAUJ,1471,8,IND,0,M,UTTAR PRADESH,758627,758580,47,1346673,747469,599204,0.10923215955172488,1471,0.19390293253469756
38,KALESHWAR,SC,KANNAUJ,1005,7,IND,0,M,UTTAR PRADESH,758627,758580,47,1346673,747469,599204,0.07462836189631782,1005,0.13247617076639773
36,PANKAJ KUMAR SHAKYA,GEN,KANNAUJ,932,6,RSMD,0,M,UTTAR PRADESH,758627,758580,47,1346673,747469,599204,0.06920759531081414,932,0.12285352353659966
52,CHANDRA BHUSHAN SINGH (MUNNOO BABU),GEN,FARRUKHABAD,176119,1,SP,10,M,UTTAR PRADESH,665435,665388,47,1366501,757826,608675,12.889050209257075,176129,26.468250092045054
49,LOUISE KHURSHID,GEN,FARRUKHABAD,173380,4,INC,4,F,UTTAR PRADESH,665435,665388,47,1366501,757826,608675,12.68817220038624,173384,26.055737975910493
35,MUKESH RAJPUT,GEN,FARRUKHABAD,136090,3,BJP,30,M,UTTAR PRADESH,665435,665388,47,1366501,757826,608675,9.961207492713141,136120,20.455792075860153
26,NAGENDRA SINGH SHAKYA,GEN,FARRUKHABAD,116044,2,BSP,2,M,UTTAR PRADESH,665435,665388,47,1366501,757826,608675,8.492200152067214,116046,17.439118771931142
50,SWAMI SACCHIDANAND HARI SAKSHI ALIAS,GEN,FARRUKHABAD,41349,15,IND,0,M,UTTAR PRADESH,665435,665388,47,1366501,757826,608675,3.0259033838979996,41349,6.213830051019258
33,PRAVEEN,GEN,FARRUKHABAD,4486,6,AD,0,M,UTTAR PRADESH,665435,665388,47,1366501,757826,608675,0.3282836968286156,4486,0.6741454837812859
38,ASHOK KUMAR PAL,GEN,FARRUKHABAD,4419,5,LP(S),1,M,UTTAR PRADESH,665435,665388,47,1366501,757826,608675,0.32345384306341524,4420,0.6642271596775041
44,"SURESH SARASWAT ""ELLAYACHI WALA""",GEN,FARRUKHABAD,3750,16,IND,0,M,UTTAR PRADESH,665435,665388,47,1366501,757826,608675,0.2744235093863817,3750,0.5635411422603259
37,WAZID ALI,GEN,FARRUKHABAD,2036,13,IND,0,M,UTTAR PRADESH,665435,665388,47,1366501,757826,608675,0.14899367069617953,2036,0.30596527083787295
50,VIJAI SWARUP,GEN,FARRUKHABAD,2035,14,IND,0,M,UTTAR PRADESH,665435,665388,47,1366501,757826,608675,0.1489204910936765,2035,0.3058149931999369
27,MOHD USMAN,GEN,FARRUKHABAD,1298,10,IND,0,M,UTTAR PRADESH,665435,665388,47,1366501,757826,608675,0.0949871240489396,1298,0.19506037404104082
44,MUNESH SINGH,GEN,FARRUKHABAD,1155,12,IND,0,M,UTTAR PRADESH,665435,665388,47,1366501,757826,608675,0.08452244089100557,1155,0.17357067181618038
31,RAFI ANSARI,GEN,FARRUKHABAD,1008,7,BNRP,0,M,UTTAR PRADESH,665435,665388,47,1366501,757826,608675,0.0737650393230594,1008,0.15147985903957562
26,SHER SINGH,SC,FARRUKHABAD,904,8,RSBP,0,M,UTTAR PRADESH,665435,665388,47,1366501,757826,608675,0.06615436066274376,904,0.13585098469422258
38,CHHATRA PAL SINGH,SC,FARRUKHABAD,728,11,IND,0,M,UTTAR PRADESH,665435,665388,47,1366501,757826,608675,0.05327475062220957,728,0.10940212041747129
57,SATYA PRAKASH UPADHYAYA,GEN,FARRUKHABAD,587,9,SAP,0,M,UTTAR PRADESH,665435,665388,47,1366501,757826,608675,0.042956426669281615,587,0.08821297346848303
63,MULAYAM SINGH YADAV,GEN,MAINPURI,460408,3,SP,62,M,UTTAR PRADESH,719918,719797,121,1211002,669500,541502,38.023884353617916,460470,63.9614511652716
35,ASHOK SHAKYA,GEN,MAINPURI,122596,1,BSP,4,M,UTTAR PRADESH,719918,719797,121,1211002,669500,541502,10.123847854916837,122600,17.02971727335613
58,BALRAM SINGH YADAV,GEN,MAINPURI,111108,2,BJP,45,M,UTTAR PRADESH,719918,719797,121,1211002,669500,541502,9.17859755805523,111153,15.439675074105663
49,THA RAJENDRA SINGH JADON,GEN,MAINPURI,9887,4,INC,9,M,UTTAR PRADESH,719918,719797,121,1211002,669500,541502,0.8171745381097637,9896,1.37460099622457
50,GENDA LAL PAL,GEN,MAINPURI,4701,5,LP(S),1,M,UTTAR PRADESH,719918,719797,121,1211002,669500,541502,0.3882735123476262,4702,0.6531299397986993
34,VIJENDRA,GEN,MAINPURI,4001,13,IND,0,M,UTTAR PRADESH,719918,719797,121,1211002,669500,541502,0.33038756335662534,4001,0.5557577390758393
52,RAM PRAKASH,GEN,MAINPURI,3950,12,IND,0,M,UTTAR PRADESH,719918,719797,121,1211002,669500,541502,0.32617617477097477,3950,0.5486735989376568
25,RAKESH KUMAR S/O SHRI SHAITAN SINGH,GEN,MAINPURI,966,11,IND,0,M,UTTAR PRADESH,719918,719797,121,1211002,669500,541502,0.07976865438702826,966,0.13418194849969023
45,MITRA PAL,GEN,MAINPURI,566,6,BMP(AI),0,M,UTTAR PRADESH,719918,719797,121,1211002,669500,541502,0.046738155676043475,566,0.0786200650629655
33,RAKESH KUMAR S/O SHRI PRATAP SINGH,GEN,MAINPURI,545,10,IND,0,M,UTTAR PRADESH,719918,719797,121,1211002,669500,541502,0.04500405449371677,545,0.07570306618253746
28,TEKCHANDRA,SC,MAINPURI,409,9,IND,0,M,UTTAR PRADESH,719918,719797,121,1211002,669500,541502,0.03377368493198194,409,0.056812025814051044
39,ANAND BIHARI,GEN,MAINPURI,354,8,IND,0,M,UTTAR PRADESH,719918,719797,121,1211002,669500,541502,0.029231991359221537,354,0.049172266841501396
38,ASHOK KUMAR,GEN,MAINPURI,306,7,IND,0,M,UTTAR PRADESH,719918,719797,121,1211002,669500,541502,0.025268331513903366,306,0.04250484082909443
40,PRO S P SINGH BAGHEL,GEN,JALESAR,287076,4,SP,15,M,UTTAR PRADESH,650356,650313,43,1240919,685569,555350,23.13535371768826,287091,44.1436690058983
39,PRATYENDRA PAL SINGH (PAPPU BHAIYA),GEN,JALESAR,181001,2,BJP,22,M,UTTAR PRADESH,650356,650313,43,1240919,685569,555350,14.587817577134366,181023,27.83444759485574
48,UPDESH SINGH CHAUHAN,GEN,JALESAR,149652,1,BSP,2,M,UTTAR PRADESH,650356,650313,43,1240919,685569,555350,12.05993300126761,149654,23.011089311085005
39,SHIVRAJ SINGH YADAV,GEN,JALESAR,12735,3,INC,3,M,UTTAR PRADESH,650356,650313,43,1240919,685569,555350,1.0264972975673674,12738,1.9586195868109157
29,RAMESH CHANDRA KUSHWAH,GEN,JALESAR,5437,7,RSMD,0,M,UTTAR PRADESH,650356,650313,43,1240919,685569,555350,0.43814302142202677,5437,0.8360036656846405
44,YATENDRA KUMAR,GEN,JALESAR,3693,14,IND,0,M,UTTAR PRADESH,650356,650313,43,1240919,685569,555350,0.29760201914871154,3693,0.5678428429967587
59,DR JASWANT SINGH YADAV,GEN,JALESAR,3455,5,RJD,1,M,UTTAR PRADESH,650356,650313,43,1240919,685569,555350,0.278503270559964,3456,0.5314012633080959
45,DESHRAJ,GEN,JALESAR,1959,11,IND,0,M,UTTAR PRADESH,650356,650313,43,1240919,685569,555350,0.1578668712462296,1959,0.3012196397050231
34,PREMPAL,GEN,JALESAR,1442,13,IND,0,M,UTTAR PRADESH,650356,650313,43,1240919,685569,555350,0.11620420027415165,1442,0.22172471692426918
53,SHAKOOR KHAN,GEN,JALESAR,1437,9,NLP,0,M,UTTAR PRADESH,650356,650313,43,1240919,685569,555350,0.11580127308873503,1437,0.2209559072261961
50,DR BHARAT SINGH BAGHEL,GEN,JALESAR,758,6,LP(S),0,M,UTTAR PRADESH,650356,650313,43,1240919,685569,555350,0.061083761309158775,758,0.1165515502278752
34,PUTTAN SINGH,SC,JALESAR,758,12,IND,0,M,UTTAR PRADESH,650356,650313,43,1240919,685569,555350,0.061083761309158775,758,0.1165515502278752
25,VIVEK KUMAR SHARMA,GEN,JALESAR,513,8,AD,0,M,UTTAR PRADESH,650356,650313,43,1240919,685569,555350,0.04134032922374466,513,0.07887987502229547
48,GREESH CHANDRA,GEN,JALESAR,397,10,IND,0,M,UTTAR PRADESH,650356,650313,43,1240919,685569,555350,0.0319924185220792,397,0.061043490027000595
54,KU DEVENDRA SINGH YADAV,GEN,ETAH,276140,2,SP,16,M,UTTAR PRADESH,587118,587065,53,1128519,623458,505061,24.47065578869297,276156,47.035859912317456
43,ASHOK RATAN SHAKYA,GEN,ETAH,224797,1,BJP,24,M,UTTAR PRADESH,587118,587065,53,1128519,623458,505061,19.921773581127123,224821,38.292302399177
48,RAMGOPAL SHAKYA,GEN,ETAH,56872,4,BSP,1,M,UTTAR PRADESH,587118,587065,53,1128519,623458,505061,5.039613865606161,56873,9.686809125252505
62,RAVINDR,GEN,ETAH,22442,3,INC,12,M,UTTAR PRADESH,587118,587065,53,1128519,623458,505061,1.989687369020814,22454,3.8244441492170225
48,VIKRAM SINGH RANA,SC,ETAH,2692,8,IND,0,M,UTTAR PRADESH,587118,587065,53,1128519,623458,505061,0.23854272723808817,2692,0.4585108955950933
38,AMARPAL SINGH,GEN,ETAH,2029,5,RJD,0,M,UTTAR PRADESH,587118,587065,53,1128519,623458,505061,0.1797931625431207,2029,0.345586406821116
70,JAI PARKASH,GEN,ETAH,1050,6,PTSS,0,M,UTTAR PRADESH,587118,587065,53,1128519,623458,505061,0.09304229702822904,1050,0.17883968810358394
59,DEV SINGH,GEN,ETAH,1043,7,IND,0,M,UTTAR PRADESH,587118,587065,53,1128519,623458,505061,0.09242201504804085,1043,0.17764742351622673
52,RAM JI LAL SUMAN,SC,FIROZABAD (SC),212360,2,SP,23,M,UTTAR PRADESH,531363,531305,58,1305888,719455,586433,16.263492734445833,212383,39.96947472819899
60,KISHORI LAL MAHAUR,SC,FIROZABAD (SC),157564,1,BJP,31,M,UTTAR PRADESH,531363,531305,58,1305888,719455,586433,12.06803339949521,157595,29.658632610851715
45,BIRESH KUMAR ALIAS DADUA,SC,FIROZABAD (SC),69553,3,BSP,1,M,UTTAR PRADESH,531363,531305,58,1305888,719455,586433,5.3261841750594225,69554,13.089733383769664
52,PRABHUDAYAL KATHERIA,SC,FIROZABAD (SC),54332,5,RSMD,0,M,UTTAR PRADESH,531363,531305,58,1305888,719455,586433,4.160540567031782,54332,10.225025077018913
53,DR SHIVNARAIN GAUTAM,SC,FIROZABAD (SC),28105,4,INC,3,M,UTTAR PRADESH,531363,531305,58,1305888,719455,586433,2.1524051067166554,28108,5.289792477082521
46,VINOD KUMAR,SC,FIROZABAD (SC),4991,10,IND,0,M,UTTAR PRADESH,531363,531305,58,1305888,719455,586433,0.38219204097135434,4991,0.9392825620150443
46,BAHADUR SINGH,SC,FIROZABAD (SC),1312,9,IND,0,M,UTTAR PRADESH,531363,531305,58,1305888,719455,586433,0.10046803401210518,1312,0.2469121862079219
33,ACHAL SINGH,SC,FIROZABAD (SC),1283,6,IND,0,M,UTTAR PRADESH,531363,531305,58,1305888,719455,586433,0.09824732289445955,1283,0.2414545235554602
45,KAILASH CHAND MAHAUR,SC,FIROZABAD (SC),1090,8,IND,0,M,UTTAR PRADESH,531363,531305,58,1305888,719455,586433,0.08346810752530079,1090,0.20513283762700826
48,AMBEDKARI HASNURAM AMBEDKARI,SC,FIROZABAD (SC),715,7,IND,0,M,UTTAR PRADESH,531363,531305,58,1305888,719455,586433,0.054752015486779874,715,0.1345596136727623
52,RAJ BABBAR,GEN,AGRA,243083,3,SP,11,M,UTTAR PRADESH,642719,642675,44,1430713,781396,649317,16.991108629054185,243094,37.8227499109253
54,MURARI LAL MITTAL FATEHPURIA,GEN,AGRA,185722,2,BJP,30,M,UTTAR PRADESH,642719,642675,44,1430713,781396,649317,12.983176919480007,185752,28.900966052038296
50,PANDIT KESHAV PRASAD DIXIT,GEN,AGRA,174149,1,BSP,0,M,UTTAR PRADESH,642719,642675,44,1430713,781396,649317,12.172182680943,174149,27.095667002220253
66,SURENDRA SINGH,GEN,AGRA,14480,4,INC,3,M,UTTAR PRADESH,642719,642675,44,1430713,781396,649317,1.012292472354693,14483,2.2533953407321086
30,SAYED IRFAN AHMAD,GEN,AGRA,12346,5,RHD,0,M,UTTAR PRADESH,642719,642675,44,1430713,781396,649317,0.8629263870531687,12346,1.9209016693142726
39,SUNDAR SINGH,SC,AGRA,3897,16,IND,0,M,UTTAR PRADESH,642719,642675,44,1430713,781396,649317,0.27238167263455354,3897,0.6063302936431006
38,SAMARVEER SINGH CHAHAR,GEN,AGRA,2233,8,RSMD,0,M,UTTAR PRADESH,642719,642675,44,1430713,781396,649317,0.1560760264287806,2233,0.3474302144483048
40,SUNDAR BABU CHANCHAL,SC,AGRA,1991,15,IND,0,M,UTTAR PRADESH,642719,642675,44,1430713,781396,649317,0.13916138317048912,1991,0.3097776788923309
28,RAJESH KUMAR SINGH KUSHWAHA,GEN,AGRA,1843,14,IND,0,M,UTTAR PRADESH,642719,642675,44,1430713,781396,649317,0.1288168905993026,1843,0.28675050838702454
35,FIROZ KHAN,GEN,AGRA,577,12,IND,0,M,UTTAR PRADESH,642719,642675,44,1430713,781396,649317,0.04032954198361237,577,0.08977484717271467
48,MADAN LAL TIMORI,SC,AGRA,546,7,AD,0,M,UTTAR PRADESH,642719,642675,44,1430713,781396,649317,0.03816279016126924,546,0.08495158848579239
40,DEVI SINGH,GEN,AGRA,479,6,RKSP,0,M,UTTAR PRADESH,642719,642675,44,1430713,781396,649317,0.03347981041620506,479,0.07452712616244424
32,RAJENDRA KARDAM,SC,AGRA,467,13,IND,0,M,UTTAR PRADESH,642719,642675,44,1430713,781396,649317,0.03264106777529805,467,0.07266005828363561
40,DILEEP,GEN,AGRA,345,11,IND,0,M,UTTAR PRADESH,642719,642675,44,1430713,781396,649317,0.024113850926076718,345,0.05367820151574794
28,ANOOP,SC,AGRA,278,9,IND,0,M,UTTAR PRADESH,642719,642675,44,1430713,781396,649317,0.019430871181012544,278,0.04325373919239979
45,GIRRAJ,GEN,AGRA,239,10,IND,0,M,UTTAR PRADESH,642719,642675,44,1430713,781396,649317,0.01670495759806474,239,0.03718576858627176
56,MANVENDRA SINGH,GEN,MATHURA,187376,2,INC,24,M,UTTAR PRADESH,602187,601855,332,1277346,709749,567597,14.67104449381765,187400,31.119901293119913
51,CHOUDHARY LAXMINARAYAN,GEN,MATHURA,149236,4,BSP,32,M,UTTAR PRADESH,602187,601855,332,1277346,709749,567597,11.685792259888863,149268,24.78764901932456
70,DR GYANVATI SINGH,GEN,MATHURA,144314,5,RLD,52,F,UTTAR PRADESH,602187,601855,332,1277346,709749,567597,11.30202779826296,144366,23.973616169063764
45,CHOUDHARY TEJVEER SINGH,GEN,MATHURA,102789,1,BJP,218,M,UTTAR PRADESH,602187,601855,332,1277346,709749,567597,8.064142370195702,103007,17.105483844719334
31,HARPAL SINGH,GEN,MATHURA,4321,16,IND,0,M,UTTAR PRADESH,602187,601855,332,1277346,709749,567597,0.33827952645563536,4321,0.71755119256975
46,OM PRAKASH,GEN,MATHURA,2414,6,LP(S),0,M,UTTAR PRADESH,602187,601855,332,1277346,709749,567597,0.18898559982964677,2414,0.4008721543307976
29,RAJKUMAR,GEN,MATHURA,2292,3,NCP,2,M,UTTAR PRADESH,602187,601855,332,1277346,709749,567597,0.17959112096487562,2294,0.38094478957533123
38,SATISH CHANDRA,GEN,MATHURA,2226,15,IND,0,M,UTTAR PRADESH,602187,601855,332,1277346,709749,567597,0.1742675829415053,2226,0.36965261621390033
54,BIJENDRA SINGH,GEN,MATHURA,1659,13,IND,0,M,UTTAR PRADESH,602187,601855,332,1277346,709749,567597,0.1298786703054615,1659,0.27549581774432197
38,KUNVAR SINGH,GEN,MATHURA,1179,8,IND,0,M,UTTAR PRADESH,602187,601855,332,1277346,709749,567597,0.09230075484637679,1179,0.19578635872245664
40,NARAYAN SINGH,GEN,MATHURA,1066,10,IND,0,M,UTTAR PRADESH,602187,601855,332,1277346,709749,567597,0.08345428724871727,1066,0.17702142357772585
40,BALBIR SINGH,GEN,MATHURA,873,12,IND,1,M,UTTAR PRADESH,602187,601855,332,1277346,709749,567597,0.06842312106508337,874,0.14513763996897974
40,VIDHYA DEVI,SC,MATHURA,647,14,IND,0,F,UTTAR PRADESH,602187,601855,332,1277346,709749,567597,0.05065189854589125,647,0.10744170830655594
58,PHAKKAR BABA,GEN,MATHURA,576,11,IND,1,M,UTTAR PRADESH,602187,601855,332,1277346,709749,567597,0.04517178587477473,577,0.09581741219920058
42,DEVKI NANDAN,GEN,MATHURA,527,9,IND,2,M,UTTAR PRADESH,602187,601855,332,1277346,709749,567597,0.041413994328866256,529,0.08784646629701405
26,AJAY SINGH,GEN,MATHURA,360,7,IND,0,M,UTTAR PRADESH,602187,601855,332,1277346,709749,567597,0.028183436594313525,360,0.05978209426639897
80,KISHAN LAL DILER,SC,HATHRAS (SC),175010,1,BJP,39,M,UTTAR PRADESH,492135,492076,59,1212983,666239,546744,14.431282219124258,175049,35.56930517032928
40,RAM VIR SINGH BHAIYAJI,SC,HATHRAS (SC),152212,3,BSP,0,M,UTTAR PRADESH,492135,492076,59,1212983,666239,546744,12.548568281665942,152212,30.92891178233615
52,VIMLA PAL,SC,HATHRAS (SC),118816,4,SP,10,F,UTTAR PRADESH,492135,492076,59,1212983,666239,546744,9.796180160810168,118826,24.14500086358418
47,MUKESH KUMAR,SC,HATHRAS (SC),32225,2,INC,9,M,UTTAR PRADESH,492135,492076,59,1212983,666239,546744,2.6574156439125693,32234,6.549828807136253
60,BHAGWAN SAHAY DHANGAR,SC,HATHRAS (SC),5979,5,INLD,0,M,UTTAR PRADESH,492135,492076,59,1212983,666239,546744,0.4929170483015837,5979,1.2149105428388551
59,VALWANT SINGH,SC,HATHRAS (SC),3954,11,IND,0,M,UTTAR PRADESH,492135,492076,59,1212983,666239,546744,0.3259732411748557,3954,0.8034380810143559
33,RAJVIR SINGH,SC,HATHRAS (SC),1223,9,IND,0,M,UTTAR PRADESH,492135,492076,59,1212983,666239,546744,0.10082581536592021,1223,0.24850904731425322
43,LAKHAN SINGH,SC,HATHRAS (SC),744,10,IND,0,M,UTTAR PRADESH,492135,492076,59,1212983,666239,546744,0.061336391359153426,744,0.15117803041848274
48,PHOOL SINGH,SC,HATHRAS (SC),692,7,IND,1,M,UTTAR PRADESH,492135,492076,59,1212983,666239,546744,0.05713188066114694,693,0.14081502026882867
56,TEKE CHANDRA RAO,SC,HATHRAS (SC),659,6,IND,0,M,UTTAR PRADESH,492135,492076,59,1212983,666239,546744,0.054328873529142625,659,0.13390634683572597
28,RAKESH KUMAR VIMAL,SC,HATHRAS (SC),562,8,IND,0,M,UTTAR PRADESH,492135,492076,59,1212983,666239,546744,0.04633205906430675,562,0.11419630792363884
49,BIJENDRA SINGH,GEN,ALIGARH,167104,3,INC,38,M,UTTAR PRADESH,633685,633500,185,1341254,731762,609492,12.461621736076836,167142,26.37619637517063
72,SHEELA GAUTAM,GEN,ALIGARH,164228,4,BJP,123,F,UTTAR PRADESH,633685,633500,185,1341254,731762,609492,12.253532887879553,164351,25.935756724555574
42,THAKUR JAIVEER SINGH,GEN,ALIGARH,159933,1,BSP,8,M,UTTAR PRADESH,633685,633500,185,1341254,731762,609492,11.924736105167254,159941,25.239827359019074
59,DALVEER SINGH,GEN,ALIGARH,117206,2,RLD,13,M,UTTAR PRADESH,633685,633500,185,1341254,731762,609492,8.739507953005173,117219,18.497991904495137
45,CHANDRA PAL,GEN,ALIGARH,12083,5,LP(S),0,M,UTTAR PRADESH,633685,633500,185,1341254,731762,609492,0.9008733617942611,12083,1.906783338725076
30,SATISH KUMAR,SC,ALIGARH,3686,16,IND,0,M,UTTAR PRADESH,633685,633500,185,1341254,731762,609492,0.2748174469563558,3686,0.5816770161831194
26,RAM KISHAN,GEN,ALIGARH,2546,15,IND,1,M,UTTAR PRADESH,633685,633500,185,1341254,731762,609492,0.18989691736240863,2547,0.4019347151976139
32,RAKESH KUMAR,GEN,ALIGARH,1544,13,IND,0,M,UTTAR PRADESH,633685,633500,185,1341254,731762,609492,0.11511615249609694,1544,0.24365418149395993
36,RAJVEER,SC,ALIGARH,1175,14,IND,0,M,UTTAR PRADESH,633685,633500,185,1341254,731762,609492,0.08760458496302714,1175,0.18542335703070137
50,TEJ SINGH,SC,ALIGARH,1054,6,ASP,0,M,UTTAR PRADESH,633685,633500,185,1341254,731762,609492,0.07858317663917498,1054,0.1663286964343483
29,BACHHU SINGH,SC,ALIGARH,647,12,IND,0,M,UTTAR PRADESH,633685,633500,185,1341254,731762,609492,0.048238439549854094,647,0.10210120170116067
44,PREM SINGH,SC,ALIGARH,607,11,IND,1,M,UTTAR PRADESH,633685,633500,185,1341254,731762,609492,0.04533071290001745,608,0.09594672431886506
31,MERAJ ALI,GEN,ALIGARH,550,9,RSBP,0,M,UTTAR PRADESH,633685,633500,185,1341254,731762,609492,0.041006401472055254,550,0.0867939118016049
58,MAHESH PRATAP,GEN,ALIGARH,403,8,RVP,0,M,UTTAR PRADESH,633685,633500,185,1341254,731762,609492,0.030046508714978673,403,0.0635962662837214
48,AMREEK SINGH,GEN,ALIGARH,370,10,IND,0,M,UTTAR PRADESH,633685,633500,185,1341254,731762,609492,0.027586124626655356,370,0.05838863157562511
73,MAHENDRA PAL,GEN,ALIGARH,364,7,BSK,1,M,UTTAR PRADESH,633685,633500,185,1341254,731762,609492,0.027213339158727576,365,0.057599596013792345
51,ASHOK KUMAR PRADHAN,SC,KHURJA (SC),214688,1,BJP,13,M,UTTAR PRADESH,600704,600689,15,1457828,797234,660594,14.727457560151128,214701,35.7415632324739
54,RAVI GAUTAM,SC,KHURJA (SC),173551,3,BSP,0,M,UTTAR PRADESH,600704,600689,15,1457828,797234,660594,11.904765171199895,173551,28.891267579373537
62,DEVI DAYAL,SC,KHURJA (SC),109112,2,INC,2,M,UTTAR PRADESH,600704,600689,15,1457828,797234,660594,7.4846964113736325,109114,18.164353824845513
48,RAM NIWAS BALMIKI,SC,KHURJA (SC),86374,4,RLD,0,M,UTTAR PRADESH,600704,600689,15,1457828,797234,660594,5.924841613688309,86374,14.378795546558704
79,RAM SAHAI,SC,KHURJA (SC),6446,10,IND,0,M,UTTAR PRADESH,600704,600689,15,1457828,797234,660594,0.44216464493753727,6446,1.0730742595354785
35,JAGPAL SINGH,SC,KHURJA (SC),3632,8,IND,0,M,UTTAR PRADESH,600704,600689,15,1457828,797234,660594,0.24913775836381247,3632,0.6046239079480076
65,OM PRAKASH,SC,KHURJA (SC),2140,7,IND,0,M,UTTAR PRADESH,600704,600689,15,1457828,797234,660594,0.14679372326502166,2140,0.35624866822927764
63,KRIPAL SINGH,SC,KHURJA (SC),2006,5,BKD,0,M,UTTAR PRADESH,600704,600689,15,1457828,797234,660594,0.13760196676151096,2006,0.3339415086298743
41,MAHENDRA SINGH,SC,KHURJA (SC),1931,9,IND,0,M,UTTAR PRADESH,600704,600689,15,1457828,797234,660594,0.13245732692745646,1931,0.32145615810782013
44,MAGAN LAL,SC,KHURJA (SC),809,6,ABHM,0,M,UTTAR PRADESH,600704,600689,15,1457828,797234,660594,0.05549351501000119,809,0.13467531429789048
72,KALYAN SINGH,GEN,BULANDSHAHR,258262,1,BJP,22,M,UTTAR PRADESH,685261,685228,33,1226141,665470,560671,21.064787818040504,258284,37.69133220772815
58,BADRUL ISLAM,GEN,BULANDSHAHR,241632,4,RLD,1,M,UTTAR PRADESH,685261,685228,33,1226141,665470,560671,19.706787392314588,241633,35.261455124397855
39,DEVENDRA BHARDWAJ,GEN,BULANDSHAHR,119104,3,BSP,0,M,UTTAR PRADESH,685261,685228,33,1226141,665470,560671,9.713727866534109,119104,17.380822781392784
53,PT CHANDRA SHEKHAR SHARMA,GEN,BULANDSHAHR,38795,2,INC,10,M,UTTAR PRADESH,685261,685228,33,1226141,665470,560671,3.1648073100891336,38805,5.662805850617502
64,HAKIM AHMAD QURESHI,GEN,BULANDSHAHR,5150,16,IND,0,M,UTTAR PRADESH,685261,685228,33,1226141,665470,560671,0.4200169474799391,5150,0.7515384649060722
32,PHIREY SINGH,GEN,BULANDSHAHR,4682,14,IND,0,M,UTTAR PRADESH,685261,685228,33,1226141,665470,560671,0.38184841710700484,4682,0.6832433189689768
48,MAHENDRA SINGH,GEN,BULANDSHAHR,3370,5,LP(S),0,M,UTTAR PRADESH,685261,685228,33,1226141,665470,560671,0.27484604136065915,3370,0.491783422666692
38,SHRINIVAS,GEN,BULANDSHAHR,3112,7,ABHM,0,M,UTTAR PRADESH,685261,685228,33,1226141,665470,560671,0.25380441564224665,3112,0.4541335345218829
46,NASIR IQBAL,GEN,BULANDSHAHR,3009,13,IND,0,M,UTTAR PRADESH,685261,685228,33,1226141,665470,560671,0.2454040766926479,3009,0.4391027652237614
55,CHUNNI LAL,GEN,BULANDSHAHR,2340,12,IND,0,M,UTTAR PRADESH,685261,685228,33,1226141,665470,560671,0.19084265186467136,2340,0.3414757296854775
48,RAMPHAL,GEN,BULANDSHAHR,1778,15,IND,0,M,UTTAR PRADESH,685261,685228,33,1226141,665470,560671,0.14500779274161782,1778,0.25946318264135854
48,YAD KARAN,GEN,BULANDSHAHR,1516,6,RSMD,0,M,UTTAR PRADESH,685261,685228,33,1226141,665470,560671,0.12363994026788111,1516,0.22122957530050594
51,CHAMAN LAL,GEN,BULANDSHAHR,813,11,IND,0,M,UTTAR PRADESH,685261,685228,33,1226141,665470,560671,0.06630558801964864,813,0.1186409265958518
33,SATENDRA SINGH,GEN,BULANDSHAHR,793,8,BRPP,0,M,UTTAR PRADESH,685261,685228,33,1226141,665470,560671,0.06467445424302752,793,0.11572233061563406
58,IMTIYAZ MOHD KHAN,GEN,BULANDSHAHR,449,9,IND,0,M,UTTAR PRADESH,685261,685228,33,1226141,665470,560671,0.03661895328514421,449,0.06552247975588862
55,SMT KRISHANA SINGH,GEN,BULANDSHAHR,423,10,IND,0,F,UTTAR PRADESH,685261,685228,33,1226141,665470,560671,0.03449847937553674,423,0.06172830498160555
53,SURENDRA PRAKASH GOYAL,GEN,HAPUR,235098,4,INC,16,M,UTTAR PRADESH,799736,799678,58,1806830,998543,808287,13.012513628841674,235114,29.398951654045835
58,RAMESH CHAND TOMAR,GEN,HAPUR,192724,3,BJP,27,M,UTTAR PRADESH,799736,799678,58,1806830,998543,808287,10.667910096688676,192751,24.101828603439134
38,KUNWAR AYYUB ALI,GEN,HAPUR,180063,1,BSP,5,M,UTTAR PRADESH,799736,799678,58,1806830,998543,808287,9.96596248678625,180068,22.515930256984806
52,TRILOK TYAGI,GEN,HAPUR,170701,2,RLD,9,M,UTTAR PRADESH,799736,799678,58,1806830,998543,808287,9.448038830437838,170710,21.34579411205698
38,VIRENDRA TYAGI,GEN,HAPUR,5994,16,IND,0,M,UTTAR PRADESH,799736,799678,58,1806830,998543,808287,0.33174122634669556,5994,0.7494973341202597
58,COL TEJENDRA PAL TYAGI VEER CHAKRA,GEN,HAPUR,2835,11,IND,0,M,UTTAR PRADESH,799736,799678,58,1806830,998543,808287,0.15690463408289657,2835,0.3544919823541769
48,ABDUL KARIM,GEN,HAPUR,2786,5,MUL,0,M,UTTAR PRADESH,799736,799678,58,1806830,998543,808287,0.1541927021357848,2786,0.3483649604369442
45,RAM KUMAR,GEN,HAPUR,1969,15,IND,0,M,UTTAR PRADESH,799736,799678,58,1806830,998543,808287,0.10897538783394123,1969,0.2462062480618604
63,RANJEET,GEN,HAPUR,1947,14,IND,0,M,UTTAR PRADESH,799736,799678,58,1806830,998543,808287,0.10775778573523795,1947,0.24345534026228655
52,MANJEET SINGH,GEN,HAPUR,1379,13,IND,0,M,UTTAR PRADESH,799736,799678,58,1806830,998543,808287,0.07632151336871758,1379,0.1724319025278342
38,GEETA TOMAR (ADVOCATE),GEN,HAPUR,1011,7,BKD,1,F,UTTAR PRADESH,799736,799678,58,1806830,998543,808287,0.05600969654034968,1012,0.12654175878039753
36,DAYARAM (HIJRA),GEN,HAPUR,929,12,IND,0,M,UTTAR PRADESH,799736,799678,58,1806830,998543,808287,0.051416015895241945,929,0.11616333390018707
47,DR MOHD IQBAL,GEN,HAPUR,641,6,NBNP,0,M,UTTAR PRADESH,799736,799678,58,1806830,998543,808287,0.03547649751221753,641,0.08015144997849291
26,USMAN QURAISHI,GEN,HAPUR,640,10,IND,0,M,UTTAR PRADESH,799736,799678,58,1806830,998543,808287,0.03542115196227647,640,0.08002640871487592
41,PRADEEP KUMAR,SC,HAPUR,487,9,IJP,0,M,UTTAR PRADESH,799736,799678,58,1806830,998543,808287,0.026953282821294756,487,0.06089509538147589
30,NAVEEN KUMAR GAUTAM,SC,HAPUR,474,8,BRPP,0,M,UTTAR PRADESH,799736,799678,58,1806830,998543,808287,0.02623379067206101,474,0.05926955895445497
34,MOHD SHAHID,GEN,MEERUT,252518,3,BSP,0,M,UTTAR PRADESH,697484,697471,13,1329974,723093,606881,18.986686957790152,252518,36.20412797999668
39,MALOOK NAGAR,GEN,MEERUT,183177,1,RLD,5,M,UTTAR PRADESH,697484,697471,13,1329974,723093,606881,13.773351960263886,183182,26.26325478433914
48,K C TYAGI,GEN,MEERUT,167215,5,JD(U),6,M,UTTAR PRADESH,697484,697471,13,1329974,723093,606881,12.573253311718876,167221,23.974886879125542
50,K K SHARMA,GEN,MEERUT,65912,2,INC,2,M,UTTAR PRADESH,697484,697471,13,1329974,723093,606881,4.956036734552705,65914,9.450252622282376
44,ANIL RASTOGI,GEN,MEERUT,15058,4,SHS,0,M,UTTAR PRADESH,697484,697471,13,1329974,723093,606881,1.1322025844114247,15058,2.158902569808053
40,SALEEM KHAN,GEN,MEERUT,4224,14,IND,0,M,UTTAR PRADESH,697484,697471,13,1329974,723093,606881,0.3176001936879969,4224,0.6056052898704487
39,PRADEEP KUMAR RASTOGI,GEN,MEERUT,2770,12,IND,0,M,UTTAR PRADESH,697484,697471,13,1329974,723093,606881,0.20827474822816086,2770,0.397141726548566
60,TEJVEER SINGH,GEN,MEERUT,1328,9,IND,0,M,UTTAR PRADESH,697484,697471,13,1329974,723093,606881,0.09985157604584752,1328,0.19039863280017894
38,SUDHIR KUMAR PANWAR (ADVOCATE),GEN,MEERUT,1245,6,RSBP,0,M,UTTAR PRADESH,697484,697471,13,1329974,723093,606881,0.09361085254298204,1245,0.17849871825016775
40,SARITA SAGAR,SC,MEERUT,1239,13,IND,0,F,UTTAR PRADESH,697484,697471,13,1329974,723093,606881,0.09315971590422069,1239,0.17763848346341995
47,NARENDRA,SC,MEERUT,885,10,IND,0,M,UTTAR PRADESH,697484,697471,13,1329974,723093,606881,0.06654265421730049,885,0.12688463104529996
65,DR HARI SINGH AZAD,GEN,MEERUT,754,7,ABLTP,0,M,UTTAR PRADESH,697484,697471,13,1329974,723093,606881,0.05669283760434415,754,0.10810283820130641
41,NAHAR SINGH,GEN,MEERUT,655,11,IND,0,M,UTTAR PRADESH,697484,697471,13,1329974,723093,606881,0.04924908306478172,655,0.09390896421996778
30,AMIT KUMAR JATAV,SC,MEERUT,491,8,IND,0,M,UTTAR PRADESH,697484,697471,13,1329974,723093,606881,0.036918014938637896,491,0.07039588004886134
65,AJIT SINGH,GEN,BAGHPAT,353168,1,RLD,13,M,UTTAR PRADESH,656900,656864,36,1570374,887531,682843,22.490247546125953,353181,53.76480438422896
50,AULAD ALI,GEN,BAGHPAT,132538,2,BSP,5,M,UTTAR PRADESH,656900,656864,36,1570374,887531,682843,8.440218699494515,132543,20.17704369005937
56,SATYAPAL SINGH MALIK,GEN,BAGHPAT,102309,4,BJP,8,M,UTTAR PRADESH,656900,656864,36,1570374,887531,682843,6.515454280317937,102317,15.575734510579997
48,JAGVEER,GEN,BAGHPAT,55158,3,INC,6,M,UTTAR PRADESH,656900,656864,36,1570374,887531,682843,3.5127937675993106,55164,8.397625209316487
44,HABIB AHMAD,GEN,BAGHPAT,4917,14,IND,2,M,UTTAR PRADESH,656900,656864,36,1570374,887531,682843,0.3132374835548729,4919,0.7488202161668442
39,SAMAR PAL,GEN,BAGHPAT,2488,8,INLD,1,M,UTTAR PRADESH,656900,656864,36,1570374,887531,682843,0.15849727517139228,2489,0.3789008981580149
30,SUBHASH,SC,BAGHPAT,1520,13,IND,0,M,UTTAR PRADESH,656900,656864,36,1570374,887531,682843,0.09679222911230065,1520,0.23138986147054347
40,KRISHNA BHAGWAN SWAMI,GEN,BAGHPAT,993,6,RPI,1,M,UTTAR PRADESH,656900,656864,36,1570374,887531,682843,0.0632970235115966,994,0.15131679098797382
48,ANAR SINGH,SC,BAGHPAT,750,5,BRPP,0,M,UTTAR PRADESH,656900,656864,36,1570374,887531,682843,0.04775932357514834,750,0.11417262901507079
33,BIRENDRA,SC,BAGHPAT,722,10,IND,0,M,UTTAR PRADESH,656900,656864,36,1570374,887531,682843,0.0459763088283428,722,0.10991018419850813
50,SHYAM SINGH,GEN,BAGHPAT,663,12,IND,0,M,UTTAR PRADESH,656900,656864,36,1570374,887531,682843,0.042219242040431135,663,0.10092860404932258
46,RAMAUTAR,GEN,BAGHPAT,652,11,IND,0,M,UTTAR PRADESH,656900,656864,36,1570374,887531,682843,0.04151877196132896,652,0.09925407215710152
37,NARENDRA,GEN,BAGHPAT,540,9,IND,0,M,UTTAR PRADESH,656900,656864,36,1570374,887531,682843,0.03438671297410681,540,0.08220429289085096
30,BRIJ PAL,SC,BAGHPAT,446,7,RSBP,0,M,UTTAR PRADESH,656900,656864,36,1570374,887531,682843,0.028400877752688212,446,0.0678946567209621
35,CH MUNAWWAR HASAN,GEN,MUZAFFARNAGAR,306221,2,SP,4,M,UTTAR PRADESH,862408,862387,21,1521778,829817,691961,20.122843147949308,306225,35.50813536052541
56,AMARPAL SINGH,GEN,MUZAFFARNAGAR,237207,1,BJP,13,M,UTTAR PRADESH,862408,862387,21,1521778,829817,691961,15.588344686281442,237220,27.506702164172875
59,SURATSINGH VERMA,GEN,MUZAFFARNAGAR,182290,4,BSP,0,M,UTTAR PRADESH,862408,862387,21,1521778,829817,691961,11.978751171327223,182290,21.137327111993397
56,SAIDUZZAMAN,GEN,MUZAFFARNAGAR,105173,3,INC,4,M,UTTAR PRADESH,862408,862387,21,1521778,829817,691961,6.911454890266517,105177,12.195735661079212
52,KUNWAR VIJENDER SINGH TYAGI,GEN,MUZAFFARNAGAR,11456,8,BKD,0,M,UTTAR PRADESH,862408,862387,21,1521778,829817,691961,0.7528036283873206,11456,1.3283735772395433
26,SALMAN SAEED,GEN,MUZAFFARNAGAR,5233,15,IND,0,M,UTTAR PRADESH,862408,862387,21,1521778,829817,691961,0.3438740736165196,5233,0.60678936187976
46,RANBIR SINGH KASHYAP,GEN,MUZAFFARNAGAR,3690,13,IND,0,M,UTTAR PRADESH,862408,862387,21,1521778,829817,691961,0.24247952066595782,3690,0.42787172660735984
30,MANOJ SAINI,GEN,MUZAFFARNAGAR,3524,12,IND,0,M,UTTAR PRADESH,862408,862387,21,1521778,829817,691961,0.2315712278663511,3524,0.40862329662990143
40,BRIHAM PRAKASH,SC,MUZAFFARNAGAR,2202,5,IJP,0,M,UTTAR PRADESH,862408,862387,21,1521778,829817,691961,0.14469916111285616,2202,0.2553315831949611
36,RAMVIR SINGH,GEN,MUZAFFARNAGAR,1406,14,IND,0,M,UTTAR PRADESH,862408,862387,21,1521778,829817,691961,0.09239192576052487,1406,0.1630318828211241
38,RAJ KUMAR,GEN,MUZAFFARNAGAR,1189,7,JSP,0,M,UTTAR PRADESH,862408,862387,21,1521778,829817,691961,0.0781322899923642,1189,0.13786977857348262
27,ARSHAD HASAN,GEN,MUZAFFARNAGAR,1070,9,IND,0,M,UTTAR PRADESH,862408,862387,21,1521778,829817,691961,0.07031248973240511,1070,0.12407120527638892
43,MOHD IRFAN,GEN,MUZAFFARNAGAR,727,6,NBNP,0,M,UTTAR PRADESH,862408,862387,21,1521778,829817,691961,0.047773065453699554,727,0.0842988469494717
70,BALBIR SINGH,SC,MUZAFFARNAGAR,542,11,IND,0,M,UTTAR PRADESH,862408,862387,21,1521778,829817,691961,0.03561623311678839,542,0.06284728342037643
35,PRADEEP VERMA,GEN,MUZAFFARNAGAR,457,10,IND,0,M,UTTAR PRADESH,862408,862387,21,1521778,829817,691961,0.030030661502531905,457,0.05299115963673806
43,ANURADHA CHOUDHARY,GEN,KAIRANA,523911,1,RLD,12,F,UTTAR PRADESH,816726,816700,26,1220829,673109,547720,42.91534686676021,523923,64.14917610067513
30,SHAHNAWAZ,GEN,KAIRANA,181509,3,BSP,0,M,UTTAR PRADESH,816726,816700,26,1220829,673109,547720,14.867684171984774,181509,22.223977196758764
36,AMARKANT RANA,GEN,KAIRANA,75844,2,BJP,7,M,UTTAR PRADESH,816726,816700,26,1220829,673109,547720,6.213073247768524,75851,9.287202807306244
62,SUBHASH CHAND MAHESHWARI,GEN,KAIRANA,12507,4,INC,4,M,UTTAR PRADESH,816726,816700,26,1220829,673109,547720,1.0247954463729154,12511,1.5318478902349135
48,OMPAL,GEN,KAIRANA,3687,14,IND,0,M,UTTAR PRADESH,816726,816700,26,1220829,673109,547720,0.3020078979119926,3687,0.4514365895049258
45,RAGHURAJ SINGH,GEN,KAIRANA,3538,9,BVP,0,M,UTTAR PRADESH,816726,816700,26,1220829,673109,547720,0.28980307643412795,3538,0.4331930169971325
35,UMA KASHYAP,GEN,KAIRANA,2670,6,BKD,1,F,UTTAR PRADESH,816726,816700,26,1220829,673109,547720,0.21878575951259346,2671,0.32703746421688545
43,JAIPAL,GEN,KAIRANA,1591,16,IND,0,M,UTTAR PRADESH,816726,816700,26,1220829,673109,547720,0.1303212816864606,1591,0.1948021735563702
40,JAKIR,GEN,KAIRANA,1344,17,IND,0,M,UTTAR PRADESH,816726,816700,26,1220829,673109,547720,0.11008912796140982,1344,0.16455947282197456
53,HARENDRA,GEN,KAIRANA,860,31,IND,0,M,UTTAR PRADESH,816726,816700,26,1220829,673109,547720,0.07044393604673546,860,0.10529847219263254
45,SUKHMAL,GEN,KAIRANA,851,28,IND,0,M,UTTAR PRADESH,816726,816700,26,1220829,673109,547720,0.069706732064851,851,0.10419651143712824
30,SURESH,GEN,KAIRANA,792,11,LP(S),0,M,UTTAR PRADESH,816726,816700,26,1220829,673109,547720,0.0648739504058308,792,0.09697254648437786
53,SUMAN CH,GEN,KAIRANA,762,29,IND,1,M,UTTAR PRADESH,816726,816700,26,1220829,673109,547720,0.06249851535309204,763,0.09342178404997514
25,YOGESH,GEN,KAIRANA,740,22,IND,0,M,UTTAR PRADESH,816726,816700,26,1220829,673109,547720,0.06061454962160957,740,0.09060566211924195
31,NASEEM HAIDER,GEN,KAIRANA,714,19,IND,0,M,UTTAR PRADESH,816726,816700,26,1220829,673109,547720,0.058484849229498974,714,0.087422219936674
42,KAMRUZAMA,GEN,KAIRANA,660,15,IND,0,M,UTTAR PRADESH,816726,816700,26,1220829,673109,547720,0.05406162533819232,660,0.08081045540364823
25,ASHU SHARMA URF ASHWANI SHARMA,GEN,KAIRANA,542,5,BJVP,1,M,UTTAR PRADESH,816726,816700,26,1220829,673109,547720,0.044477973573694596,543,0.06648496558209241
39,GAYOOR,GEN,KAIRANA,488,7,RPI,0,M,UTTAR PRADESH,816726,816700,26,1220829,673109,547720,0.03997283812884524,488,0.05975076096512171
30,IJHARULHAQ,GEN,KAIRANA,485,13,IND,0,M,UTTAR PRADESH,816726,816700,26,1220829,673109,547720,0.03972710346821709,485,0.05938344071328695
53,HARPAL SINGH,SC,KAIRANA,364,30,IND,0,M,UTTAR PRADESH,816726,816700,26,1220829,673109,547720,0.029815805489548493,364,0.044568190555951445
29,SHAHEEN,GEN,KAIRANA,359,25,IND,0,M,UTTAR PRADESH,816726,816700,26,1220829,673109,547720,0.029406247721834918,359,0.043955990136226836
36,SHIMLA URF SHIMLA KASHYAP,GEN,KAIRANA,344,26,IND,0,F,UTTAR PRADESH,816726,816700,26,1220829,673109,547720,0.028177574418694184,344,0.042119388877053014
49,MUSHEER AHMAD,GEN,KAIRANA,327,8,AP,0,M,UTTAR PRADESH,816726,816700,26,1220829,673109,547720,0.026785078008468015,327,0.04003790744998935
42,PHALKUMAR,SC,KAIRANA,321,20,IND,0,M,UTTAR PRADESH,816726,816700,26,1220829,673109,547720,0.02629360868721172,321,0.03930326694631982
48,DILSHAD ALI,GEN,KAIRANA,318,18,IND,0,M,UTTAR PRADESH,816726,816700,26,1220829,673109,547720,0.026047874026583574,318,0.03893594669448505
69,RAMKRISHAN MITTAL,GEN,KAIRANA,318,24,IND,0,M,UTTAR PRADESH,816726,816700,26,1220829,673109,547720,0.026047874026583574,318,0.03893594669448505
35,SHORAJ SINGH,GEN,KAIRANA,216,27,IND,0,M,UTTAR PRADESH,816726,816700,26,1220829,673109,547720,0.017692895565226577,216,0.026447058132103053
53,ANAND PAL,GEN,KAIRANA,208,12,IND,0,M,UTTAR PRADESH,816726,816700,26,1220829,673109,547720,0.017037603136884853,208,0.025467537460543685
37,RADHESH KUMAR URF PAPPU,SC,KAIRANA,203,10,IJP,0,M,UTTAR PRADESH,816726,816700,26,1220829,673109,547720,0.016628045369171278,203,0.024855337040819075
25,MUKESH,GEN,KAIRANA,126,21,IND,0,M,UTTAR PRADESH,816726,816700,26,1220829,673109,547720,0.010320855746382172,126,0.015427450577060116
45,RAVINDRA KUMAR,GEN,KAIRANA,101,23,IND,0,M,UTTAR PRADESH,816726,816700,26,1220829,673109,547720,0.00827306690781428,101,0.012366448478437077
53,RASHEED MASOOD,GEN,SAHARANPUR,353271,4,SP,1,M,UTTAR PRADESH,990415,990397,18,1566135,846308,719827,22.55693155443177,353272,35.66908821049762
60,MANSOOR ALI KHAN,GEN,SAHARANPUR,326441,2,BSP,3,M,UTTAR PRADESH,990415,990397,18,1566135,846308,719827,20.843924693592825,326444,32.96032471236805
79,CH YASHPAL SINGH,GEN,SAHARANPUR,230336,3,BJP,10,M,UTTAR PRADESH,990415,990397,18,1566135,846308,719827,14.707927477516305,230346,23.257523361419203
54,TARA CHANDRA SHASTRI,GEN,SAHARANPUR,51063,1,INC,4,M,UTTAR PRADESH,990415,990397,18,1566135,846308,719827,3.260702302164245,51067,5.156121423847579
28,SUSHIL,GEN,SAHARANPUR,8173,14,IND,0,M,UTTAR PRADESH,990415,990397,18,1566135,846308,719827,0.5218579496658973,8173,0.8252096343451988
25,SHAHID URF POOJA,GEN,SAHARANPUR,5248,13,IND,0,F,UTTAR PRADESH,990415,990397,18,1566135,846308,719827,0.33509244094538465,5248,0.529878889152527
35,PRAKASH SHARMA,GEN,SAHARANPUR,3630,5,RPI,0,M,UTTAR PRADESH,990415,990397,18,1566135,846308,719827,0.2317807851813541,3630,0.3665130273673157
43,YOGENDRA,GEN,SAHARANPUR,3173,11,IND,0,M,UTTAR PRADESH,990415,990397,18,1566135,846308,719827,0.20260066980177316,3173,0.32037075367396495
34,MOHSEEN,GEN,SAHARANPUR,2258,7,INLD,0,M,UTTAR PRADESH,990415,990397,18,1566135,846308,719827,0.14417658758663845,2258,0.22798523851112915
35,RAVEENDRA KUMAR,GEN,SAHARANPUR,2176,12,IND,0,M,UTTAR PRADESH,990415,990397,18,1566135,846308,719827,0.1389407681968668,2176,0.21970588086812093
49,BRIJ PAL SINGH,SC,SAHARANPUR,1592,6,IJP,0,M,UTTAR PRADESH,990415,990397,18,1566135,846308,719827,0.10165151790873712,1592,0.16074069960572082
41,MOHD HUSSAIN JILANI,GEN,SAHARANPUR,1415,8,MUL,0,M,UTTAR PRADESH,990415,990397,18,1566135,846308,719827,0.09034981020154713,1415,0.14286940322995914
43,MOHAMMAD ARIF,GEN,SAHARANPUR,862,9,IND,0,M,UTTAR PRADESH,990415,990397,18,1566135,846308,719827,0.055039955048575,862,0.0870342230277207
57,BADROOL,GEN,SAHARANPUR,759,10,IND,0,M,UTTAR PRADESH,990415,990397,18,1566135,846308,719827,0.048463255083374034,759,0.07663454208589329
53,HITEN BARMAN,SC,COOCH BEHAR (SC),487332,3,AIFB,3650,M,WEST BENGAL,952563,947381,5182,1148934,597710,551224,42.73369923772819,490982,51.54325750632766
50,GIRINDRA NATH BARMAN,SC,COOCH BEHAR (SC),263400,1,AITC,1013,M,WEST BENGAL,952563,947381,5182,1148934,597710,551224,23.01376754452388,264413,27.758059047013163
43,SAILEN BARMA,SC,COOCH BEHAR (SC),116327,2,INC,388,M,WEST BENGAL,952563,947381,5182,1148934,597710,551224,10.15854696614427,116715,12.252732890108057
74,AMAR ROY PRADHAN,SC,COOCH BEHAR (SC),26660,6,IND,95,M,WEST BENGAL,952563,947381,5182,1148934,597710,551224,2.3286803245443166,26755,2.808738109710329
29,BHARAT SINGHA SARKAR,SC,COOCH BEHAR (SC),17389,9,IND,4,M,WEST BENGAL,952563,947381,5182,1148934,597710,551224,1.5138380446570474,17393,1.825915976161157
40,PRADIP KUMAR ROY,SC,COOCH BEHAR (SC),11016,8,IND,5,M,WEST BENGAL,952563,947381,5182,1148934,597710,551224,0.9592369970772908,11021,1.1569838425384988
53,NRIPEN KARJEE,SC,COOCH BEHAR (SC),10676,7,IND,6,M,WEST BENGAL,952563,947381,5182,1148934,597710,551224,0.929731385788914,10682,1.1213956452224159
45,DALENDRA NATH ROY,SC,COOCH BEHAR (SC),8522,4,AMB,5,M,WEST BENGAL,952563,947381,5182,1148934,597710,551224,0.7421662166843352,8527,0.8951638894225369
36,PIJUSH BARMAN,SC,COOCH BEHAR (SC),6059,5,SP,16,M,WEST BENGAL,952563,947381,5182,1148934,597710,551224,0.5287509987518866,6075,0.6377530934961781
49,JOACHIM BAXLA,ST,ALIPURDUARS (ST),381694,1,RSP,2558,M,WEST BENGAL,840836,837257,3579,1045042,546690,498352,36.769048516710335,384252,45.69880452311747
31,MANOJ TIGGA,ST,ALIPURDUARS (ST),238534,2,BJP,594,M,WEST BENGAL,840836,837257,3579,1045042,546690,498352,22.88214253589808,239128,28.43931515777155
59,RATAN LAL BARAIK,ST,ALIPURDUARS (ST),169088,3,INC,411,M,WEST BENGAL,840836,837257,3579,1045042,546690,498352,16.219348121893663,169499,20.15838998330233
40,SAMARENDRA EKKA ( PINTU),ST,ALIPURDUARS (ST),20009,6,IND,5,M,WEST BENGAL,840836,837257,3579,1045042,546690,498352,1.9151383389375738,20014,2.3802501320114744
62,RAMPRATAP BARAIK,ST,ALIPURDUARS (ST),14078,5,IND,9,M,WEST BENGAL,840836,837257,3579,1045042,546690,498352,1.3479841001605677,14087,1.6753564309805953
52,PAUL DEXION KHARIA,ST,ALIPURDUARS (ST),13854,4,IND,2,M,WEST BENGAL,840836,837257,3579,1045042,546690,498352,1.3258797254081653,13856,1.6478837728165778
60,MINATI SEN,GEN,JALPAIGURI,420262,3,CPM,3901,F,WEST BENGAL,890105,884971,5134,1104784,586142,518642,38.39329678923663,424163,47.65314204503963
57,PARASH DUTTA,GEN,JALPAIGURI,242791,2,AITC,767,M,WEST BENGAL,890105,884971,5134,1104784,586142,518642,22.045757360714855,243558,27.36283921559816
64,DIPAK KRISHNA BHOWMIK,GEN,JALPAIGURI,129886,1,INC,369,M,WEST BENGAL,890105,884971,5134,1104784,586142,518642,11.790087474112587,130255,14.633666814589292
54,NACHHIR ALI PRAMANIK,GEN,JALPAIGURI,19277,7,IND,39,M,WEST BENGAL,890105,884971,5134,1104784,586142,518642,1.7483960665614275,19316,2.170081057852725
36,SUBHASISH DASGUPTA,GEN,JALPAIGURI,18471,10,IND,2,M,WEST BENGAL,890105,884971,5134,1104784,586142,518642,1.6720915581688367,18473,2.075373130136332
65,SHANKAR KUMAR GANGULI,GEN,JALPAIGURI,14732,9,IND,13,M,WEST BENGAL,890105,884971,5134,1104784,586142,518642,1.3346500311373082,14745,1.6565461378152018
45,SANTI KUMAR SARKAR,SC,JALPAIGURI,13670,4,BSP,17,M,WEST BENGAL,890105,884971,5134,1104784,586142,518642,1.2388847050645195,13687,1.5376837564107606
57,BHIM CHANDRA ROY,SC,JALPAIGURI,13517,8,IND,10,M,WEST BENGAL,890105,884971,5134,1104784,586142,518642,1.2244022360932092,13527,1.5197083490150038
57,SANKAR DAS,GEN,JALPAIGURI,7268,6,CPI(ML)(L),10,M,WEST BENGAL,890105,884971,5134,1104784,586142,518642,0.658771307332474,7278,0.817656343914482
53,PABITRA MAITRA,SC,JALPAIGURI,5097,5,AMB,6,M,WEST BENGAL,890105,884971,5134,1104784,586142,518642,0.4619002447537256,5103,0.5733031496284147
67,DAWA NARBULA,ST,DARJEELING,396531,2,INC,442,M,WEST BENGAL,888083,886298,1785,1249238,648990,600248,31.777211388062167,396973,44.69998862718912
38,MONI THAPA,GEN,DARJEELING,294299,4,CPM,1258,F,WEST BENGAL,888083,886298,1785,1249238,648990,600248,23.6589825157416,295557,33.28033528397684
65,DR G S YONZONE,ST,DARJEELING,113897,1,BJP,75,M,WEST BENGAL,888083,886298,1785,1249238,648990,600248,9.123321576833238,113972,12.833485158481809
38,SANJAY THAKURI,GEN,DARJEELING,20988,10,IND,0,M,WEST BENGAL,888083,886298,1785,1249238,648990,600248,1.6800641671162742,20988,2.3632926201717632
40,MOHAN CHHETRI,GEN,DARJEELING,14855,7,IND,2,M,WEST BENGAL,888083,886298,1785,1249238,648990,600248,1.1892849881287633,14857,1.672929219453587
37,RAJU BHATTA,GEN,DARJEELING,11112,8,IND,0,M,WEST BENGAL,888083,886298,1785,1249238,648990,600248,0.889502240565849,11112,1.2512344003882518
39,BIMAL DUTTA,GEN,DARJEELING,10752,3,BSP,6,M,WEST BENGAL,888083,886298,1785,1249238,648990,600248,0.8611649661633731,10758,1.2113732612830106
53,KISHALAY KANTI SHARMA,SC,DARJEELING,8695,5,IND,0,M,WEST BENGAL,888083,886298,1785,1249238,648990,600248,0.6960242964110922,8695,0.9790751540115057
42,LALIT BARMAN,SC,DARJEELING,8690,9,IND,0,M,WEST BENGAL,888083,886298,1785,1249238,648990,600248,0.6956240524223566,8690,0.9785121435721661
52,TIKA PRADHAN,GEN,DARJEELING,6479,6,IND,2,M,WEST BENGAL,888083,886298,1785,1249238,648990,600248,0.5187962581989981,6481,0.7297741314719458
58,PRIYA RANJAN DASMUNSI,GEN,RAIGANJ,420408,3,INC,1496,M,WEST BENGAL,917582,913637,3945,1147290,596765,550525,36.77396299104847,421904,45.97997781124739
57,MINATI GHOSH,GEN,RAIGANJ,380519,4,CPM,2238,F,WEST BENGAL,917582,913637,3945,1147290,596765,550525,33.361835281402264,382757,41.71365610920877
73,ABEDIN DR ZAINAL,GEN,RAIGANJ,57726,2,AITC,205,M,WEST BENGAL,917582,913637,3945,1147290,596765,550525,5.049377228076598,57931,6.313441196536114
44,ANIL BISWAS,SC,RAIGANJ,11201,1,BSP,4,M,WEST BENGAL,917582,913637,3945,1147290,596765,550525,0.9766493214444474,11205,1.221144268305176
62,AJIT DAS,SC,RAIGANJ,11152,5,CPI(ML)(L),2,M,WEST BENGAL,917582,913637,3945,1147290,596765,550525,0.972204063488743,11154,1.2155861819434122
45,SUBRATA ADHIKARY,GEN,RAIGANJ,9914,9,IND,0,M,WEST BENGAL,917582,913637,3945,1147290,596765,550525,0.8641232818206381,9914,1.0804483958926832
41,SUKUMAL BISWAS,SC,RAIGANJ,9624,8,IND,0,M,WEST BENGAL,917582,913637,3945,1147290,596765,550525,0.8388463248176137,9624,1.0488435910904965
33,ACHINTYA TARAFDAR,GEN,RAIGANJ,7037,7,IND,0,M,WEST BENGAL,917582,913637,3945,1147290,596765,550525,0.613358435966495,7037,0.7669069358378869
32,ASHIS SAHA,GEN,RAIGANJ,6056,6,SP,0,M,WEST BENGAL,917582,913637,3945,1147290,596765,550525,0.527852591759712,6056,0.6599955099380763
35,RANEN BARMAN,SC,BALURGHAT (SC),411803,4,RSP,3495,M,WEST BENGAL,925631,920808,4823,1129369,590331,539038,36.77256946135408,415298,44.866474869575455
69,MANOMOHAN RAY,SC,BALURGHAT (SC),343114,3,BJP,1038,M,WEST BENGAL,925631,920808,4823,1129369,590331,539038,30.472945512051417,344152,37.1802586559871
28,DIPTI BARMAN,SC,BALURGHAT (SC),118826,2,INC,278,F,WEST BENGAL,925631,920808,4823,1129369,590331,539038,10.546065989061148,119104,12.867330502111532
38,BINOY MALLICK,SC,BALURGHAT (SC),19572,6,IND,2,M,WEST BENGAL,925631,920808,4823,1129369,590331,539038,1.733180209479807,19574,2.1146655632752145
46,GOBINDA SAKAR,SC,BALURGHAT (SC),17222,1,BSP,8,M,WEST BENGAL,925631,920808,4823,1129369,590331,539038,1.5256306840368383,17230,1.8614329036084576
26,PRAHALLAD BARMAN,SC,BALURGHAT (SC),10271,5,IND,2,M,WEST BENGAL,925631,920808,4823,1129369,590331,539038,0.9096229841619523,10273,1.1098375054422336
69,A B A GHANI KHAN CHOUDHURY,GEN,MALDA,411668,1,INC,1245,M,WEST BENGAL,849111,843986,5125,1088411,559574,528837,37.93723143187638,412913,48.628860066587286
41,PRANAB DAS,GEN,MALDA,298090,2,CPM,3715,M,WEST BENGAL,849111,843986,5125,1088411,559574,528837,27.728955330293424,301805,35.543645059362085
51,BADSHA ALAM,GEN,MALDA,86371,3,BJP,154,M,WEST BENGAL,849111,843986,5125,1088411,559574,528837,7.949662397752319,86525,10.190069378444043
52,SADHAN CHATTERJEE,GEN,MALDA,18812,10,IND,1,M,WEST BENGAL,849111,843986,5125,1088411,559574,528837,1.7284830822180224,18813,2.2156113864971716
30,TUSHAR KANTI BESRA,ST,MALDA,5743,6,IND,5,M,WEST BENGAL,849111,843986,5125,1088411,559574,528837,0.5281093263482268,5748,0.6769432971660949
39,MAJEDUR RAHAMAN,GEN,MALDA,5496,9,IND,0,M,WEST BENGAL,849111,843986,5125,1088411,559574,528837,0.5049563078653192,5496,0.6472651985429466
60,LAWRENCE HANSDA,ST,MALDA,5360,4,BSP,4,M,WEST BENGAL,849111,843986,5125,1088411,559574,528837,0.4928285362790343,5364,0.6317195278355834
32,PARIMAL MARDI,ST,MALDA,5283,8,IND,0,M,WEST BENGAL,849111,843986,5125,1088411,559574,528837,0.485386494623814,5283,0.6221801389924285
33,ATUL CHANDRA MANDAL,SC,MALDA,3793,5,IND,1,M,WEST BENGAL,849111,843986,5125,1088411,559574,528837,0.3485815560482208,3794,0.4468202626040647
51,NARESH RISHI,SC,MALDA,3370,7,IND,0,M,WEST BENGAL,849111,843986,5125,1088411,559574,528837,0.3096256836801539,3370,0.3968856839682916
67,PRANAB MUKHERJEE,GEN,JANGIPUR,430438,3,INC,1209,M,WEST BENGAL,883128,880175,2953,1082151,551546,530605,39.88787147080213,431647,48.87705972407171
58,ABUL HASNAT KHAN,GEN,JANGIPUR,393082,1,CPM,1705,M,WEST BENGAL,883128,880175,2953,1082151,551546,530605,36.48169248099387,394787,44.70325932367675
68,SHISH MOHAMMAD,GEN,JANGIPUR,19693,4,AITC,32,M,WEST BENGAL,883128,880175,2953,1082151,551546,530605,1.8227585614207258,19725,2.2335380601679486
26,PALASH DE,SC,JANGIPUR,9957,9,IND,2,M,WEST BENGAL,883128,880175,2953,1082151,551546,530605,0.9202967053581247,9959,1.1276960984138198
59,GOUR PADA BISWAS MALLIK,SC,JANGIPUR,8496,2,BSP,3,M,WEST BENGAL,883128,880175,2953,1082151,551546,530605,0.7853802288220406,8499,0.9623746501073458
61,ABDUS SAYEED,GEN,JANGIPUR,7130,7,IND,2,M,WEST BENGAL,883128,880175,2953,1082151,551546,530605,0.6590577470242138,7132,0.8075839515902565
33,TOJIBUR RAHAMAN,GEN,JANGIPUR,3997,8,IND,0,M,WEST BENGAL,883128,880175,2953,1082151,551546,530605,0.3693569566539235,3997,0.452595773206149
56,MOHAMMAD ABDUR RAHAMAN,GEN,JANGIPUR,3934,5,SP,0,M,WEST BENGAL,883128,880175,2953,1082151,551546,530605,0.3635352182828459,3934,0.445462039477856
29,ABU ASIM SIDDIQUE,GEN,JANGIPUR,3448,6,IND,0,M,WEST BENGAL,883128,880175,2953,1082151,551546,530605,0.31862466513453297,3448,0.3904303792881666
51,ABDUL MANNAN HOSSAIN,GEN,MURSHIDABAD,460539,2,INC,1356,M,WEST BENGAL,1007221,1003469,3752,1197170,619686,577484,38.58223978215291,461895,45.858356805507434
45,MOINUL HASSAN AHAMED,GEN,MURSHIDABAD,444135,4,CPM,2280,M,WEST BENGAL,1007221,1003469,3752,1197170,619686,577484,37.289190340553134,446415,44.32145477506923
39,ALI MOHAMMAD,GEN,MURSHIDABAD,43630,1,AITC,86,M,WEST BENGAL,1007221,1003469,3752,1197170,619686,577484,3.651611717634087,43716,4.340258989834406
49,KHADIJA BANU,GEN,MURSHIDABAD,13671,8,IND,15,F,WEST BENGAL,1007221,1003469,3752,1197170,619686,577484,1.1431960373213494,13686,1.3587881904765686
57,ABDUR RASHID MONDAL,GEN,MURSHIDABAD,10441,5,PBRML,5,M,WEST BENGAL,1007221,1003469,3752,1197170,619686,577484,0.8725577821027924,10446,1.0371110213150838
37,ABDUL HANNAN SEIKH,GEN,MURSHIDABAD,10007,3,BSP,6,M,WEST BENGAL,1007221,1003469,3752,1197170,619686,577484,0.8363891510813002,10013,0.9941214490166508
34,BABITA HALDAR,SC,MURSHIDABAD,7501,10,IND,2,F,WEST BENGAL,1007221,1003469,3752,1197170,619686,577484,0.6267280336126031,7503,0.7449209259934017
28,DINESH MANDAL,SC,MURSHIDABAD,4793,9,IND,0,M,WEST BENGAL,1007221,1003469,3752,1197170,619686,577484,0.40036085100695806,4793,0.4758637875898139
44,MD SAHABUDDIN,GEN,MURSHIDABAD,4549,6,INL,1,M,WEST BENGAL,1007221,1003469,3752,1197170,619686,577484,0.3800629818655663,4550,0.45173799990270264
65,SYED NAWAB JANI MEERZA,GEN,MURSHIDABAD,4203,7,SP,1,M,WEST BENGAL,1007221,1003469,3752,1197170,619686,577484,0.3511614891786463,4204,0.41738605529471684
48,ADHIR RANJAN CHOWDHURY,GEN,BERHAMPORE,506236,1,INC,1859,M,WEST BENGAL,991515,987384,4131,1220502,624346,596156,41.630001425642895,508095,51.244307952981046
58,PRAMOTHES MUKHERJEE,GEN,BERHAMPORE,407047,3,RSP,2147,M,WEST BENGAL,991515,987384,4131,1220502,624346,596156,33.52669639214028,409194,41.26957232114491
48,TAPAS KUMAR CHATTERJEE,GEN,BERHAMPORE,41379,2,BJP,111,M,WEST BENGAL,991515,987384,4131,1220502,624346,596156,3.3994208940255732,41490,4.184505529417104
39,JYOTIRMOY THAKUR,GEN,BERHAMPORE,9672,9,IND,0,M,WEST BENGAL,991515,987384,4131,1220502,624346,596156,0.7924608071105168,9672,0.9754769216804586
50,APURBA BANERJEE,GEN,BERHAMPORE,6808,6,IND,10,M,WEST BENGAL,991515,987384,4131,1220502,624346,596156,0.5586225995532985,6818,0.6876345794062622
63,SUNIL KUMAR MONDAL,GEN,BERHAMPORE,5641,4,BSP,2,M,WEST BENGAL,991515,987384,4131,1220502,624346,596156,0.46235073764729595,5643,0.5691290600747342
35,ASHIM ROY,SC,BERHAMPORE,3797,7,IND,1,M,WEST BENGAL,991515,987384,4131,1220502,624346,596156,0.31118343107999824,3798,0.38305018078395187
45,KRISHNA PROSAD BISWAS,SC,BERHAMPORE,3428,8,IND,0,M,WEST BENGAL,991515,987384,4131,1220502,624346,596156,0.2808680362670442,3428,0.34573354916466215
50,ASHOKE KUMAR SINGHA,GEN,BERHAMPORE,3376,5,SP,1,M,WEST BENGAL,991515,987384,4131,1220502,624346,596156,0.27668942779282624,3377,0.34058990534686817
35,JYOTIRMOYEE SIKDAR,GEN,KRISHNAGAR,393736,2,CPM,3825,F,WEST BENGAL,930294,923868,6426,1117441,589512,527929,35.5778067924839,397561,42.73498485425037
71,SATYA BRATA MOOKHERJEE,GEN,KRISHNAGAR,374856,4,BJP,2318,M,WEST BENGAL,930294,923868,6426,1117441,589512,527929,33.75337042403134,377174,40.54352710003504
53,ASIM KUMAR SAHA,GEN,KRISHNAGAR,95226,1,INC,253,M,WEST BENGAL,930294,923868,6426,1117441,589512,527929,8.544433218398108,95479,10.263314608070138
49,JAYASHREE CHAKRABORTY,GEN,KRISHNAGAR,12598,5,SP,4,F,WEST BENGAL,930294,923868,6426,1117441,589512,527929,1.1277552908833666,12602,1.3546255269839427
58,KHODA BOX SHAIKH,GEN,KRISHNAGAR,11336,8,IND,2,M,WEST BENGAL,930294,923868,6426,1117441,589512,527929,1.0146396990982074,11338,1.2187545012651912
49,MOZAMMEL HAQUE PAILE,GEN,KRISHNAGAR,10017,3,BSP,7,M,WEST BENGAL,930294,923868,6426,1117441,589512,527929,0.8970495981443316,10024,1.0775088305417428
38,UJJWAL MUKHERJEE,GEN,KRISHNAGAR,9301,7,IND,0,M,WEST BENGAL,930294,923868,6426,1117441,589512,527929,0.8323481955646874,9301,0.9997914637738177
69,PROFULLA BANERJEE,GEN,KRISHNAGAR,9299,9,IND,1,M,WEST BENGAL,930294,923868,6426,1117441,589512,527929,0.8322587053813132,9300,0.9996839708737237
55,BIMAN BISWAS,GEN,KRISHNAGAR,7499,6,CPI(ML)(L),16,M,WEST BENGAL,930294,923868,6426,1117441,589512,527929,0.6725187280581256,7515,0.8078091442060252
40,ALAKESH DAS,SC,NABADWIP (SC),556203,1,CPM,3973,M,WEST BENGAL,1177771,1171667,6104,1389486,730239,659247,40.31533962918662,560176,47.56238691562282
44,NILIMA NAG ( MALLICK),SC,NABADWIP (SC),548113,2,AITC,2072,F,WEST BENGAL,1177771,1171667,6104,1389486,730239,659247,39.5962967600969,550185,46.71408958108155
48,HOWLADAR NRIPENDRA NATH,SC,NABADWIP (SC),24236,4,INC,32,M,WEST BENGAL,1177771,1171667,6104,1389486,730239,659247,1.7465451253197226,24268,2.0605024236460228
58,SATISH BISWAS,SC,NABADWIP (SC),15694,3,BSP,25,M,WEST BENGAL,1177771,1171667,6104,1389486,730239,659247,1.1312816393975902,15719,1.3346397559457652
31,BASU DEV BACHHAR,SC,NABADWIP (SC),11139,9,IND,0,M,WEST BENGAL,1177771,1171667,6104,1389486,730239,659247,0.8016633488930438,11139,0.9457695935797367
36,PARIMAL DHALI,SC,NABADWIP (SC),8317,8,IND,1,M,WEST BENGAL,1177771,1171667,6104,1389486,730239,659247,0.5986386332787808,8318,0.7062493472839796
47,GOPAL BISWAS,SC,NABADWIP (SC),3709,6,IND,1,M,WEST BENGAL,1177771,1171667,6104,1389486,730239,659247,0.2670052091204949,3710,0.3150018127462809
29,PARAMESH CHANDRA BISWAS,SC,NABADWIP (SC),2219,7,IND,0,M,WEST BENGAL,1177771,1171667,6104,1389486,730239,659247,0.15969934205886205,2219,0.18840674460485102
34,AMITOSH BISWAS,SC,NABADWIP (SC),2037,5,IND,0,M,WEST BENGAL,1177771,1171667,6104,1389486,730239,659247,0.14660097330955474,2037,0.17295382548899574
72,SUBRATA BOSE,GEN,BARASAT,517118,4,AIFB,3266,M,WEST BENGAL,1153160,1148662,4498,1388017,730680,657337,37.49118346533219,520384,45.12678205973152
72,DR RANJIT KUMAR PANJA,GEN,BARASAT,507124,3,AITC,1100,M,WEST BENGAL,1153160,1148662,4498,1388017,730680,657337,36.61511350365305,508224,44.0722883207881
56,PRABIR BANERJEE,GEN,BARASAT,60924,2,INC,90,M,WEST BENGAL,1153160,1148662,4498,1388017,730680,657337,4.395767486997638,61014,5.291026397030767
62,DULAL CHANDRA DAS,SC,BARASAT,24332,1,BSP,35,M,WEST BENGAL,1153160,1148662,4498,1388017,730680,657337,1.7555260490325408,24367,2.1130632349370426
54,WALIUR RAHAMAN,GEN,BARASAT,12132,5,SP,0,M,WEST BENGAL,1153160,1148662,4498,1388017,730680,657337,0.8740526953200141,12132,1.0520656283603316
27,SAMPATIA MUNDA,ST,BARASAT,7932,10,IND,0,F,WEST BENGAL,1153160,1148662,4498,1388017,730680,657337,0.571462741450573,7932,0.6878490408963197
50,SANKAR GHOSH,GEN,BARASAT,6152,9,IND,4,M,WEST BENGAL,1153160,1148662,4498,1388017,730680,657337,0.4435104181000665,6156,0.533837455340109
33,ANJAN ADHIKARY,SC,BARASAT,6029,7,IND,2,M,WEST BENGAL,1153160,1148662,4498,1388017,730680,657337,0.434504764711095,6031,0.5229976759512991
64,ARUN BASU,GEN,BARASAT,3869,8,IND,0,M,WEST BENGAL,1153160,1148662,4498,1388017,730680,657337,0.27874298369544465,3869,0.3355128516424434
40,KABI ROY,GEN,BARASAT,3050,6,SAP,1,M,WEST BENGAL,1153160,1148662,4498,1388017,730680,657337,0.21980998791801543,3051,0.26457733532207156
60,AJAY CHAKRABORTY,GEN,BASIRHAT,461373,1,CPI,1232,M,WEST BENGAL,907585,906003,1582,1107129,578151,528978,41.78420039579851,462605,50.97098343405852
41,SUJIT BOSE,GEN,BASIRHAT,280285,3,AITC,236,M,WEST BENGAL,907585,906003,1582,1107129,578151,528978,25.33769777505602,280521,30.908509946726753
38,SYED MD NIZAMUDDIN,GEN,BASIRHAT,109516,4,INC,113,M,WEST BENGAL,907585,906003,1582,1107129,578151,528978,9.902098129486266,109629,12.079199193463973
30,MD QUAMRUZZAMAN,GEN,BASIRHAT,25773,6,SP,0,M,WEST BENGAL,907585,906003,1582,1107129,578151,528978,2.327913007427319,25773,2.8397340194031413
55,KARTICK CHANDRA SARKAR,GEN,BASIRHAT,12487,8,IND,0,M,WEST BENGAL,907585,906003,1582,1107129,578151,528978,1.1278721811098797,12487,1.3758490940242512
35,GOPAL DEBNATH,GEN,BASIRHAT,7300,2,BSP,1,M,WEST BENGAL,907585,906003,1582,1107129,578151,528978,0.6594534150943566,7301,0.8044425590991477
47,ASHRAFI HASSAN SHAHIDULLAH,GEN,BASIRHAT,4780,5,INL,0,M,WEST BENGAL,907585,906003,1582,1107129,578151,528978,0.43174733928927883,4780,0.5266724328850741
38,AJOY GHORA,GEN,BASIRHAT,4489,7,IND,0,M,WEST BENGAL,907585,906003,1582,1107129,578151,528978,0.4054631393450989,4489,0.4946093203391418
61,SANAT KUMAR MANDAL,SC,JOYNAGAR (SC),449706,3,RSP,337,M,WEST BENGAL,806334,805899,435,1136859,579957,556902,39.58652744095794,450043,55.81347183673267
61,ASIT BARAN THAKUR,SC,JOYNAGAR (SC),219442,1,BJP,80,M,WEST BENGAL,806334,805899,435,1136859,579957,556902,19.309518594654218,219522,27.22469845002195
48,TARUN KANTI NASKAR,SC,JOYNAGAR (SC),90787,5,IND,11,M,WEST BENGAL,806334,805899,435,1136859,579957,556902,7.986742419244602,90798,11.2605942450647
49,SUKRITI RANJAN BISWAS,SC,JOYNAGAR (SC),21708,4,RPI,3,M,WEST BENGAL,806334,805899,435,1136859,579957,556902,1.9097355080973104,21711,2.692556682466571
41,SANAT KUMAR DHALI,SC,JOYNAGAR (SC),14339,6,IND,1,M,WEST BENGAL,806334,805899,435,1136859,579957,556902,1.2613701435270337,14340,1.778419364680145
46,MEGHNATH HALDER,SC,JOYNAGAR (SC),9917,2,BSP,3,M,WEST BENGAL,806334,805899,435,1136859,579957,556902,0.8725796250898308,9920,1.2302594210339637
68,BASUDEB BARMAN,SC,MATHURAPUR (SC),438939,2,CPM,1923,M,WEST BENGAL,907785,904420,3365,1113351,566256,547095,39.59775488592546,440862,48.56458302351327
71,RADHIKA RANJAN PRAMANIK,SC,MATHURAPUR (SC),357552,4,AITC,1282,M,WEST BENGAL,907785,904420,3365,1113351,566256,547095,32.230087366877115,358834,39.52852272289144
60,MONORANJAN HALDAR,SC,MATHURAPUR (SC),71548,3,INC,152,M,WEST BENGAL,907785,904420,3365,1113351,566256,547095,6.440017568583492,71700,7.898345973991638
59,PRAHLAD KUMAR PURKAIT,SC,MATHURAPUR (SC),16014,5,IND,7,M,WEST BENGAL,907785,904420,3365,1113351,566256,547095,1.4389891417890674,16021,1.7648452001299868
36,KANSARI MONDAL,SC,MATHURAPUR (SC),12601,1,BSP,0,M,WEST BENGAL,907785,904420,3365,1113351,566256,547095,1.1318083874716958,12601,1.388104011412394
39,MIHIR KUMAR NASKAR,SC,MATHURAPUR (SC),7766,6,IND,1,M,WEST BENGAL,907785,904420,3365,1113351,566256,547095,0.6976236604628729,7767,0.85559906806127
37,SAMIK LAHIRI,GEN,DIAMOND HARBOUR,429399,3,CPM,1491,M,WEST BENGAL,836540,834504,2036,1102946,586900,516046,39.06718914615947,430890,51.508594926721976
56,SAUGATA ROY,GEN,DIAMOND HARBOUR,276614,4,AITC,492,M,WEST BENGAL,836540,834504,2036,1102946,586900,516046,25.124167456974323,277106,33.12525402252134
64,DAULAT ALI SHEIKH,GEN,DIAMOND HARBOUR,92807,1,INC,52,M,WEST BENGAL,836540,834504,2036,1102946,586900,516046,8.419179180123052,92859,11.100365792430726
34,SEKH NASIR UDDIN,GEN,DIAMOND HARBOUR,8427,12,IND,0,M,WEST BENGAL,836540,834504,2036,1102946,586900,516046,0.7640446585780265,8427,1.007363664618548
55,ABDUR RAUF BAIDYA,GEN,DIAMOND HARBOUR,5559,9,IND,0,M,WEST BENGAL,836540,834504,2036,1102946,586900,516046,0.5040137957796665,5559,0.664522915819925
46,ZAMEERUL HASAN,GEN,DIAMOND HARBOUR,4455,5,INL,0,M,WEST BENGAL,836540,834504,2036,1102946,586900,516046,0.4039182335309254,4455,0.5325507447342626
47,MAINUDDIN CHISTY,GEN,DIAMOND HARBOUR,4001,11,IND,0,M,WEST BENGAL,836540,834504,2036,1102946,586900,516046,0.3627557468815336,4001,0.4782795801754848
66,DR DHIREN MONDAL,SC,DIAMOND HARBOUR,3663,2,BSP,1,M,WEST BENGAL,836540,834504,2036,1102946,586900,516046,0.33220121384002477,3664,0.4379945967915461
54,BECHU MONDAL,GEN,DIAMOND HARBOUR,3411,10,IND,0,M,WEST BENGAL,836540,834504,2036,1102946,586900,516046,0.30926264749135496,3411,0.40775097425108187
50,MALA BANERJEE,GEN,DIAMOND HARBOUR,2592,6,JUM,0,F,WEST BENGAL,836540,834504,2036,1102946,586900,516046,0.23500697223617475,2592,0.3098477060272073
36,SEKH NAZRUL ISLAM,GEN,DIAMOND HARBOUR,2139,7,SP,0,M,WEST BENGAL,836540,834504,2036,1102946,586900,516046,0.19393515185693588,2139,0.25569608147847084
38,AMIT SUNDAR PURKAIT,GEN,DIAMOND HARBOUR,1437,8,IND,0,M,WEST BENGAL,836540,834504,2036,1102946,586900,516046,0.13028743020963857,1437,0.17177899442943553
44,SUJAN CHAKRABORTY,GEN,JADAVPUR,502914,4,CPM,2482,M,WEST BENGAL,1022315,1018998,3317,1354946,715799,639147,37.300084283801716,505396,49.43642615045265
72,KRISHNA BOSE,GEN,JADAVPUR,414933,3,AITC,795,F,WEST BENGAL,1022315,1018998,3317,1354946,715799,639147,30.682255971824706,415728,40.66535265549268
43,PROF OMPRAKASH MISHRA,GEN,JADAVPUR,66096,2,INC,25,M,WEST BENGAL,1022315,1018998,3317,1354946,715799,639147,4.879973076417805,66121,6.467771675070795
48,BANASREE CHAKRABORTY,GEN,JADAVPUR,10280,11,IND,6,F,WEST BENGAL,1022315,1018998,3317,1354946,715799,639147,0.7591446448788365,10286,1.0061478115844922
62,ARABINDU HALDER,SC,JADAVPUR,6868,1,BSP,7,M,WEST BENGAL,1022315,1018998,3317,1354946,715799,639147,0.5074002949195023,6875,0.6724933117483358
33,ANISUR RAHMAN,GEN,JADAVPUR,6372,5,INL,2,M,WEST BENGAL,1022315,1018998,3317,1354946,715799,639147,0.47042465160973207,6374,0.6234868900485663
27,TAPAS KUMAR HOWLADER,SC,JADAVPUR,3235,9,IND,0,M,WEST BENGAL,1022315,1018998,3317,1354946,715799,639147,0.23875490240939493,3235,0.3164386710553988
31,TAPAN SARKAR,SC,JADAVPUR,2603,8,IND,0,M,WEST BENGAL,1022315,1018998,3317,1354946,715799,639147,0.19211097711643121,2603,0.25461819497904264
31,BADAN BAIRAGI,SC,JADAVPUR,2320,10,IND,0,M,WEST BENGAL,1022315,1018998,3317,1354946,715799,639147,0.17122453588556297,2320,0.22693592483725664
39,ARUP GHOSH,GEN,JADAVPUR,1710,6,IND,0,M,WEST BENGAL,1022315,1018998,3317,1354946,715799,639147,0.12620429153634166,1710,0.16726742735849517
39,JIT NARAYAN SINGH,GEN,JADAVPUR,1667,7,IND,0,M,WEST BENGAL,1022315,1018998,3317,1354946,715799,639147,0.12303073332811787,1667,0.1630612873722874
62,TARIT BARAN TOPDAR,GEN,BARRACKPORE,441243,3,CPM,1805,M,WEST BENGAL,794426,792214,2212,981008,543689,437319,45.16252670722359,443048,55.76957451040122
42,ARJUN SINGH,GEN,BARRACKPORE,277643,1,AITC,334,M,WEST BENGAL,794426,792214,2212,981008,543689,437319,28.335854549606122,277977,34.9909242648151
69,DEBI GHOSAL,GEN,BARRACKPORE,43687,4,INC,63,M,WEST BENGAL,794426,792214,2212,981008,543689,437319,4.4596985957301065,43750,5.5071208646242695
48,SUBRATA BISWAS,GEN,BARRACKPORE,9072,12,IND,0,M,WEST BENGAL,794426,792214,2212,981008,543689,437319,0.9247631008105948,9072,1.1419565824884885
49,CHAPALA MAJUMDER,SC,BARRACKPORE,6467,2,BSP,6,F,WEST BENGAL,794426,792214,2212,981008,543689,437319,0.6598315202322509,6473,0.8148021338677234
39,TARKESHWAR SINGH,GEN,BARRACKPORE,3920,10,IND,0,M,WEST BENGAL,794426,792214,2212,981008,543689,437319,0.3995889941774175,3920,0.49343802947033455
47,AMAL KUMAR SEN,GEN,BARRACKPORE,3068,5,IND,3,M,WEST BENGAL,794426,792214,2212,981008,543689,437319,0.3130453574282778,3071,0.3865684154345402
35,DINESH KUMAR SHARMA,SC,BARRACKPORE,1927,11,IND,0,M,WEST BENGAL,794426,792214,2212,981008,543689,437319,0.19643061014792948,1927,0.24256507214013642
50,ARJUN PRASAD SINGH,GEN,BARRACKPORE,1874,6,IND,1,M,WEST BENGAL,794426,792214,2212,981008,543689,437319,0.19112993981700455,1875,0.2360194656267544
46,TAPAN SINHA,GEN,BARRACKPORE,1466,9,IND,0,M,WEST BENGAL,794426,792214,2212,981008,543689,437319,0.14943812894492195,1466,0.1845357528580384
36,ARJUN BAG,SC,BARRACKPORE,947,7,IND,0,M,WEST BENGAL,794426,792214,2212,981008,543689,437319,0.0965333616035751,947,0.11920556477255276
42,GANESH DAS,GEN,BARRACKPORE,900,8,IND,0,M,WEST BENGAL,794426,792214,2212,981008,543689,437319,0.09174237111216219,900,0.11328934350084213
61,AMITAVA NANDY,GEN,DUM DUM,616692,1,CPM,2633,M,WEST BENGAL,1248360,1245065,3295,1543705,816225,727480,40.11938809552343,619325,49.61108974975168
61,TAPAN SIKDAR,GEN,DUM DUM,520476,3,BJP,597,M,WEST BENGAL,1248360,1245065,3295,1543705,816225,727480,33.754700541878144,521073,41.74060367201769
41,TAPAS MAJUMDER,GEN,DUM DUM,76806,4,INC,48,M,WEST BENGAL,1248360,1245065,3295,1543705,816225,727480,4.9785418846217375,76854,6.15639719311737
28,SUBHANKAR NAG,GEN,DUM DUM,10349,8,IND,3,M,WEST BENGAL,1248360,1245065,3295,1543705,816225,727480,0.670594446477792,10352,0.8292479733410234
34,GOUTAM DAS,GEN,DUM DUM,9871,2,BSP,11,M,WEST BENGAL,1248360,1245065,3295,1543705,816225,727480,0.6401482148467486,9882,0.7915985773334615
42,KRISHNENDU GOSWAMI,GEN,DUM DUM,4358,5,SP,0,M,WEST BENGAL,1248360,1245065,3295,1543705,816225,727480,0.28230782435763313,4358,0.3490980165977763
51,AHINDRA BASU,GEN,DUM DUM,3704,7,IND,0,M,WEST BENGAL,1248360,1245065,3295,1543705,816225,727480,0.23994221693911724,3704,0.2967092825787433
44,ADHIKARY BINOY,SC,DUM DUM,2809,6,IND,3,M,WEST BENGAL,1248360,1245065,3295,1543705,816225,727480,0.18215915605637087,2812,0.2252555352622641
57,SUDHANGSHU SEAL,GEN,CALCUTTA NORTH WEST,151481,3,CPM,291,M,WEST BENGAL,360117,359642,475,609204,376542,232662,24.91316537645846,151772,42.14519170158587
56,SUBRATA MUKHERJEE,GEN,CALCUTTA NORTH WEST,108658,2,AITC,110,M,WEST BENGAL,360117,359642,475,609204,376542,232662,17.854117832450214,108768,30.203517190246504
52,BANDYOPADHYAY SUDIP,GEN,CALCUTTA NORTH WEST,81906,5,IND,46,M,WEST BENGAL,360117,359642,475,609204,376542,232662,13.452308257989113,81952,22.757048403713238
46,SUDIP BANDYOPADHYAY,GEN,CALCUTTA NORTH WEST,3426,13,IND,24,M,WEST BENGAL,360117,359642,475,609204,376542,232662,0.5663127622274312,3450,0.9580219761910712
63,"PROF VIJAY K ARORA ""SAMYAK""",GEN,CALCUTTA NORTH WEST,2664,14,IND,2,M,WEST BENGAL,360117,359642,475,609204,376542,232662,0.43762023886908163,2666,0.7403149531957669
50,SUDHIR KR BISHRAM,SC,CALCUTTA NORTH WEST,2199,12,IND,2,M,WEST BENGAL,360117,359642,475,609204,376542,232662,0.36129112743842784,2201,0.6111902520569703
35,ASHIM DAS,SC,CALCUTTA NORTH WEST,2172,4,IND,0,M,WEST BENGAL,360117,359642,475,609204,376542,232662,0.35653081726318275,2172,0.6031373137063788
41,RIZWAN AHMAD SIDDIQUI,GEN,CALCUTTA NORTH WEST,2127,1,BSP,0,M,WEST BENGAL,360117,359642,475,609204,376542,232662,0.34914412906021625,2127,0.5906413748864952
49,SUBRATA BANERJEE,GEN,CALCUTTA NORTH WEST,1185,11,IND,0,M,WEST BENGAL,360117,359642,475,609204,376542,232662,0.19451612267811766,1185,0.32905972225693314
57,BIPLAB MUKHERJEE,GEN,CALCUTTA NORTH WEST,1079,6,IND,0,M,WEST BENGAL,360117,359642,475,609204,376542,232662,0.17711636824446325,1079,0.29962484414787416
42,PANDEY RAMENDRA,GEN,CALCUTTA NORTH WEST,969,10,IND,0,M,WEST BENGAL,360117,359642,475,609204,376542,232662,0.1590600193038785,969,0.26907921592149214
28,GOPAL CH SAHA,SC,CALCUTTA NORTH WEST,697,7,IND,0,M,WEST BENGAL,360117,359642,475,609204,376542,232662,0.11441159283261436,697,0.19354820794352945
63,LOK NATH SARAFF,GEN,CALCUTTA NORTH WEST,640,9,IND,0,M,WEST BENGAL,360117,359642,475,609204,376542,232662,0.10505512110885681,640,0.17772001877167698
40,KAMALESH OJHA,GEN,CALCUTTA NORTH WEST,439,8,IND,0,M,WEST BENGAL,360117,359642,475,609204,376542,232662,0.07206124713560647,439,0.12190482537619718
46,MD SALIM,GEN,CALCUTTA NORTH EAST,283700,4,CPM,727,M,WEST BENGAL,568885,567774,1111,803853,463604,340249,35.38296181018171,284427,49.99727537199961
67,"AJIT KUMAR PANJA (250, CHITTARANJAN",GEN,CALCUTTA NORTH EAST,210318,1,AITC,329,M,WEST BENGAL,568885,567774,1111,803853,463604,340249,26.204666773651404,210647,37.02804609015882
45,INDIRA MUKHERJEE ( MOUSHUMI,GEN,CALCUTTA NORTH EAST,56397,3,INC,52,F,WEST BENGAL,568885,567774,1111,803853,463604,340249,7.022303829182699,56449,9.922743612505164
47,"AJIT KUMAR PANJA ( MAMUDPUR, P S-",GEN,CALCUTTA NORTH EAST,4791,5,IND,1,M,WEST BENGAL,568885,567774,1111,803853,463604,340249,0.5961288942132454,4792,0.8423495082485916
30,PINTU KUNDU,GEN,CALCUTTA NORTH EAST,4180,10,IND,0,M,WEST BENGAL,568885,567774,1111,803853,463604,340249,0.519995571329584,4180,0.7347706478462255
39,DEBOJYOTI BASU,GEN,CALCUTTA NORTH EAST,2625,7,IND,1,M,WEST BENGAL,568885,567774,1111,803853,463604,340249,0.3266766436151884,2626,0.461604718001002
47,CHANDRA PRAKASH DUBEY,GEN,CALCUTTA NORTH EAST,2226,2,BSP,0,M,WEST BENGAL,568885,567774,1111,803853,463604,340249,0.2769163018611612,2226,0.3912917373458608
39,MAHUA ROY,GEN,CALCUTTA NORTH EAST,1311,9,IND,0,F,WEST BENGAL,568885,567774,1111,803853,463604,340249,0.16308952009882405,1311,0.23045079409722527
27,ANGSHUMAN PAUL,GEN,CALCUTTA NORTH EAST,1308,6,IND,1,M,WEST BENGAL,568885,567774,1111,803853,463604,340249,0.1628407183900539,1309,0.23009922919394957
59,IMTIAZ AHMED,GEN,CALCUTTA NORTH EAST,918,8,IND,0,M,WEST BENGAL,568885,567774,1111,803853,463604,340249,0.11419998432549235,918,0.16136829060354904
48,MAMATA BANERJEE,GEN,CALCUTTA SOUTH,392964,3,AITC,597,F,WEST BENGAL,772742,770766,1976,1096709,593299,503410,35.88563602560023,393561,50.93045285489853
55,RABIN DEB,GEN,CALCUTTA SOUTH,293787,4,CPM,1345,M,WEST BENGAL,772742,770766,1976,1096709,593299,503410,26.91069372094147,295132,38.19282503086412
46,NAFISA ALI,GEN,CALCUTTA SOUTH,60347,2,INC,30,F,WEST BENGAL,772742,770766,1976,1096709,593299,503410,5.505289005561184,60377,7.813345204479632
64,SUJIT KUMAR ROY,GEN,CALCUTTA SOUTH,4782,11,IND,0,M,WEST BENGAL,772742,770766,1976,1096709,593299,503410,0.4360318005961472,4782,0.6188352645514286
77,KUSHA RAM,SC,CALCUTTA SOUTH,4429,1,BSP,2,M,WEST BENGAL,772742,770766,1976,1096709,593299,503410,0.4040269570141214,4431,0.5734126008421958
46,BANDANA DAS,GEN,CALCUTTA SOUTH,4129,5,IND,1,F,WEST BENGAL,772742,770766,1976,1096709,593299,503410,0.3765812079594496,4130,0.5344604020488081
44,MUKUL PAUL,GEN,CALCUTTA SOUTH,2524,8,IND,0,M,WEST BENGAL,772742,770766,1976,1096709,593299,503410,0.23014309174083553,2524,0.32662906895186233
46,RANJIT BANERJEE,GEN,CALCUTTA SOUTH,2306,9,IND,0,M,WEST BENGAL,772742,770766,1976,1096709,593299,503410,0.21026543960157162,2306,0.2984178419187775
31,BARNALI MUKHERJEE,GEN,CALCUTTA SOUTH,2257,6,IND,1,F,WEST BENGAL,772742,770766,1976,1096709,593299,503410,0.2058887088553117,2258,0.29220619559956623
27,SANTU MUKHERJEE,GEN,CALCUTTA SOUTH,1708,10,IND,0,F,WEST BENGAL,772742,770766,1976,1096709,593299,503410,0.15573866905441644,1708,0.22103108152526973
61,BHUSAN MONDAL,SC,CALCUTTA SOUTH,1533,7,IND,0,M,WEST BENGAL,772742,770766,1976,1096709,593299,503410,0.13978183820867707,1533,0.19838445431981178
61,SWADESH CHAKRABORTTY,GEN,HOWRAH,487633,4,CPM,1811,M,WEST BENGAL,911632,909246,2386,1240427,686588,553839,39.45770287167242,489444,53.688769152465035
65,DR BIKRAM SARKAR,SC,HOWRAH,242071,1,AITC,436,M,WEST BENGAL,911632,909246,2386,1240427,686588,553839,19.550283894175152,242507,26.60141372834652
60,SULTAN SINGH,GEN,HOWRAH,151967,3,INC,133,M,WEST BENGAL,911632,909246,2386,1240427,686588,553839,12.261906585393579,152100,16.68436386612142
30,MANTU DAS,SC,HOWRAH,5788,14,IND,0,M,WEST BENGAL,911632,909246,2386,1240427,686588,553839,0.4666135129274033,5788,0.6349053126700248
27,ANUP DEY,GEN,HOWRAH,4013,5,JD(S),0,M,WEST BENGAL,911632,909246,2386,1240427,686588,553839,0.32351762739766227,4013,0.44019955420608314
65,PRASADI RAM,SC,HOWRAH,2927,11,IND,0,M,WEST BENGAL,911632,909246,2386,1240427,686588,553839,0.23596713067355032,2927,0.3210725380416659
44,RABINDRA KUMAR JAISWAL,GEN,HOWRAH,2861,2,BSP,3,M,WEST BENGAL,911632,909246,2386,1240427,686588,553839,0.23088823445474826,2864,0.3141618547835091
42,MONORANJAN POLLEY,SC,HOWRAH,2445,13,IND,0,M,WEST BENGAL,911632,909246,2386,1240427,686588,553839,0.19710954372969955,2445,0.2682003264475139
32,BIMAL MONDAL,SC,HOWRAH,2313,12,IND,0,M,WEST BENGAL,911632,909246,2386,1240427,686588,553839,0.18646804689030472,2313,0.25372079962089966
52,ALOKE GHOSH,GEN,HOWRAH,2012,6,IND,1,M,WEST BENGAL,911632,909246,2386,1240427,686588,553839,0.16228282680077102,2013,0.22081278410586727
45,PANCHU GOPAL BAGANI,SC,HOWRAH,1770,10,IND,1,M,WEST BENGAL,911632,909246,2386,1240427,686588,553839,0.1427734159285472,1771,0.19426698492374117
45,GOUTAM MONDAL,GEN,HOWRAH,1521,8,IND,0,M,WEST BENGAL,911632,909246,2386,1240427,686588,553839,0.12261906585393578,1521,0.16684363866121418
33,GAUTAM SAHA,SC,HOWRAH,1262,9,IND,1,M,WEST BENGAL,911632,909246,2386,1240427,686588,553839,0.1018197765769368,1263,0.13854274531828634
58,GOPAL CHANDRA MODI,ST,HOWRAH,663,7,IND,0,M,WEST BENGAL,911632,909246,2386,1240427,686588,553839,0.053449336397869446,663,0.07272671428822156
58,HANNAN MOLLAH,GEN,ULUBERIA,422818,4,CPM,1931,M,WEST BENGAL,851546,849086,2460,1129673,583133,546540,37.59928758145056,424749,49.879748128697685
36,RAJIB BANERJEE,GEN,ULUBERIA,272248,2,AITC,386,M,WEST BENGAL,851546,849086,2460,1129673,583133,546540,24.133886531766272,272634,32.0163561334326
67,KAZI ABDUL RAJJAK,GEN,ULUBERIA,124183,1,INC,143,M,WEST BENGAL,851546,849086,2460,1129673,583133,546540,11.005485658239154,124326,14.600033351104932
35,SNEHANSHU MAITY,SC,ULUBERIA,8785,8,IND,0,M,WEST BENGAL,851546,849086,2460,1129673,583133,546540,0.7776586675967293,8785,1.031653016983228
40,DILIP KUMAR HAIT,SC,ULUBERIA,6687,5,IND,0,M,WEST BENGAL,851546,849086,2460,1129673,583133,546540,0.591941207765433,6687,0.7852776009751675
49,SANDHYA MANDAL,SC,ULUBERIA,6677,3,BSP,0,F,WEST BENGAL,851546,849086,2460,1129673,583133,546540,0.5910559958501266,6677,0.7841032662944808
54,BHARAT CHANDRA MANNA,SC,ULUBERIA,4030,7,IND,0,M,WEST BENGAL,851546,849086,2460,1129673,583133,546540,0.3567404018685053,4030,0.47325687631672275
68,BAIDYA NATH CHOWDHURY,SC,ULUBERIA,3658,6,IND,0,M,WEST BENGAL,851546,849086,2460,1129673,583133,546540,0.3238105186191048,3658,0.4295716261951792
64,SANTASRI CHATTERJEE,GEN,SERAMPORE,401765,3,CPM,2317,M,WEST BENGAL,946248,942891,3357,1285398,675969,609429,31.43633333800115,404082,42.70360412915007
47,AKBAR ALI KHANDOKER,GEN,SERAMPORE,383535,1,AITC,860,M,WEST BENGAL,946248,942891,3357,1285398,675969,609429,29.90474545627113,384395,40.623071330137556
58,KESTO MUKHERJEE,GEN,SERAMPORE,124851,2,INC,169,M,WEST BENGAL,946248,942891,3357,1285398,675969,609429,9.72617041570004,125020,13.212181161809589
33,SUKUMAR MALIK,SC,SERAMPORE,9806,10,IND,2,M,WEST BENGAL,946248,942891,3357,1285398,675969,609429,0.7630321503534314,9808,1.036514740321776
47,SABITRI DAS,SC,SERAMPORE,6370,4,BSP,2,F,WEST BENGAL,946248,942891,3357,1285398,675969,609429,0.49572194759910937,6372,0.6733964034798489
61,DILIP BHATTACHARYA,GEN,SERAMPORE,5394,8,IND,6,M,WEST BENGAL,946248,942891,3357,1285398,675969,609429,0.42010334542297406,5400,0.5706749182032617
38,AVASH MUNSHI,GEN,SERAMPORE,3664,7,IND,0,M,WEST BENGAL,946248,942891,3357,1285398,675969,609429,0.2850478995610698,3664,0.38721350005495386
57,BIDYUT RAUT,GEN,SERAMPORE,3021,9,IND,0,M,WEST BENGAL,946248,942891,3357,1285398,675969,609429,0.2350244826894083,3021,0.31926091257260253
44,INDRADEO RAY,GEN,SERAMPORE,2845,5,SP,0,M,WEST BENGAL,946248,942891,3357,1285398,675969,609429,0.22133222550525206,2845,0.30066113746079254
33,SURESH NAYAK,GEN,SERAMPORE,1640,6,JD(S),1,M,WEST BENGAL,946248,942891,3357,1285398,675969,609429,0.12766473885909266,1641,0.17342176680954674
56,RUPCHAND PAL,GEN,HOOGHLY,492968,4,CPM,3922,M,WEST BENGAL,924919,919683,5236,1161683,598487,563196,42.77328668836507,496890,53.722542190180974
50,INDRANI MUKHERJEE,GEN,HOOGHLY,328708,2,AITC,1216,F,WEST BENGAL,924919,919683,5236,1161683,598487,563196,28.400518902316723,329924,35.67058304565048
56,ASOK KUMAR DAS,GEN,HOOGHLY,70083,1,INC,90,M,WEST BENGAL,924919,919683,5236,1161683,598487,563196,6.040632427262859,70173,7.586934639681961
51,KESHAB CHANDRA SOREN,ST,HOOGHLY,16927,5,JDP,4,M,WEST BENGAL,924919,919683,5236,1161683,598487,563196,1.4574544002107286,16931,1.8305386741974163
62,MATILAL MANDAL,SC,HOOGHLY,10997,3,BSP,4,M,WEST BENGAL,924919,919683,5236,1161683,598487,563196,0.9469881198227056,11001,1.1894014502891606
59,ANIL BASU,GEN,ARAMBAGH,741335,1,CPM,3129,M,WEST BENGAL,964840,961186,3654,1187610,606634,580976,62.68589856939568,744464,77.15932175282948
52,SWAPAN KUMAR NANDI,GEN,ARAMBAGH,151569,3,BJP,393,M,WEST BENGAL,964840,961186,3654,1187610,606634,580976,12.795614722004697,151962,15.749968906761744
47,DATTA PRADIP,GEN,ARAMBAGH,68282,2,INC,132,M,WEST BENGAL,964840,961186,3654,1187610,606634,580976,5.760645329695776,68414,7.090709340408773
67,GURUDAS DASGUPTA,GEN,PANSKURA,538757,1,CPI,2756,M,WEST BENGAL,874554,871070,3484,1061186,535316,525870,51.029037322392114,541513,61.918760876972726
30,HEMA CHOUBEY,GEN,PANSKURA,261376,3,AITC,659,F,WEST BENGAL,874554,871070,3484,1061186,535316,525870,24.69265519899433,262035,29.962129268175552
55,NAZIM AHMED,GEN,PANSKURA,70937,2,INC,69,M,WEST BENGAL,874554,871070,3484,1061186,535316,525870,6.691192684411592,71006,8.11910985485173
54,SETH LAKSHMAN CHANDRA,SC,TAMLUK,504273,3,CPM,2955,M,WEST BENGAL,1035269,1030848,4421,1185781,609418,576363,42.77585827399832,507228,48.99480231707894
34,ADHIKARI SUVENDU,GEN,TAMLUK,448441,2,AITC,1407,M,WEST BENGAL,1035269,1030848,4421,1185781,609418,576363,37.936853432463494,449848,43.45228148432919
55,SUDARSAN PANJA,GEN,TAMLUK,34752,4,INC,42,M,WEST BENGAL,1035269,1030848,4421,1185781,609418,576363,2.934268638138071,34794,3.3608656300922752
73,AJIT DAS,SC,TAMLUK,14087,1,BSP,0,M,WEST BENGAL,1035269,1030848,4421,1185781,609418,576363,1.187993398443726,14087,1.3607091490231042
56,MANAB BERA,GEN,TAMLUK,13323,7,IND,16,M,WEST BENGAL,1035269,1030848,4421,1185781,609418,576363,1.1249126103386713,13339,1.2884573960970531
45,HOSSAIN MAHMUD SHAIKH,GEN,TAMLUK,6239,8,IND,0,M,WEST BENGAL,1035269,1030848,4421,1185781,609418,576363,0.5261511189671617,6239,0.6026453028150172
44,TRILOCHAN KUILA,GEN,TAMLUK,6082,5,SP,0,M,WEST BENGAL,1035269,1030848,4421,1185781,609418,576363,0.5129109000734537,6082,0.5874801621607524
40,BHAKTI ADHIKARY,GEN,TAMLUK,3651,6,IND,1,M,WEST BENGAL,1035269,1030848,4421,1185781,609418,576363,0.3079826713364441,3652,0.35275855840366127
63,PRASANTA PRADHAN,GEN,CONTAI,461623,4,CPM,3120,M,WEST BENGAL,926774,921643,5131,1081102,551761,529341,42.98789568421851,464743,50.146313988092025
68,NITISH SENGUPTA,GEN,CONTAI,403604,3,AITC,1949,M,WEST BENGAL,926774,921643,5131,1081102,551761,529341,37.512926624869806,405553,43.75964366717236
59,KSHITINDRA MOHAN SAHOO,GEN,CONTAI,25963,2,INC,47,M,WEST BENGAL,926774,921643,5131,1081102,551761,529341,2.405878446252065,26010,2.806509461853699
48,JIBAN DAS,GEN,CONTAI,11694,6,IND,13,M,WEST BENGAL,926774,921643,5131,1081102,551761,529341,1.0828765463388283,11707,1.2631990107620628
58,ADHAR CHANDRA NAHAL,GEN,CONTAI,9676,5,IND,0,M,WEST BENGAL,926774,921643,5131,1081102,551761,529341,0.8950126815046129,9676,1.0440517321375007
63,ASALATA MAJUMDAR,SC,CONTAI,9083,1,BSP,2,F,WEST BENGAL,926774,921643,5131,1081102,551761,529341,0.8403462393002695,9085,0.9802821399823475
58,PRABODH PANDA,GEN,MIDNAPORE,477478,2,CPI,2556,M,WEST BENGAL,908499,904948,3551,1152887,586858,566029,41.6375585811966,480034,52.83814291485186
39,RAHUL ( BISWAJIT) SINHA,GEN,MIDNAPORE,318394,4,BJP,880,M,WEST BENGAL,908499,904948,3551,1152887,586858,566029,27.69343396187137,319274,35.14302162137768
41,NARAYAN CHANDRA PARIA,GEN,MIDNAPORE,68240,1,INC,98,M,WEST BENGAL,908499,904948,3551,1152887,586858,566029,5.927554044758939,68338,7.522077624741469
54,PANCHANAN PRADHAN,GEN,MIDNAPORE,10230,7,IND,13,M,WEST BENGAL,908499,904948,3551,1152887,586858,566029,0.8884652181870383,10243,1.1274640918702168
50,MADHUMANTI SENGUPTA,GEN,MIDNAPORE,9898,3,NCP,3,F,WEST BENGAL,908499,904948,3551,1152887,586858,566029,0.8588005589446321,9901,1.089819581529534
39,MRITUNJOY CHAKRABORTY,GEN,MIDNAPORE,9440,8,IND,0,M,WEST BENGAL,908499,904948,3551,1152887,586858,566029,0.8188139861061838,9440,1.0390765427369761
27,ASIT KUMAR KHATUA,GEN,MIDNAPORE,7248,5,JKP(N),1,M,WEST BENGAL,908499,904948,3551,1152887,586858,566029,0.6287693416614117,7249,0.7979095188877479
34,LALIT KUMAR JAISWAL,GEN,MIDNAPORE,4020,6,SHS,0,M,WEST BENGAL,908499,904948,3551,1152887,586858,566029,0.3486898542528452,4020,0.4424881040045173
56,RUPCHAND MURMU,ST,JHARGRAM (ST),506706,2,CPM,2339,M,WEST BENGAL,795312,792563,2749,1029496,520137,509359,49.44603961550118,509045,64.00569839258053
69,NITYANANDA HEMBRAM,ST,JHARGRAM (ST),157392,1,AITC,310,M,WEST BENGAL,795312,792563,2749,1029496,520137,509359,15.318369376860133,157702,19.82894763313014
56,KHAGENDRA NATH HEMBROM,ST,JHARGRAM (ST),57581,3,JKP(N),69,M,WEST BENGAL,795312,792563,2749,1029496,520137,509359,5.5998274884020915,57650,7.24872754340435
26,MONGAL SOREN,ST,JHARGRAM (ST),37912,4,JMM,9,M,WEST BENGAL,795312,792563,2749,1029496,520137,509359,3.6834528740276795,37921,4.768065865974611
42,SURJA MANDI,ST,JHARGRAM (ST),13330,7,IND,8,M,WEST BENGAL,795312,792563,2749,1029496,520137,509359,1.2955854126679462,13338,1.6770776751765346
31,MASANG HEMRAM,ST,JHARGRAM (ST),10220,5,IND,3,M,WEST BENGAL,795312,792563,2749,1029496,520137,509359,0.9930101719676424,10223,1.2854074878789707
55,LEBA CHAND TUDU,ST,JHARGRAM (ST),9422,6,IND,11,M,WEST BENGAL,795312,792563,2749,1029496,520137,509359,0.916273594069331,9433,1.1860754018548696
57,BIR SINGH MAHATO,GEN,PURULIA,339612,2,AIFB,1445,M,WEST BENGAL,696219,694449,1770,992438,504207,488231,34.365572458934466,341057,48.987028506834775
51,SHANTIRAM MAHATO,GEN,PURULIA,195098,4,INC,241,M,WEST BENGAL,696219,694449,1770,992438,504207,488231,19.68274088658435,195339,28.057119957944266
39,NIYATI MAHATO,GEN,PURULIA,105059,1,AITC,68,F,WEST BENGAL,696219,694449,1770,992438,504207,488231,10.592802774581385,105127,15.099702823393212
48,MIHIR KUMAR RAJWAR,SC,PURULIA,14018,3,BSP,3,M,WEST BENGAL,696219,694449,1770,992438,504207,488231,1.4127834685894736,14021,2.013877817181088
54,PRANATI BHATTACHARYA,GEN,PURULIA,13015,11,IND,5,F,WEST BENGAL,696219,694449,1770,992438,504207,488231,1.3119207446712036,13020,1.8701012181511851
49,AJOY KUMAR TUDU,ST,PURULIA,8760,5,JDP,2,M,WEST BENGAL,696219,694449,1770,992438,504207,488231,0.8828763106612202,8762,1.2585120486513584
65,NILKAMAL MAHATO,GEN,PURULIA,5695,10,IND,4,M,WEST BENGAL,696219,694449,1770,992438,504207,488231,0.5742424211890315,5699,0.8185642735978191
60,GOMASTA PRASAD SOREN,ST,PURULIA,3663,7,JKP,1,M,WEST BENGAL,696219,694449,1770,992438,504207,488231,0.3691918286079332,3664,0.5262711876579065
45,THAKUR DAS KISKU,ST,PURULIA,3536,8,AMB,0,M,WEST BENGAL,696219,694449,1770,992438,504207,488231,0.35629429747752506,3536,0.5078861680017351
38,ANIL KUMAR CHOUDHURY,GEN,PURULIA,3110,6,JD(U),1,M,WEST BENGAL,696219,694449,1770,992438,504207,488231,0.3134704636460917,3111,0.4468421574246035
46,DHIREN CHANDRA RAJAK,SC,PURULIA,2883,9,JKP(N),0,M,WEST BENGAL,696219,694449,1770,992438,504207,488231,0.29049673632005224,2883,0.41409384116204817
62,ACHARIA BASUDEB,GEN,BANKURA,414639,1,CPM,3159,M,WEST BENGAL,695487,691813,3674,1020046,527499,492547,40.95874107638283,417798,60.07272601788387
55,DEB PRASAD KUNDU ( TARA),GEN,BANKURA,187007,2,AITC,462,M,WEST BENGAL,695487,691813,3674,1020046,527499,492547,18.37848489185782,187469,26.95506889417056
67,BHASKAR CHANDRA BHADRA,GEN,BANKURA,23533,9,IND,20,M,WEST BENGAL,695487,691813,3674,1020046,527499,492547,2.309013515076771,23553,3.38654784345358
57,NATABAR BAGDI,SC,BANKURA,21295,6,PDS,11,M,WEST BENGAL,695487,691813,3674,1020046,527499,492547,2.0887293318144478,21306,3.063464881442788
33,BALARAM MAHATO,GEN,BANKURA,18505,7,JMM,3,M,WEST BENGAL,695487,691813,3674,1020046,527499,492547,1.814427976777518,18508,2.661156858431574
41,RAHUL SEN,GEN,BANKURA,8568,8,SP,0,M,WEST BENGAL,695487,691813,3674,1020046,527499,492547,0.8399621193554017,8568,1.2319425093495637
57,MOTILAL MURMU,ST,BANKURA,7883,3,BSP,9,M,WEST BENGAL,695487,691813,3674,1020046,527499,492547,0.773690598267137,7892,1.1347444308808072
36,ABHIRAM BESRA,ST,BANKURA,6403,4,JDP,8,M,WEST BENGAL,695487,691813,3674,1020046,527499,492547,0.6285010675989122,6411,0.9218001199159725
54,GOPINATH MANDI,ST,BANKURA,3980,5,AMB,2,M,WEST BENGAL,695487,691813,3674,1020046,527499,492547,0.39037455173590213,3982,0.5725484444712842
29,SUSMITA BAURI,SC,VISHNUPUR (SC),515705,4,CPM,2802,F,WEST BENGAL,806624,803231,3393,1052852,535866,516986,49.247852499686566,518507,64.28112726623557
35,JANARDAN SAHA,SC,VISHNUPUR (SC),186203,3,AITC,475,M,WEST BENGAL,806624,803231,3393,1052852,535866,516986,17.730697192007995,186678,23.1431249256159
38,ACHINTYA MAJHI,SC,VISHNUPUR (SC),61707,1,INC,86,M,WEST BENGAL,806624,803231,3393,1052852,535866,516986,5.869106009201673,61793,7.660694449954378
35,SRABAN MONDAL,SC,VISHNUPUR (SC),28991,5,IND,18,M,WEST BENGAL,806624,803231,3393,1052852,535866,516986,2.7552780447774237,29009,3.5963472448129488
40,AJOY BAURI,SC,VISHNUPUR (SC),10625,2,BSP,12,M,WEST BENGAL,806624,803231,3393,1052852,535866,516986,1.010303442459149,10637,1.3187061133812037
57,SUNIL KHAN,SC,DURGAPUR (SC),502964,4,CPM,2286,M,WEST BENGAL,847616,844777,2839,1150939,605273,545666,43.898938171354,505250,59.6083603896104
54,SHIB NARAYAN SAHA,SC,DURGAPUR (SC),227290,3,BJP,452,M,WEST BENGAL,847616,844777,2839,1150939,605273,545666,19.787495253875313,227742,26.86853480821504
49,DHIBAR SHOVA,SC,DURGAPUR (SC),72325,1,INC,94,F,WEST BENGAL,847616,844777,2839,1150939,605273,545666,6.2921666569644445,72419,8.543845326185442
58,UMAKANTA BHAKAT,SC,DURGAPUR (SC),15051,5,SJP(R),0,M,WEST BENGAL,847616,844777,2839,1150939,605273,545666,1.3077148311074696,15051,1.775686159770462
34,RABINDRANATH BOURI,SC,DURGAPUR (SC),12364,7,IND,0,M,WEST BENGAL,847616,844777,2839,1150939,605273,545666,1.074253283623198,12364,1.4586794019933556
49,BANSHI LOHAR,SC,DURGAPUR (SC),8777,6,IND,2,M,WEST BENGAL,847616,844777,2839,1150939,605273,545666,0.7627684872960253,8779,1.0357284430685594
47,MOHAN CH BOURI,SC,DURGAPUR (SC),6006,2,BSP,5,M,WEST BENGAL,847616,844777,2839,1150939,605273,545666,0.5222692080118929,6011,0.7091654711567502
69,BIKASH CHOWDHURY,GEN,ASANSOL,368755,3,CPM,1077,M,WEST BENGAL,725198,723795,1403,1092141,602894,489247,33.86302684360353,369832,50.9973827837363
46,GHATAK MOLOY,GEN,ASANSOL,245209,1,AITC,305,M,WEST BENGAL,725198,723795,1403,1092141,602894,489247,22.480064387290653,245514,33.854754149901126
50,TAPAS BANERJEE,GEN,ASANSOL,70847,2,INC,20,M,WEST BENGAL,725198,723795,1403,1092141,602894,489247,6.488814173261511,70867,9.772089829260423
69,SUNIL MUKHERJEE,GEN,ASANSOL,12552,8,IND,0,M,WEST BENGAL,725198,723795,1403,1092141,602894,489247,1.1493021505464953,12552,1.730837647097758
63,MANIK LAL BAURI,SC,ASANSOL,8830,4,BSP,0,M,WEST BENGAL,725198,723795,1403,1092141,602894,489247,0.8085036639042028,8830,1.2175985041326645
44,PRATAP SINGH,GEN,ASANSOL,6828,6,SP,0,M,WEST BENGAL,725198,723795,1403,1092141,602894,489247,0.6251939996758661,6828,0.9415359667290865
47,SAILENDRA NATH BHATTACHARYYA,GEN,ASANSOL,6286,7,IND,0,M,WEST BENGAL,725198,723795,1403,1092141,602894,489247,0.575566707961701,6286,0.8667977573021436
46,ATANU CHAKRAVARTY,GEN,ASANSOL,4488,5,CPI(ML)(L),1,M,WEST BENGAL,725198,723795,1403,1092141,602894,489247,0.4110275138466553,4489,0.6190033618404904
66,NIKHILANANDA SAR,GEN,BURDWAN,669547,4,CPM,3544,M,WEST BENGAL,997024,992928,4096,1221820,622341,599479,55.08921117676908,673091,67.51000978913247
55,ANINDYA GOPAL MITRA,GEN,BURDWAN,201355,1,BJP,385,M,WEST BENGAL,997024,992928,4096,1221820,622341,599479,16.511433762747377,201740,20.234217029880924
49,CHAMPAK GARAI,GEN,BURDWAN,88056,2,INC,161,M,WEST BENGAL,997024,992928,4096,1221820,622341,599479,7.220130624805618,88217,8.848031742465578
39,SHANTI MURMU,GEN,BURDWAN,21557,5,JDP,3,F,WEST BENGAL,997024,992928,4096,1221820,622341,599479,1.7645807074691853,21560,2.162435407773534
37,DINESH CHANDRA SIKDAR,SC,BURDWAN,12413,3,BSP,3,M,WEST BENGAL,997024,992928,4096,1221820,622341,599479,1.0161889640045179,12416,1.2453060307475046
72,MAHBOOB ZAHEDI,GEN,KATWA,492410,2,CPM,2306,M,WEST BENGAL,966263,962903,3360,1169525,600234,569291,42.30059212073278,494716,51.19889719465611
47,AHMED SULTAN,GEN,KATWA,350609,1,AITC,758,M,WEST BENGAL,966263,962903,3360,1169525,600234,569291,30.043564695068508,351367,36.36349523887389
52,SAIFUDDIN CHOUDHURY,GEN,KATWA,60418,6,PDS,275,M,WEST BENGAL,966263,962903,3360,1169525,600234,569291,5.189542763087578,60693,6.281209153201561
52,HOSSAIN AMJAD,GEN,KATWA,14685,12,IND,0,M,WEST BENGAL,966263,962903,3360,1169525,600234,569291,1.2556379726812168,14685,1.519772567096122
52,SUSIL SARKAR,SC,KATWA,10319,3,BSP,4,M,WEST BENGAL,966263,962903,3360,1169525,600234,569291,0.8826660396314743,10323,1.0683426768902462
46,SHYAMSUNDAR DAS,SC,KATWA,8854,11,IND,3,M,WEST BENGAL,966263,962903,3360,1169525,600234,569291,0.7573160043607448,8857,0.9166241489118386
44,SALIL DUTTA,GEN,KATWA,6287,5,CPI(ML)(L),3,M,WEST BENGAL,966263,962903,3360,1169525,600234,569291,0.5378251854385327,6290,0.6509614877109027
52,SWAPAN BHATTACHARYA,GEN,KATWA,5435,7,SHS,7,M,WEST BENGAL,966263,962903,3360,1169525,600234,569291,0.46531711592313113,5442,0.563200702086285
28,RINA MONDAL,SC,KATWA,3906,10,IND,1,F,WEST BENGAL,966263,962903,3360,1169525,600234,569291,0.33406724952437955,3907,0.40434126112662905
50,KAILASH SHARMA,GEN,KATWA,3539,4,SP,2,M,WEST BENGAL,966263,962903,3360,1169525,600234,569291,0.3027724931061756,3541,0.36646337487826813
46,MOHAMMAD ZAKARIA,GEN,KATWA,3361,9,IND,1,M,WEST BENGAL,966263,962903,3360,1169525,600234,569291,0.2874671340929009,3362,0.34793839772401514
33,BABLU CHANDRA DAS,GEN,KATWA,3080,8,IND,0,M,WEST BENGAL,966263,962903,3360,1169525,600234,569291,0.2633547807870717,3080,0.31875379684413047
74,CHATTERJEE SOMNATH,GEN,BOLPUR,502910,1,CPM,1926,M,WEST BENGAL,770059,767696,2363,1035012,525795,509217,48.77585960356015,504836,65.55809360062021
42,DR NIRMAL KUMAR MAJI,SC,BOLPUR,194158,3,AITC,373,M,WEST BENGAL,770059,767696,2363,1035012,525795,509217,18.79504778688556,194531,25.261830587006965
47,DHANANJOY GHOSH,GEN,BOLPUR,48700,2,INC,56,M,WEST BENGAL,770059,767696,2363,1035012,525795,509217,4.710670021217146,48756,6.331462913880624
56,BUDHEN SOREN,ST,BOLPUR,9859,6,IND,1,M,WEST BENGAL,770059,767696,2363,1035012,525795,509217,0.952645959660371,9860,1.2804213703105864
40,BHABOTOSH MANDAL,SC,BOLPUR,6558,4,BSP,3,M,WEST BENGAL,770059,767696,2363,1035012,525795,509217,0.6339056938470279,6561,0.8520126379926733
32,BIJOY DOLUI,SC,BOLPUR,5511,5,IND,4,M,WEST BENGAL,770059,767696,2363,1035012,525795,509217,0.5328440636437065,5515,0.7161788901889335
46,RAM CHANDRA DOME,SC,BIRBHUM (SC),370610,4,CPM,1684,M,WEST BENGAL,724061,721560,2501,1029870,527046,502824,36.14961111596609,372294,51.41749106774153
35,GOPAL CHANDRA DAS,SC,BIRBHUM (SC),180305,3,INC,377,M,WEST BENGAL,724061,721560,2501,1029870,527046,502824,17.54415605853166,180682,24.95397487228286
35,ARJUN SAHA,SC,BIRBHUM (SC),139776,1,BJP,420,M,WEST BENGAL,724061,721560,2501,1029870,527046,502824,13.612980279064349,140196,19.362457030554054
62,BRAJA MOHON DAS,SC,BIRBHUM (SC),14750,6,IND,12,M,WEST BENGAL,724061,721560,2501,1029870,527046,502824,1.4333847961393187,14762,2.0387785007064325
30,CHINTA SARKAR,SC,BIRBHUM (SC),9591,5,JD(S),3,F,WEST BENGAL,724061,721560,2501,1029870,527046,502824,0.9315738879664424,9594,1.3250264825753633
51,KARTIK CHANDRA DAS,SC,BIRBHUM (SC),6528,2,BSP,5,M,WEST BENGAL,724061,721560,2501,1029870,527046,502824,0.634351908493305,6533,0.902272046139759
65,NAND KUMAR SAI,ST,SURGUJA (ST),356952,2,BJP,156,M,CHHATTISGARH,676699,676480,219,1387483,707640,679843,25.73782885988513,357108,52.77205966020343
56,KHELSAY SINGH,ST,SURGUJA (ST),253598,1,INC,58,M,CHHATTISGARH,676699,676480,219,1387483,707640,679843,18.281737505973048,253656,37.48431725183575
60,RAMLAKHAN,ST,SURGUJA (ST),19474,8,IND,0,M,CHHATTISGARH,676699,676480,219,1387483,707640,679843,1.4035487281645973,19474,2.8777935241518016
35,RAMNARAYAN SINGH AYAM,ST,SURGUJA (ST),16211,3,BSP,3,M,CHHATTISGARH,676699,676480,219,1387483,707640,679843,1.168590894446995,16214,2.3960431447364336
34,DR L S UDAY,ST,SURGUJA (ST),11185,4,GGP,1,M,CHHATTISGARH,676699,676480,219,1387483,707640,679843,0.8062080760629139,11186,1.6530244613927314
27,PRAVIN KUMAR,ST,SURGUJA (ST),7461,7,IND,0,M,CHHATTISGARH,676699,676480,219,1387483,707640,679843,0.5377363182107456,7461,1.1025581536251716
55,BERNADATE,ST,SURGUJA (ST),5908,6,JMM,1,F,CHHATTISGARH,676699,676480,219,1387483,707640,679843,0.42587909185193623,5909,0.8732095067378555
35,NIRMALA,ST,SURGUJA (ST),5691,5,SP,0,F,CHHATTISGARH,676699,676480,219,1387483,707640,679843,0.41016718763401067,5691,0.8409942973168277
39,VISHNUDEO SAI,ST,RAIGARH (ST),328946,3,BJP,111,M,CHHATTISGARH,648435,648290,145,1038634,520609,518025,31.681708859906376,329057,50.7463354075582
63,RAMPUKAR SINGH,ST,RAIGARH (ST),254784,2,INC,30,M,CHHATTISGARH,648435,648290,145,1038634,520609,518025,24.53357005451391,254814,39.296768373082884
29,KRIPA SHANKAR BHAGAT,ST,RAIGARH (ST),27615,1,BSP,1,M,CHHATTISGARH,648435,648290,145,1038634,520609,518025,2.658876947991304,27616,4.258869431785762
46,GOVIND SINGH NETI,ST,RAIGARH (ST),21271,5,GGP,0,M,CHHATTISGARH,648435,648290,145,1038634,520609,518025,2.0479784024016157,21271,3.2803596351214845
28,AMRIT TIRKEY,ST,RAIGARH (ST),15674,4,SP,3,M,CHHATTISGARH,648435,648290,145,1038634,520609,518025,1.5093863670937018,15677,2.4176671524516724
52,KARUNA SHUKLA,GEN,JANJGIR,303432,1,BJP,223,F,CHHATTISGARH,717698,717350,348,1374418,702929,671489,22.093351513149564,303655,42.30957868072643
48,DR CHARANDAS MAHANT,GEN,JANJGIR,292241,2,INC,85,M,CHHATTISGARH,717698,717350,348,1374418,702929,671489,21.269075346801337,292326,40.731059582164086
54,MURTIRAMSAHU,GEN,JANJGIR,51873,3,BSP,28,M,CHHATTISGARH,717698,717350,348,1374418,702929,671489,3.776216551296622,51901,7.231593232808228
41,DR URMILA MARKO,ST,JANJGIR,22901,4,GGP,9,F,CHHATTISGARH,717698,717350,348,1374418,702929,671489,1.6668873661433423,22910,3.1921504588280865
40,HAMID (ABDUL HAMID SIDDQIE),GEN,JANJGIR,13441,16,IND,0,M,CHHATTISGARH,717698,717350,348,1374418,702929,671489,0.9779412085697363,13441,1.8727932918860022
64,DR VIDYANAND TIWARI,GEN,JANJGIR,7274,15,IND,1,M,CHHATTISGARH,717698,717350,348,1374418,702929,671489,0.5293149536749373,7275,1.0136575551276443
28,BADKURAM DHRUW,ST,JANJGIR,5008,14,IND,0,M,CHHATTISGARH,717698,717350,348,1374418,702929,671489,0.36437241072221116,5008,0.697786534168968
25,HEMLATA,ST,JANJGIR,4139,11,YGP,1,F,CHHATTISGARH,717698,717350,348,1374418,702929,671489,0.301218406627387,4140,0.5768442994128449
47,PRAMOD KUMAR,GEN,JANJGIR,3263,13,IND,0,M,CHHATTISGARH,717698,717350,348,1374418,702929,671489,0.23740957990945988,3263,0.45464805531017227
40,PARSRAM YADAV,GEN,JANJGIR,2511,12,IND,0,M,CHHATTISGARH,717698,717350,348,1374418,702929,671489,0.18269551184574126,2511,0.34986860768735595
50,SAHASRAM YADAV,GEN,JANJGIR,2316,10,SP,1,M,CHHATTISGARH,717698,717350,348,1374418,702929,671489,0.16858044641440958,2317,0.3228377395506188
48,SHOBHA LAL PRAJAPTI,GEN,JANJGIR,1984,9,LJNSP,0,M,CHHATTISGARH,717698,717350,348,1374418,702929,671489,0.14435200935959805,1984,0.27643939372828125
38,RAMDAS MAHANT,GEN,JANJGIR,1951,8,CSP,0,M,CHHATTISGARH,717698,717350,348,1374418,702929,671489,0.14195099307488696,1951,0.27184135945759913
35,DHANRAJ PATEL,GEN,JANJGIR,1833,6,AD,0,M,CHHATTISGARH,717698,717350,348,1374418,702929,671489,0.1333655409053141,1833,0.2553999035806147
63,BHAGWATI PRASAD SHUKLA GURUJI,GEN,JANJGIR,1689,7,BPSGKD,0,M,CHHATTISGARH,717698,717350,348,1374418,702929,671489,0.12288837893566587,1689,0.23533575403582008
42,KANCHAN,GEN,JANJGIR,1494,5,SAP,0,F,CHHATTISGARH,717698,717350,348,1374418,702929,671489,0.10870055543510053,1494,0.20816555152724406
52,PUNNULAL MOHLE,SC,BILASPUR (SC),324640,1,BJP,89,M,CHHATTISGARH,621425,621307,118,1411786,718155,693631,23.00129056386733,324729,52.25554169851551
43,DR BASANT PAHRE,SC,BILASPUR (SC),243153,2,INC,23,M,CHHATTISGARH,621425,621307,118,1411786,718155,693631,17.224706860671517,243176,39.131995011465584
29,SHEKHAR KUMAR BANJARE,GEN,BILASPUR (SC),15588,7,IND,0,M,CHHATTISGARH,621425,621307,118,1411786,718155,693631,1.104133345988698,15588,2.508428209357525
40,ENGG RAMESHWAR KHARE,SC,BILASPUR (SC),15404,3,BSP,2,M,CHHATTISGARH,621425,621307,118,1411786,718155,693631,1.091241873768404,15406,2.4791406847165787
47,DR BHAGIRATHI KHUTE,SC,BILASPUR (SC),11180,4,GGP,3,M,CHHATTISGARH,621425,621307,118,1411786,718155,693631,0.792117218898615,11183,1.7995735607675905
28,CHOTELAL SUMER,SC,BILASPUR (SC),7236,6,IND,0,M,CHHATTISGARH,621425,621307,118,1411786,718155,693631,0.5125422691541069,7236,1.164420485175202
43,RAMLAL,SC,BILASPUR (SC),4106,5,SP,1,M,CHHATTISGARH,621425,621307,118,1411786,718155,693631,0.2909081121359753,4107,0.6609003500020115
30,GUHARAM AJGALLE,SC,SARANGARH (SC),242462,1,BJP,113,M,CHHATTISGARH,587907,587744,163,1191389,597660,593729,20.360688238686105,242575,41.26077764000088
57,PARASRAM BHARDWAJ,SC,SARANGARH (SC),183438,3,INC,19,M,CHHATTISGARH,587907,587744,163,1191389,597660,593729,15.398580984044674,183457,31.20510556941829
45,DAU RAM RATNAKAR,SC,SARANGARH (SC),112975,2,BSP,29,M,CHHATTISGARH,587907,587744,163,1191389,597660,593729,9.485063232915529,113004,19.221407467507614
61,RAMVILAS RATRE,SC,SARANGARH (SC),13315,11,IND,0,M,CHHATTISGARH,587907,587744,163,1191389,597660,593729,1.1176030666725982,13315,2.26481399268932
34,RAMASHANKAR,SC,SARANGARH (SC),8727,10,IND,0,M,CHHATTISGARH,587907,587744,163,1191389,597660,593729,0.732506343436107,8727,1.4844184539391434
65,ROHIT KUMAR CHAUHAN,SC,SARANGARH (SC),7109,4,SP,0,M,CHHATTISGARH,587907,587744,163,1191389,597660,593729,0.5966984754769433,7109,1.2092048572308205
26,DR GOVIND CHOUHAN,SC,SARANGARH (SC),7069,9,IND,2,M,CHHATTISGARH,587907,587744,163,1191389,597660,593729,0.5935089210996576,7071,1.2027412498915644
38,SAHEBLAL CHAUHAN,SC,SARANGARH (SC),3703,6,AD,0,M,CHHATTISGARH,587907,587744,163,1191389,597660,593729,0.31081368050233804,3703,0.6298615257175029
35,KARAMCHAND SURYAWANSHI S/O SHRI,SC,SARANGARH (SC),3249,8,IND,0,M,CHHATTISGARH,587907,587744,163,1191389,597660,593729,0.27270689925792496,3249,0.5526384275063914
51,SHIV PRASAD,SC,SARANGARH (SC),3089,5,JD(U),0,M,CHHATTISGARH,587907,587744,163,1191389,597660,593729,0.25927719661672216,3089,0.5254232387095238
31,AWADHRAM BEHARA,SC,SARANGARH (SC),2608,7,IND,0,M,CHHATTISGARH,587907,587744,163,1191389,597660,593729,0.21890415305160618,2608,0.44360757738894074
54,RAMESH BAIS,GEN,RAIPUR,375949,1,BJP,80,M,CHHATTISGARH,689517,689427,90,1370242,699764,670478,27.44252475110236,376029,54.535131113518595
77,SHYAMACHARAN SHUKLA,GEN,RAIPUR,246500,2,INC,10,M,CHHATTISGARH,689517,689427,90,1370242,699764,670478,17.990252816655744,246510,35.75111273543655
44,DR HEERAMAN BANJARE,SC,RAIPUR,32252,3,BSP,0,M,CHHATTISGARH,689517,689427,90,1370242,699764,670478,2.3537448129600467,32252,4.677477132543506
57,DR RAMKUMAR SIRMOR,GEN,RAIPUR,14330,13,IND,0,M,CHHATTISGARH,689517,689427,90,1370242,699764,670478,1.0458006687869734,14330,2.078266380669367
34,RADHESHYAM SEN,GEN,RAIPUR,6192,12,IND,0,M,CHHATTISGARH,689517,689427,90,1370242,699764,670478,0.45189097984151705,6192,0.8980199182906295
35,MANMOHAN SINGH THAKUR (GIRDHARI,GEN,RAIPUR,2944,11,IND,0,M,CHHATTISGARH,689517,689427,90,1370242,699764,670478,0.2148525588910572,2944,0.42696554254644914
34,BALRAM SINGH YADAV ALIAS BALLU,GEN,RAIPUR,2558,4,SP,0,M,CHHATTISGARH,689517,689427,90,1370242,699764,670478,0.1866823524603683,2558,0.3709843267098563
35,NANHA MARKANDEY,SC,RAIPUR,2502,8,IND,0,M,CHHATTISGARH,689517,689427,90,1370242,699764,670478,0.18259548313363624,2502,0.36286269954185324
40,PATRAKAR BIMAL KUMAR SAHU SANDI,GEN,RAIPUR,1560,10,IND,0,M,CHHATTISGARH,689517,689427,90,1370242,699764,670478,0.11384850267325043,1560,0.22624532825151522
29,KABEER BHAKT ASWANT DAS SAHU,GEN,RAIPUR,1410,7,IND,0,M,CHHATTISGARH,689517,689427,90,1370242,699764,670478,0.10290153126236096,1410,0.2044909697657926
45,PRAKASH GOLCHA (SARAFA SANSAD),GEN,RAIPUR,1277,9,IND,0,M,CHHATTISGARH,689517,689427,90,1370242,699764,670478,0.0931952166113723,1277,0.18520210524178518
37,MADHUSUDAN MISHRA JI,GEN,RAIPUR,992,5,ABHM,0,M,CHHATTISGARH,689517,689427,90,1370242,699764,670478,0.07239597093068231,992,0.14386882411891222
43,SEEDHERAM,SC,RAIPUR,961,6,GGP,0,M,CHHATTISGARH,689517,689427,90,1370242,699764,670478,0.0701335968390985,961,0.13937292336519622
57,AJIT JOGI,ST,MAHASAMUND,414363,1,INC,284,M,CHHATTISGARH,771432,770599,833,1169419,579623,589796,35.45752206865119,414647,53.75029814682305
74,VIDHYA CHARAN SHUKLA,GEN,MAHASAMUND,295600,3,BJP,542,M,CHHATTISGARH,771432,770599,833,1169419,579623,589796,25.323857402693132,296142,38.388607161745945
56,SULTAN SINGH SATNAM,GEN,MAHASAMUND,20836,10,IND,0,M,CHHATTISGARH,771432,770599,833,1169419,579623,589796,1.7817394791772665,20836,2.7009509587364797
33,RAJENDRA KUMAR,GEN,MAHASAMUND,12001,2,BSP,6,M,CHHATTISGARH,771432,770599,833,1169419,579623,589796,1.0267491805759954,12007,1.5564560453805392
68,GANPAT SARAIPALI,GEN,MAHASAMUND,7519,8,IND,0,M,CHHATTISGARH,771432,770599,833,1169419,579623,589796,0.6429688588948871,7519,0.9746808532702816
39,TEN SINGH,GEN,MAHASAMUND,6808,4,CSP,1,M,CHHATTISGARH,771432,770599,833,1169419,579623,589796,0.5822549488250148,6809,0.8826442252849247
55,DHARAMDAS MAHILANG,SC,MAHASAMUND,5468,9,IND,0,M,CHHATTISGARH,771432,770599,833,1169419,579623,589796,0.4675826200874109,5468,0.7088116645407502
38,SHRIDHAR PATEL,GEN,MAHASAMUND,3502,7,AD,0,M,CHHATTISGARH,771432,770599,833,1169419,579623,589796,0.2994649479784406,3502,0.45396094535876136
38,COMRED SHIKHA DAS (PATRAKAR),GEN,MAHASAMUND,2416,5,LSWP,0,F,CHHATTISGARH,771432,770599,833,1169419,579623,589796,0.20659831933635422,2416,0.3131837932572152
32,SIYARAM DHARITLAHRE,SC,MAHASAMUND,2086,6,ABHM,0,M,CHHATTISGARH,771432,770599,833,1169419,579623,589796,0.1783791780362727,2086,0.2704062056020492
47,SOHAN POTAI,ST,KANKER (ST),273766,4,BJP,528,M,CHHATTISGARH,553888,553195,693,1152128,570195,581933,23.807597766914785,274294,49.521563926281125
54,MRS GANGA POTAI THAKUR,ST,KANKER (ST),200548,2,INC,120,F,CHHATTISGARH,553888,553195,693,1152128,570195,581933,17.417161982002,200668,36.22898492113929
56,G R RANA,ST,KANKER (ST),28869,5,SP,37,M,CHHATTISGARH,553888,553195,693,1152128,570195,581933,2.508922619708921,28906,5.218744583742561
38,ARJUN SINGH THAKUR,ST,KANKER (ST),17601,1,BSP,4,M,CHHATTISGARH,553888,553195,693,1152128,570195,581933,1.5280420231085434,17605,3.178440406724825
27,SUKHRANJAN USENDI,ST,KANKER (ST),16478,3,CPM,1,M,CHHATTISGARH,553888,553195,693,1152128,570195,581933,1.4303098266859238,16479,2.975150210872956
29,SUNDARLAL NETAM,ST,KANKER (ST),15933,6,CSP,3,M,CHHATTISGARH,553888,553195,693,1152128,570195,581933,1.3831796467059216,15936,2.8771159512392397
67,BALIRAM KASHYAP,ST,BASTAR (ST),212886,1,BJP,7,M,CHHATTISGARH,450425,450417,8,1039442,507521,531921,20.481469865562485,212893,47.26491646778043
50,MAHENDRA KARMA,ST,BASTAR (ST),158519,2,INC,1,M,CHHATTISGARH,450425,450417,8,1039442,507521,531921,15.250490166839517,158520,35.19342842870622
45,RAMNATH SARFE,ST,BASTAR (ST),30608,3,CPI,0,M,CHHATTISGARH,450425,450417,8,1039442,507521,531921,2.944656844730153,30608,6.795359937836489
49,DASI BAI,ST,BASTAR (ST),24556,8,IND,0,F,CHHATTISGARH,450425,450417,8,1039442,507521,531921,2.362421376084476,24556,5.4517400233113165
36,CHANDRA SHEKHAR DHRUVA (SHEKHAR),ST,BASTAR (ST),7465,7,IND,0,M,CHHATTISGARH,450425,450417,8,1039442,507521,531921,0.7181737893985427,7465,1.6573236387855912
56,LAXMINATH BHARTI,ST,BASTAR (ST),6856,4,BSP,0,M,CHHATTISGARH,450425,450417,8,1039442,507521,531921,0.6595846617704499,6856,1.5221179996669811
28,SHIVRAM,ST,BASTAR (ST),5017,6,CPI(ML)(L),0,M,CHHATTISGARH,450425,450417,8,1039442,507521,531921,0.48266281331714517,5017,1.113836931786646
30,SHKUNTALA ATE,ST,BASTAR (ST),4510,5,SP,0,F,CHHATTISGARH,450425,450417,8,1039442,507521,531921,0.43388664302577734,4510,1.0012765721263253
57,TARACHAND SAHU,GEN,DURG,382423,1,BJP,334,M,CHHATTISGARH,761815,761323,492,1462883,745723,717160,26.16456681771543,382757,50.24277547698588
42,BHUPESH BAGHEL,GEN,DURG,321139,2,INC,150,M,CHHATTISGARH,761815,761323,492,1462883,745723,717160,21.962727026016434,321289,42.17414989203416
39,SHRI MATAJI,GEN,DURG,17929,3,BSP,6,M,CHHATTISGARH,761815,761323,492,1462883,745723,717160,1.2260037200514327,17935,2.3542461096197895
34,MANHARAN SINGH CHHEDAIHA,ST,DURG,17927,11,IND,1,M,CHHATTISGARH,761815,761323,492,1462883,745723,717160,1.2255252128844207,17928,2.3533272513668013
42,BHARAT BHUSHAN PANDEY,GEN,DURG,8077,10,IND,1,M,CHHATTISGARH,761815,761323,492,1462883,745723,717160,0.5521972707318357,8078,1.0603624239480713
50,BALVINDER SINGH,GEN,DURG,3462,9,IND,0,M,CHHATTISGARH,761815,761323,492,1462883,745723,717160,0.23665597317078674,3462,0.4544410388348877
63,R D JOGANSH,SC,DURG,2209,8,IND,0,M,CHHATTISGARH,761815,761323,492,1462883,745723,717160,0.15100319027564063,2209,0.28996541155004824
35,KIRAN NONI URF KIRAN BETI,GEN,DURG,2185,4,IJP,0,F,CHHATTISGARH,761815,761323,492,1462883,745723,717160,0.1493625942744567,2185,0.2868150403969468
36,SHIEKH RASOOL ALIAS DADA BHAI,GEN,DURG,2155,5,SP,0,M,CHHATTISGARH,761815,761323,492,1462883,745723,717160,0.14731184927297672,2155,0.2828770764555699
40,ASHOK KUMAR RAJPUT,GEN,DURG,1988,7,IND,0,M,CHHATTISGARH,761815,761323,492,1462883,745723,717160,0.13589603543140497,1988,0.2609557438485721
34,ARUN JOSHI,SC,DURG,1829,6,IND,0,M,CHHATTISGARH,761815,761323,492,1462883,745723,717160,0.12502708692356124,1829,0.24008453495927487
37,PRADEEP GANDHI,GEN,RAJNANDGAON,313472,2,BJP,1048,M,CHHATTISGARH,665935,664445,1490,1121618,554923,566695,28.04163271274177,314520,47.22983474363113
33,DEVVRAT SINGH,GEN,RAJNANDGAON,299783,1,INC,414,M,CHHATTISGARH,665935,664445,1490,1121618,554923,566695,26.764638227988495,300197,45.07902422909143
26,SANTRAM GOND (CHHEDIYA),ST,RAJNANDGAON,20414,7,IND,5,M,CHHATTISGARH,665935,664445,1490,1121618,554923,566695,1.8204950348514377,20419,3.0662151711503376
54,MOCHI RAM GOND,ST,RAJNANDGAON,13306,3,BSP,20,M,CHHATTISGARH,665935,664445,1490,1121618,554923,566695,1.1881050411102534,13326,2.001096203082884
62,AAJU RAM CHANDRAVANSHI,GEN,RAJNANDGAON,7415,6,IND,0,M,CHHATTISGARH,665935,664445,1490,1121618,554923,566695,0.6610985201735351,7415,1.1134720355590262
35,ROMAN KUMAR SAHU,GEN,RAJNANDGAON,5266,5,SP,2,M,CHHATTISGARH,665935,664445,1490,1121618,554923,566695,0.46967862498640356,5268,0.7910681973465878
40,SMT PUSHPA NAGDEV,SC,RAJNANDGAON,4789,4,RPI(KH),1,F,CHHATTISGARH,665935,664445,1490,1121618,554923,566695,0.42706161990980884,4790,0.7192894201386021
51,HEMLAL MURMU,ST,RAJMAHAL (ST),226410,4,JMM,1,M,JHARKHAND,691123,691116,7,1072040,551677,520363,21.11964105816947,226411,32.75987052955841
52,THOMAS HANSDA,ST,RAJMAHAL (ST),223434,2,INC,3,M,JHARKHAND,691123,691116,7,1072040,551677,520363,20.842226036341927,223437,32.329556388660194
40,SOM MARANDI,ST,RAJMAHAL (ST),192451,3,BJP,3,M,JHARKHAND,691123,691116,7,1072040,551677,520363,17.952128651915974,192454,27.846562768132443
42,CHUNDA TUDU,ST,RAJMAHAL (ST),14594,1,BSP,0,M,JHARKHAND,691123,691116,7,1072040,551677,520363,1.3613298011268236,14594,2.11163570015757
25,DILIP HEMBROM,ST,RAJMAHAL (ST),11546,5,IND,0,M,JHARKHAND,691123,691116,7,1072040,551677,520363,1.0770120517891124,11546,1.6706143479525353
28,SUKHLAL SOREN,ST,RAJMAHAL (ST),9908,8,IND,0,M,JHARKHAND,691123,691116,7,1072040,551677,520363,0.9242192455505391,9908,1.4336087787557352
39,RAMKSRISHNA SOREN,ST,RAJMAHAL (ST),7388,7,IND,0,M,JHARKHAND,691123,691116,7,1072040,551677,520363,0.6891533897988881,7388,1.0689848261452737
26,BABUDHAN SOREN,ST,RAJMAHAL (ST),5385,6,IND,0,M,JHARKHAND,691123,691116,7,1072040,551677,520363,0.502313346516921,5385,0.7791666606378315
59,SHIBU SOREN,ST,DUMKA (ST),339516,2,JMM,26,M,JHARKHAND,625118,625043,75,1083200,569239,513961,31.3461964549483,339542,54.316465051398296
60,SONE LAL HEMBROM,ST,DUMKA (ST),224480,3,BJP,47,M,JHARKHAND,625118,625043,75,1083200,569239,513961,20.728120384047266,224527,35.91753876868047
26,BAIJNATH MANJHI,ST,DUMKA (ST),13477,1,BSP,1,M,JHARKHAND,625118,625043,75,1083200,569239,513961,1.2442762186115215,13478,2.1560729334301683
43,JONATHAN TUDU,ST,DUMKA (ST),12324,4,AJSU,1,M,JHARKHAND,625118,625043,75,1083200,569239,513961,1.1378323485967503,12325,1.9716277566795388
51,SONA MURMU,ST,DUMKA (ST),9132,10,IND,0,F,JHARKHAND,625118,625043,75,1083200,569239,513961,0.8430576070901034,9132,1.460844192616434
48,SURUN SOREN,ST,DUMKA (ST),8039,7,CPI(ML)(L),0,M,JHARKHAND,625118,625043,75,1083200,569239,513961,0.7421528803545052,8039,1.2859972037279361
60,KALI CHARAN DEHRI,ST,DUMKA (ST),6285,9,IND,0,M,JHARKHAND,625118,625043,75,1083200,569239,513961,0.580225258493353,6285,1.0054101785582883
31,KALESHWAR SOREN,ST,DUMKA (ST),4358,8,IND,0,M,JHARKHAND,625118,625043,75,1083200,569239,513961,0.4023264401772526,4358,0.6971483783861607
58,MAIKEL MURMU,ST,DUMKA (ST),3929,5,SP,0,M,JHARKHAND,625118,625043,75,1083200,569239,513961,0.36272156573116693,3929,0.6285213351719195
60,SAMUEL SOREN,ST,DUMKA (ST),3503,6,LJNSP,0,M,JHARKHAND,625118,625043,75,1083200,569239,513961,0.3233936484490399,3503,0.560374201350785
52,FURKAN ANSARI,GEN,GODDA,373134,3,INC,4,M,JHARKHAND,831356,831337,19,1338939,712584,626355,27.868185182446698,373138,44.883058521259244
38,PRADEEP YADAV,GEN,GODDA,346371,2,BJP,13,M,JHARKHAND,831356,831337,19,1338939,712584,626355,25.87003590156086,346384,41.66494257574372
55,SURAJ MANDAL,GEN,GODDA,43836,4,JD(U),1,M,JHARKHAND,831356,831337,19,1338939,712584,626355,3.274010242438229,43837,5.272951659698132
43,JAI PRAKASH YADAV,GEN,GODDA,22875,1,BSP,0,M,JHARKHAND,831356,831337,19,1338939,712584,626355,1.7084422815378444,22875,2.7515288276021344
26,SHAMIM AKHTAR,GEN,GODDA,11061,12,IND,0,M,JHARKHAND,831356,831337,19,1338939,712584,626355,0.8261018612498403,11061,1.3304769557205336
28,NIRANJAN YADAV,GEN,GODDA,5647,10,IND,0,M,JHARKHAND,831356,831337,19,1338939,712584,626355,0.42175184978553915,5647,0.6792517285013882
30,NOOR HASAN,GEN,GODDA,5641,5,SAP,0,M,JHARKHAND,831356,831337,19,1338939,712584,626355,0.42130373377726693,5641,0.678530016022017
32,AMRENDRA KUMAR PANDIT,GEN,GODDA,5633,9,IND,0,M,JHARKHAND,831356,831337,19,1338939,712584,626355,0.4207062457662373,5633,0.677567732716189
42,RADHESHYAM VERMA,GEN,GODDA,5159,6,LJNSP,0,M,JHARKHAND,831356,831337,19,1338939,712584,626355,0.38530508111273176,5159,0.620552446845876
44,PRADIP KUMAR MISHRA,GEN,GODDA,4645,11,IND,0,M,JHARKHAND,831356,831337,19,1338939,712584,626355,0.34691647640407813,4645,0.5587257444464225
31,SHASHI SAURABH,GEN,GODDA,3705,8,AD,0,M,JHARKHAND,831356,831337,19,1338939,712584,626355,0.27671163510809677,3705,0.4456574560116244
60,LEKHA NAND JHA,GEN,GODDA,3630,7,SP,1,M,JHARKHAND,831356,831337,19,1338939,712584,626355,0.2711848710060727,3631,0.4367563354327147
45,DHIRENDRA AGARWAL,GEN,CHATRA,121459,2,RJD,5,M,JHARKHAND,435504,435488,16,978364,515592,462772,12.415011181932286,121464,27.890444175024797
60,INDER SINGH NAMDHARI,GEN,CHATRA,102603,1,JD(U),6,M,JHARKHAND,435504,435488,16,978364,515592,462772,10.487814351304833,102609,23.56097762592307
40,NAGMANI,GEN,CHATRA,99659,3,BJP,3,M,JHARKHAND,435504,435488,16,978364,515592,462772,10.18659721739557,99662,22.884290385392557
47,RAMLAL ORAON,ST,CHATRA,51915,15,IND,2,M,JHARKHAND,435504,435488,16,978364,515592,462772,5.306511686856834,51917,11.921130460340205
36,SURESH YADAV,GEN,CHATRA,14317,6,SP,0,M,JHARKHAND,435504,435488,16,978364,515592,462772,1.4633612847570026,14317,3.287455453910871
48,RAMPATI RANJAN,SC,CHATRA,11201,4,BSP,0,M,JHARKHAND,435504,435488,16,978364,515592,462772,1.1448704163276653,11201,2.5719625996546527
40,DR SITA RAM SINGH,GEN,CHATRA,8918,16,IND,0,M,JHARKHAND,435504,435488,16,978364,515592,462772,0.9115216831363379,8918,2.047742385833425
39,BIRJU RAM,SC,CHATRA,8631,5,CPI(ML)(L),0,M,JHARKHAND,435504,435488,16,978364,515592,462772,0.8821869978862673,8631,1.981841728204563
29,RAJ KUMAR SHARMA,GEN,CHATRA,4098,14,IND,0,M,JHARKHAND,435504,435488,16,978364,515592,462772,0.41886250925013596,4098,0.9409787280943459
68,MUNESHWAR SINGH,GEN,CHATRA,2821,13,IND,0,M,JHARKHAND,435504,435488,16,978364,515592,462772,0.28833849160435177,2821,0.6477552444983283
34,ABID ALI,GEN,CHATRA,2544,8,IND,0,M,JHARKHAND,435504,435488,16,978364,515592,462772,0.2600259208229248,2544,0.5841507770307506
64,BHARAT PRASAD SINGH,GEN,CHATRA,1710,12,IND,0,M,JHARKHAND,435504,435488,16,978364,515592,462772,0.17478157413805087,1710,0.3926485175796319
29,BINOD BIHARI,SC,CHATRA,1496,11,IND,0,M,JHARKHAND,435504,435488,16,978364,515592,462772,0.1529083245090784,1496,0.3435100481281458
37,AWADH KISHORE SINGH,GEN,CHATRA,1461,7,IND,0,M,JHARKHAND,435504,435488,16,978364,515592,462772,0.14933092386882593,1461,0.3354733825636504
48,BINDHYACHAL SINGH,GEN,CHATRA,1435,10,IND,0,M,JHARKHAND,435504,435488,16,978364,515592,462772,0.14667342625035262,1435,0.32950328814431096
55,CHAMARI RAM,GEN,CHATRA,1220,9,IND,0,M,JHARKHAND,435504,435488,16,978364,515592,462772,0.12469796517451584,1220,0.2801351996766964
45,BABULAL MARANDI,ST,KODARMA,366646,3,BJP,10,M,JHARKHAND,825710,825697,13,1325734,691424,634310,27.656830103173036,366656,44.40493635780117
57,CHAMPA VERMA,GEN,KODARMA,211709,1,JMM,3,F,JHARKHAND,825710,825697,13,1325734,691424,634310,15.96941769615926,211712,25.63999467125262
33,RAJ KUMAR YADAV,GEN,KODARMA,136554,7,CPI(ML)(L),0,M,JHARKHAND,825710,825697,13,1325734,691424,634310,10.300256310843652,136554,16.537767497063133
62,TILAKDHARI PRASAD SINGH,GEN,KODARMA,53806,2,INC,0,M,JHARKHAND,825710,825697,13,1325734,691424,634310,4.058581887467621,53806,6.516331399643943
29,MAHESH RAM,SC,KODARMA,17053,4,BSP,0,M,JHARKHAND,825710,825697,13,1325734,691424,634310,1.2863063027726527,17053,2.065252933838757
37,RAM BALAK CHOUDHARY,GEN,KODARMA,14129,10,IND,0,M,JHARKHAND,825710,825697,13,1325734,691424,634310,1.0657492377807312,14129,1.7111334487895264
35,DEO CHARAN DAS,SC,KODARMA,9215,8,IND,0,M,JHARKHAND,825710,825697,13,1325734,691424,634310,0.6950866463408195,9215,1.1160092526431797
46,KRISHNADEO YADAV,GEN,KODARMA,5731,6,SP,0,M,JHARKHAND,825710,825697,13,1325734,691424,634310,0.4322888301876545,5731,0.6940693463806905
37,UMESH CHANDRA TRIVEDI,GEN,KODARMA,5540,5,JKP,0,M,JHARKHAND,825710,825697,13,1325734,691424,634310,0.417881716845159,5540,0.6709377384311683
36,YOGENDRA KUMAR SINHA,GEN,KODARMA,5314,9,IND,0,M,JHARKHAND,825710,825697,13,1325734,691424,634310,0.4008345565550857,5314,0.6435673541558175
52,TEK LAL MAHTO,GEN,GIRIDIH,350249,3,JMM,6,M,JHARKHAND,714378,714371,7,1312691,716025,596666,26.68221234090887,350255,49.029365405989545
45,RAVINDRA KUMAR PANDEY,GEN,GIRIDIH,200460,4,BJP,1,M,JHARKHAND,714378,714371,7,1312691,716025,596666,15.27099675399618,200461,28.060914529842744
39,INDERDEO MAHATO,GEN,GIRIDIH,81722,1,JD(U),0,M,JHARKHAND,714378,714371,7,1312691,716025,596666,6.225532132085921,81722,11.439602003421157
57,RAJ KISHORE MAHATO,GEN,GIRIDIH,32284,9,AJSU,0,M,JHARKHAND,714378,714371,7,1312691,716025,596666,2.459375435650888,32284,4.51917612244498
34,KAMAL SAHU,GEN,GIRIDIH,13620,2,BSP,0,M,JHARKHAND,714378,714371,7,1312691,716025,596666,1.037563295550895,13620,1.906553673265414
35,SANJAY KUMAR SINGH,GEN,GIRIDIH,9810,12,IND,0,M,JHARKHAND,714378,714371,7,1312691,716025,596666,0.7473198186016359,9810,1.3732225796427102
57,IBNUL HASAN BASRU,GEN,GIRIDIH,6435,6,CPI(ML)(L),0,M,JHARKHAND,714378,714371,7,1312691,716025,596666,0.490214376422174,6435,0.9007836187564566
26,ABHAY KUMAR SINGH,GEN,GIRIDIH,5316,5,SP,0,M,JHARKHAND,714378,714371,7,1312691,716025,596666,0.4049696387040057,5316,0.7441438566137255
36,SUKHDEO MAHTO,GEN,GIRIDIH,4229,10,RLD,0,M,JHARKHAND,714378,714371,7,1312691,716025,596666,0.3221626414746501,4229,0.5919835157297677
46,KAILASH CHANDRA MAHTO,GEN,GIRIDIH,3781,8,JKP,0,M,JHARKHAND,714378,714371,7,1312691,716025,596666,0.2880342746312727,3781,0.5292716181069407
30,KIRAN RAJ,GEN,GIRIDIH,3631,7,LJNSP,0,F,JHARKHAND,714378,714371,7,1312691,716025,596666,0.2766073660899633,3631,0.5082743309564405
36,BUDHI NATH TIWARI,GEN,GIRIDIH,2834,11,IND,0,M,JHARKHAND,714378,714371,7,1312691,716025,596666,0.2158923920404726,2834,0.3967087452301163
62,CHANDRA SHEKHAR DUBEY,GEN,DHANBAD,355490,1,INC,9,M,JHARKHAND,941478,941449,29,1749456,980265,769191,20.32054535809989,355499,37.75967149524471
50,RITA VERMA,GEN,DHANBAD,236101,3,BJP,20,F,JHARKHAND,941478,941449,29,1749456,980265,769191,13.496824155623234,236121,25.079821302250295
67,A K ROY,GEN,DHANBAD,147470,6,MCO,0,M,JHARKHAND,941478,941449,29,1749456,980265,769191,8.429477506150484,147470,15.663669251963402
62,SAMRESH SINGH,GEN,DHANBAD,106234,18,IND,0,M,JHARKHAND,941478,941449,29,1749456,980265,769191,6.072401935230152,106234,11.28374746940449
51,DINA BANDHU SINGH,GEN,DHANBAD,18628,4,SLP(L),0,M,JHARKHAND,941478,941449,29,1749456,980265,769191,1.0647881398560468,18628,1.9785911088734947
27,DILIP BAURI,SC,DHANBAD,11588,11,IND,0,M,JHARKHAND,941478,941449,29,1749456,980265,769191,0.6623773332967505,11588,1.2308306726232583
25,PYARE LAL MAHATO,GEN,DHANBAD,8720,13,IND,0,M,JHARKHAND,941478,941449,29,1749456,980265,769191,0.4984406581245827,8720,0.9262032676281337
37,SHANKAR KUMAR MUKHERJEE,GEN,DHANBAD,8140,16,IND,0,M,JHARKHAND,941478,941449,29,1749456,980265,769191,0.46528749508418615,8140,0.8645980044143359
25,JAGDISH KEWAT,GEN,DHANBAD,7712,2,BSP,0,M,JHARKHAND,941478,941449,29,1749456,980265,769191,0.44082274718541076,7712,0.8191375688013952
30,SUNIL BAURI,SC,DHANBAD,7670,19,IND,0,M,JHARKHAND,941478,941449,29,1749456,980265,769191,0.43842200089627864,7670,0.8146764980169477
50,SWAPAN MUKHERJEE,GEN,DHANBAD,7497,8,CPI(ML)(L),0,M,JHARKHAND,941478,941449,29,1749456,980265,769191,0.42853321261009136,7497,0.7963011350238667
51,SATYANARAYAN JHA,GEN,DHANBAD,7047,17,IND,0,M,JHARKHAND,941478,941449,29,1749456,980265,769191,0.40281093094081816,7047,0.7485039480476442
71,MD YUNUS ANSARI,GEN,DHANBAD,4342,5,LJNSP,0,M,JHARKHAND,941478,941449,29,1749456,980265,769191,0.24819143779552044,4342,0.46118974633501786
36,SHAKUNTALA MISHRA,GEN,DHANBAD,4042,7,SHS,0,F,JHARKHAND,941478,941449,29,1749456,980265,769191,0.231043250016005,4042,0.42932495501753626
41,TEKLAL MAHATO,GEN,DHANBAD,2460,10,IND,0,M,JHARKHAND,941478,941449,29,1749456,980265,769191,0.14061513979202678,2460,0.2612912888033496
53,C P PANDEY,GEN,DHANBAD,2338,12,IND,0,M,JHARKHAND,941478,941449,29,1749456,980265,769191,0.13364154342835716,2338,0.24833294033424042
25,MILONI MADI,ST,DHANBAD,2090,14,IND,0,F,JHARKHAND,941478,941449,29,1749456,980265,769191,0.11946570819729105,2090,0.2219913795117889
48,ISHWAR LAL MAHATO,GEN,DHANBAD,2019,9,IND,0,M,JHARKHAND,941478,941449,29,1749456,980265,769191,0.11540730375613904,2019,0.2144500455666516
51,MUNSI HEMBRAM,ST,DHANBAD,1861,15,IND,0,M,JHARKHAND,941478,941449,29,1749456,980265,769191,0.10637592485892758,1861,0.19766792213944456
53,SUBODH KANT SAHAY,GEN,RANCHI,284035,4,INC,0,M,JHARKHAND,695754,695754,0,1379179,733418,645761,20.594498611130245,284035,40.82405562885732
62,RAM TAHAL CHOUDHARY,GEN,RANCHI,268614,2,BJP,0,M,JHARKHAND,695754,695754,0,1379179,733418,645761,19.476369637298713,268614,38.60761131089437
41,BANDHU TIRKY,ST,RANCHI,52380,15,IND,0,M,JHARKHAND,695754,695754,0,1379179,733418,645761,3.797911656137456,52380,7.528523012444054
70,RAJENDRA SINGH MUNDA,ST,RANCHI,37688,1,CPM,0,M,JHARKHAND,695754,695754,0,1379179,733418,645761,2.732640215664537,37688,5.416857107540884
45,RAJESH KUMAR,GEN,RANCHI,11616,16,IND,0,M,JHARKHAND,695754,695754,0,1379179,733418,645761,0.8422402023232664,11616,1.6695556187962985
47,SAMIM AKHTAR KAMAL,GEN,RANCHI,7116,3,BSP,0,M,JHARKHAND,695754,695754,0,1379179,733418,645761,0.5159591322083645,7116,1.022775291266741
33,CHINTA MANI MAHTO,GEN,RANCHI,5450,14,IND,0,M,JHARKHAND,695754,695754,0,1379179,733418,645761,0.3951626293613809,5450,0.7833228411191311
28,ALI RAJA ZAIDI,GEN,RANCHI,5179,5,SP,0,M,JHARKHAND,695754,695754,0,1379179,733418,645761,0.37551325825001686,5179,0.7443722925056845
49,KHUDI RAM MUNDA,GEN,RANCHI,3787,6,CPI(ML)(L),0,M,JHARKHAND,695754,695754,0,1379179,733418,645761,0.27458364722780726,3787,0.5443015778565412
39,ARUN TIWARI,GEN,RANCHI,2947,13,IND,0,M,JHARKHAND,695754,695754,0,1379179,733418,645761,0.21367784747302562,2947,0.42356925005102375
47,SONA RAM MUNDA,ST,RANCHI,2326,18,IND,0,M,JHARKHAND,695754,695754,0,1379179,733418,645761,0.16865105979716918,2326,0.3343135648519448
26,SANJAY KUMAR GUPTA,GEN,RANCHI,2256,17,IND,0,M,JHARKHAND,695754,695754,0,1379179,733418,645761,0.1635755764842707,2256,0.32425253753481836
35,RAJA RAM PANDIT,GEN,RANCHI,2187,10,NLP,0,M,JHARKHAND,695754,695754,0,1379179,733418,645761,0.15857260007584223,2187,0.3143352391793651
46,ANJANI PANDEY,GEN,RANCHI,2044,11,IND,0,M,JHARKHAND,695754,695754,0,1379179,733418,645761,0.14820411273663536,2044,0.2937819976600925
33,ABHAY KUMAR,GEN,RANCHI,1869,12,IND,0,M,JHARKHAND,695754,695754,0,1379179,733418,645761,0.13551540445438917,1869,0.26862942936727635
33,MANOJ KUMAR,GEN,RANCHI,1790,8,SAP,0,M,JHARKHAND,695754,695754,0,1379179,733418,645761,0.1297873590012609,1790,0.2572748413950908
37,MAQUBOOL AHMAD,GEN,RANCHI,1592,7,LJNSP,0,M,JHARKHAND,695754,695754,0,1379179,733418,645761,0.11543099191620523,1592,0.22881650698379025
33,MUKESH SINHA,GEN,RANCHI,1449,9,JKPP,0,M,JHARKHAND,695754,695754,0,1379179,733418,645761,0.10506250457699834,1449,0.20826326546451762
65,HARIHAR SINGH MUNDA,ST,RANCHI,1429,19,IND,0,M,JHARKHAND,695754,695754,0,1379179,733418,645761,0.10361236648759878,1429,0.20538868623105294
38,SUNIL KUMAR MAHATO,GEN,JAMSHEDPUR,396054,3,JMM,2,M,JHARKHAND,776519,776508,11,1372125,726341,645784,28.8644256171996,396056,51.004032097089706
37,ABHA MAHTO,GEN,JAMSHEDPUR,290414,1,BJP,9,F,JHARKHAND,776519,776508,11,1372125,726341,645784,21.16592876013483,290423,37.400630248583745
40,OMKAR NATH JAISWAL,GEN,JAMSHEDPUR,17409,4,SP,0,M,JHARKHAND,776519,776508,11,1372125,726341,645784,1.268761956818803,17409,2.241928400979242
42,SURYA SINGH BESRA,ST,JAMSHEDPUR,11057,9,NPF,0,M,JHARKHAND,776519,776508,11,1372125,726341,645784,0.8058303725972488,11057,1.423918796578062
54,SITARAM TUDU,ST,JAMSHEDPUR,11022,16,IND,0,M,JHARKHAND,776519,776508,11,1372125,726341,645784,0.8032795845859524,11022,1.4194115018434836
52,DR BADAL CHANDRA BHAKAT,GEN,JAMSHEDPUR,10138,13,IND,0,M,JHARKHAND,776519,776508,11,1372125,726341,645784,0.7388539673863533,10138,1.305570114832992
34,YOGENDRA SHARMA,GEN,JAMSHEDPUR,9640,6,SHS,0,M,JHARKHAND,776519,776508,11,1372125,726341,645784,0.7025598979684795,9640,1.2414377497524207
52,BAIJNATH SHARMA,GEN,JAMSHEDPUR,5702,2,BSP,0,M,JHARKHAND,776519,776508,11,1372125,726341,645784,0.4155598068689077,5702,0.7343027021875833
27,MANOJ BUDHIA,GEN,JAMSHEDPUR,4952,14,IND,0,M,JHARKHAND,776519,776508,11,1372125,726341,645784,0.36090006376970024,4952,0.6377178150180485
52,ANANG PRADHAN,GEN,JAMSHEDPUR,4117,11,IND,0,M,JHARKHAND,776519,776508,11,1372125,726341,645784,0.300045549785916,4117,0.5301866406359664
32,DIL BAHADUR,GEN,JAMSHEDPUR,3629,5,JKP,0,M,JHARKHAND,776519,776508,11,1372125,726341,645784,0.2644802769426984,3629,0.46734207405098904
38,SHYAMAL RANJAN SARKAR,GEN,JAMSHEDPUR,3498,15,IND,0,M,JHARKHAND,776519,776508,11,1372125,726341,645784,0.25493304181470344,3498,0.4504719137587103
30,GOBARDHAN PATRO,GEN,JAMSHEDPUR,2466,12,IND,0,M,JHARKHAND,776519,776508,11,1372125,726341,645784,0.17972123531019404,2466,0.31757110901343044
32,SUJIT SINGH,GEN,JAMSHEDPUR,2377,8,LJNSP,0,M,JHARKHAND,776519,776508,11,1372125,726341,645784,0.17323494579575474,2377,0.3061097024026457
32,HEMANTA SINGH,ST,JAMSHEDPUR,2098,10,AMB,0,M,JHARKHAND,776519,776508,11,1372125,726341,645784,0.1529015213628496,2098,0.2701801243755787
36,SHEKH RASHID,GEN,JAMSHEDPUR,1935,7,NLP,0,M,JHARKHAND,776519,776508,11,1372125,726341,645784,0.1410221371959552,1935,0.24918900889739978
80,BAGUN SUMBRAI,ST,SINGHBHUM (ST),221343,1,INC,0,M,JHARKHAND,520155,520155,0,919728,463556,456172,24.066136944835865,221343,42.55327738847075
40,LAXMAN GILUA,ST,SINGHBHUM (ST),162147,2,BJP,0,M,JHARKHAND,520155,520155,0,919728,463556,456172,17.6298862272324,162147,31.172823485307266
38,SUKHRAM ORAON,ST,SINGHBHUM (ST),72623,7,AJSU,0,M,JHARKHAND,520155,520155,0,919728,463556,456172,7.896138858445105,72623,13.961799848122194
50,SALKHAN MURMU,ST,SINGHBHUM (ST),32810,6,JDP,0,M,JHARKHAND,520155,520155,0,919728,463556,456172,3.567359045282953,32810,6.307735194317078
27,DIMPLE LAMAY,ST,SINGHBHUM (ST),13526,8,IND,0,F,JHARKHAND,520155,520155,0,919728,463556,456172,1.4706521928222256,13526,2.600378733262201
36,HARISH CHANDRA ALDA,ST,SINGHBHUM (ST),7150,3,BSP,0,M,JHARKHAND,520155,520155,0,919728,463556,456172,0.7774037541534019,7150,1.374590266362911
47,KRISHNA MARDI,ST,SINGHBHUM (ST),6181,4,NPF,0,M,JHARKHAND,520155,520155,0,919728,463556,456172,0.6720465181010038,6181,1.1882996414530285
31,VIVEKANAND MARDI,ST,SINGHBHUM (ST),4375,5,NLP,0,M,JHARKHAND,520155,520155,0,919728,463556,456172,0.475684115303655,4375,0.8410954427045784
60,SUSHILA KERKETTA,ST,KHUNTI (ST),218158,4,INC,0,F,JHARKHAND,490772,490772,0,904846,470507,434339,24.109959042754237,218158,44.45200622692411
64,KARIYA MUNDA,ST,KHUNTI (ST),166932,2,BJP,0,M,JHARKHAND,490772,490772,0,904846,470507,434339,18.44866419258084,166932,34.014165437311014
79,NIRAL ENEM HORO,ST,KHUNTI (ST),31924,8,JKP,0,M,JHARKHAND,490772,490772,0,904846,470507,434339,3.528114176334979,31924,6.504853577628715
64,DR RAM DAYAL MUNDA,ST,KHUNTI (ST),21213,3,JD(U),0,M,JHARKHAND,490772,490772,0,904846,470507,434339,2.344376833184873,21213,4.3223737295526234
30,AJIT KIRO,ST,KHUNTI (ST),20627,1,BSP,0,M,JHARKHAND,490772,490772,0,904846,470507,434339,2.2796144316270395,20627,4.202970014589259
46,MADAN LAL PAHAN,ST,KHUNTI (ST),11770,11,IND,0,M,JHARKHAND,490772,490772,0,904846,470507,434339,1.3007738333373855,11770,2.398262329554253
33,KARTIK SINGH MUNDA,ST,KHUNTI (ST),6658,5,RSMD,0,M,JHARKHAND,490772,490772,0,904846,470507,434339,0.7358158183823545,6658,1.3566381130137823
31,DEVI DAYAL MUNDA,ST,KHUNTI (ST),3931,7,LJNSP,0,M,JHARKHAND,490772,490772,0,904846,470507,434339,0.43443856744683623,3931,0.8009829411620875
65,KHRIST ANAD TOPNO,ST,KHUNTI (ST),3682,10,IND,0,M,JHARKHAND,490772,490772,0,904846,470507,434339,0.40692007258693746,3682,0.7502465503329449
40,NITA SINHA,ST,KHUNTI (ST),3101,9,AD,0,F,JHARKHAND,490772,490772,0,904846,470507,434339,0.3427102512471736,3101,0.6318616383982787
36,KAILASH MUNDA,ST,KHUNTI (ST),2776,6,SP,0,M,JHARKHAND,490772,490772,0,904846,470507,434339,0.30679253707260684,2776,0.5656394415329318
57,RAMESHWAR ORAON,ST,LOHARDAGA (ST),223913,3,INC,7,M,JHARKHAND,466464,466400,64,906666,468653,438013,24.697076983144843,223920,48.00370446593949
54,DUKHA BHAGAT,ST,LOHARDAGA (ST),133621,1,BJP,44,M,JHARKHAND,466464,466400,64,906666,468653,438013,14.742474075348586,133665,28.65494443301091
35,CHAMRA LINDA,ST,LOHARDAGA (ST),58942,10,IND,5,M,JHARKHAND,466464,466400,64,906666,468653,438013,6.501512133464804,58947,12.636988063387527
64,SUKHDEO LOHRA,ST,LOHARDAGA (ST),9691,13,IND,0,M,JHARKHAND,466464,466400,64,906666,468653,438013,1.0688610800449119,9691,2.0775451053028746
25,BHUPENDRA NATH RAM,ST,LOHARDAGA (ST),7122,2,BSP,0,M,JHARKHAND,466464,466400,64,906666,468653,438013,0.7855152834671203,7122,1.5268059271455032
42,VINOD BHAGAT,ST,LOHARDAGA (ST),6528,7,JKP,1,M,JHARKHAND,466464,466400,64,906666,468653,438013,0.7201108236108997,6529,1.3996792892913494
60,CHINA MINJ,ST,LOHARDAGA (ST),6002,4,ABLTASJM,1,M,JHARKHAND,466464,466400,64,906666,468653,438013,0.6620960750706434,6003,1.2869160321053714
38,BHUNESWAR LOHRA,ST,LOHARDAGA (ST),4860,12,IND,1,M,JHARKHAND,466464,466400,64,906666,468653,438013,0.5361401001030148,4861,1.0420954242985525
51,LAXMAN ORAON,ST,LOHARDAGA (ST),3985,6,AJSU,3,M,JHARKHAND,466464,466400,64,906666,468653,438013,0.4398532645979887,3988,0.85494271798038
32,PUNAM XALXO,ST,LOHARDAGA (ST),3985,11,IND,2,F,JHARKHAND,466464,466400,64,906666,468653,438013,0.4397429703992429,3987,0.854728339164437
38,AMIT KUMAR BHAGAT,ST,LOHARDAGA (ST),2783,9,IND,0,M,JHARKHAND,466464,466400,64,906666,468653,438013,0.30694875510937875,2783,0.596616244769157
28,AMROO ORAON,ST,LOHARDAGA (ST),2510,8,IND,0,M,JHARKHAND,466464,466400,64,906666,468653,438013,0.27683843885179327,2510,0.5380908280167387
38,MANGRA ORAON,ST,LOHARDAGA (ST),2458,5,AD,0,M,JHARKHAND,466464,466400,64,906666,468653,438013,0.2711031405170151,2458,0.5269431295877066
35,MANOJ KUMAR,SC,PALAMAU (SC),206731,3,RJD,2,M,JHARKHAND,641543,641524,19,1289313,678391,610922,16.034353178785913,206733,32.22434037936662
46,BRAJ MOHAN RAM,SC,PALAMAU (SC),151573,2,BJP,16,M,JHARKHAND,641543,641524,19,1289313,678391,610922,11.757346742024628,151589,23.62881365707365
46,RADHA KRISHN KISHORE,SC,PALAMAU (SC),106725,4,JD(U),0,M,JHARKHAND,641543,641524,19,1289313,678391,610922,8.277664151373639,106725,16.635673680485954
27,JITENDRA KUMAR,SC,PALAMAU (SC),60907,1,BSP,0,M,JHARKHAND,641543,641524,19,1289313,678391,610922,4.723988666832646,60907,9.493829719909655
34,VIJAY KUMAR,SC,PALAMAU (SC),53998,5,INC,0,M,JHARKHAND,641543,641524,19,1289313,678391,610922,4.188121891270778,53998,8.416894892470186
36,RABINDRA BHUIYAN,SC,PALAMAU (SC),16837,9,CPI(ML)(L),0,M,JHARKHAND,641543,641524,19,1289313,678391,610922,1.305889260404572,16837,2.6244538557820754
57,SURESH MANJHI,SC,PALAMAU (SC),11117,14,IND,1,M,JHARKHAND,641543,641524,19,1289313,678391,610922,0.8623197004916572,11118,1.7330093228357257
53,SHRIHARI NAG,SC,PALAMAU (SC),6385,6,SAP,0,M,JHARKHAND,641543,641524,19,1289313,678391,610922,0.49522497640216145,6385,0.9952567481836758
33,GYANTI DEVI,SC,PALAMAU (SC),5699,12,IND,0,F,JHARKHAND,641543,641524,19,1289313,678391,610922,0.4420183462045291,5699,0.8883270490052888
73,KANHAI RAM,SC,PALAMAU (SC),5501,7,JKP,0,M,JHARKHAND,641543,641524,19,1289313,678391,610922,0.42666133049150984,5501,0.8574639579887864
45,MITHILESH PASWAN,SC,PALAMAU (SC),4391,8,LJNSP,0,M,JHARKHAND,641543,641524,19,1289313,678391,610922,0.34056896967609884,4391,0.6844435992599094
38,BHOLA RAM,SC,PALAMAU (SC),4233,13,IND,0,M,JHARKHAND,641543,641524,19,1289313,678391,610922,0.32831438137985114,4233,0.6598154761255286
39,SURESH KUMAR,SC,PALAMAU (SC),4161,11,SP,0,M,JHARKHAND,641543,641524,19,1289313,678391,610922,0.32273001202966234,4161,0.6485925339377095
63,RAMDEO RAM,SC,PALAMAU (SC),3266,10,SHS,0,M,JHARKHAND,641543,641524,19,1289313,678391,610922,0.2533131985793985,3266,0.5090851275752366
60,BHUBNESHWAR PRASAD MEHTA,GEN,HAZARIBAGH,356058,1,CPI,0,M,JHARKHAND,705439,705438,1,1180058,636492,543566,30.172923703750154,356058,50.47325140798849
60,YASHWANT SINHA,GEN,HAZARIBAGH,250729,2,BJP,1,M,JHARKHAND,705439,705438,1,1180058,636492,543566,21.24726072786253,250730,35.54240692675057
35,CHANDRA PRAKASH CHOUDHARY,GEN,HAZARIBAGH,36710,4,AJSU,0,M,JHARKHAND,705439,705438,1,1180058,636492,543566,3.110864042275888,36710,5.2038517859092
42,HEERA GOPE,GEN,HAZARIBAGH,14563,7,CPI(ML)(L),0,M,JHARKHAND,705439,705438,1,1180058,636492,543566,1.2340918836192796,14563,2.0643882745354314
43,SNEHLATA DEVI,SC,HAZARIBAGH,11223,13,IND,0,F,JHARKHAND,705439,705438,1,1180058,636492,543566,0.9510549481466166,11223,1.5909242329953406
30,SHYAM BIHARI PRAJAPATI,GEN,HAZARIBAGH,10090,3,BSP,0,M,JHARKHAND,705439,705438,1,1180058,636492,543566,0.855042718239273,10090,1.4303150236944653
68,MAHABIR LAL BISHWAKARMA,GEN,HAZARIBAGH,10056,11,IND,0,M,JHARKHAND,705439,705438,1,1180058,636492,543566,0.8521615039260781,10056,1.4254953298584288
45,SUSHIL KUMAR SINGH,GEN,HAZARIBAGH,3838,14,IND,0,M,JHARKHAND,705439,705438,1,1180058,636492,543566,0.325238251001222,3838,0.5440583806679244
40,ARVIND KUMAR,SC,HAZARIBAGH,2508,8,IND,0,M,JHARKHAND,705439,705438,1,1180058,636492,543566,0.2125319263968381,2508,0.3555232982582477
33,MUKESH KUMAR,GEN,HAZARIBAGH,2502,5,LJNSP,0,M,JHARKHAND,705439,705438,1,1180058,636492,543566,0.21202347681215666,2502,0.35467276405188825
41,PRASHANT SAHAY,GEN,HAZARIBAGH,2425,10,IND,0,M,JHARKHAND,705439,705438,1,1180058,636492,543566,0.205498373808745,2425,0.3437575750702754
35,MAHENDRA RAM,SC,HAZARIBAGH,1797,12,IND,0,M,JHARKHAND,705439,705438,1,1180058,636492,543566,0.15228065061208856,1797,0.25473499480465356
38,VIJAY PRAKASH,GEN,HAZARIBAGH,1533,6,SP,0,M,JHARKHAND,705439,705438,1,1180058,636492,543566,0.1299088688861056,1533,0.217311489724838
37,NIRANJAN MAHTO,GEN,HAZARIBAGH,1406,9,IND,0,M,JHARKHAND,705439,705438,1,1180058,636492,543566,0.11914668601034864,1406,0.19930851569022978
84,MANABENDRA SHAH,GEN,TEHRI GARHWAL,267241,2,BJP,154,M,UTTARANCHAL,561428,561210,218,1292454,665321,627133,20.68893747862593,267395,47.62765661848002
56,VIJAY BAHUGUNA,GEN,TEHRI GARHWAL,249903,3,INC,46,M,UTTARANCHAL,561428,561210,218,1292454,665321,627133,19.339102204024282,249949,44.520223430252855
44,HUSAIN AHMED,GEN,TEHRI GARHWAL,11996,4,SP,1,M,UTTARANCHAL,561428,561210,218,1292454,665321,627133,0.9282341963427712,11997,2.136872403941378
50,TRIVENDRA SINGH,GEN,TEHRI GARHWAL,8296,1,UKKD,8,M,UTTARANCHAL,561428,561210,218,1292454,665321,627133,0.642498688541333,8304,1.4790854748961575
43,GYANENDERA SINGH NEGI,GEN,TEHRI GARHWAL,6803,12,IND,2,M,UTTARANCHAL,561428,561210,218,1292454,665321,627133,0.5265177716189512,6805,1.2120877476720078
30,DR BINOD KUMAR,GEN,TEHRI GARHWAL,5195,11,IND,0,M,UTTARANCHAL,561428,561210,218,1292454,665321,627133,0.4019485413020502,5195,0.9253190079582777
34,MAHABEER SINGH,GEN,TEHRI GARHWAL,4056,10,IND,0,M,UTTARANCHAL,561428,561210,218,1292454,665321,627133,0.3138216137672985,4056,0.7224434834030365
36,CHANDAR SINGH,GEN,TEHRI GARHWAL,1833,9,IND,1,M,UTTARANCHAL,561428,561210,218,1292454,665321,627133,0.1419006014914264,1834,0.32666699915216196
29,PREMA UPRETI,GEN,TEHRI GARHWAL,1735,5,RLD,6,F,UTTARANCHAL,561428,561210,218,1292454,665321,627133,0.13470498756628863,1741,0.31010209679602724
39,RAMGOPAL NAUTIYAL,GEN,TEHRI GARHWAL,1444,6,ABHM,0,M,UTTARANCHAL,561428,561210,218,1292454,665321,627133,0.11172544632149384,1444,0.2572012795941777
33,SUNDEYSHWAR KUMAR SAHNI,GEN,TEHRI GARHWAL,1416,7,SAP,0,M,UTTARANCHAL,561428,561210,218,1292454,665321,627133,0.10955902492467817,1416,0.2522139971643737
56,GAJANAND GIRI,GEN,TEHRI GARHWAL,1292,8,IND,0,M,UTTARANCHAL,561428,561210,218,1292454,665321,627133,0.0999648730244945,1292,0.23012746068952744
69,MAJ GEN ( RETD) BHUWAN CHANDRA,GEN,GARHWAL,254722,3,BJP,3004,M,UTTARANCHAL,503240,499546,3694,1081299,530181,551118,23.834850490012478,257726,51.21333757253
64,LT GENERAL ( RETD ) TEJ PAL SINGH RAWAT,GEN,GARHWAL,206270,1,INC,494,M,UTTARANCHAL,503240,499546,3694,1081299,530181,551118,19.12181552003655,206764,41.08655909705111
60,PROFESSOR BIRENDRA SINGH SEMWAL,GEN,GARHWAL,10365,2,BSP,45,M,UTTARANCHAL,503240,499546,3694,1081299,530181,551118,0.9627309375112713,10410,2.068595501152531
32,SANJAY GOYAL,GEN,GARHWAL,7623,9,IND,22,M,UTTARANCHAL,503240,499546,3694,1081299,530181,551118,0.7070199824470382,7645,1.519155869962642
28,MAHESH NEGI,GEN,GARHWAL,6364,4,SP,51,M,UTTARANCHAL,503240,499546,3694,1081299,530181,551118,0.5932679120206344,6415,1.274739686829346
69,RAM DAYAL,SC,GARHWAL,5123,7,IND,15,M,UTTARANCHAL,503240,499546,3694,1081299,530181,551118,0.47516921776492904,5138,1.0209840235275416
63,VIJAI RAWAT,GEN,GARHWAL,4330,5,CPM,30,M,UTTARANCHAL,503240,499546,3694,1081299,530181,551118,0.4032187211862769,4360,0.8663858198871314
40,VIRENDRA SINGH ' GHAVARI',GEN,GARHWAL,2826,8,IND,14,M,UTTARANCHAL,503240,499546,3694,1081299,530181,551118,0.26264705691950146,2840,0.5643430569907002
59,DEVENDRA BAHUGUNA,GEN,GARHWAL,1923,6,RLD,19,M,UTTARANCHAL,503240,499546,3694,1081299,530181,551118,0.17959879737241966,1942,0.38589937206899294
54,BACHI SINGH RAWAT,GEN,ALMORA,225431,3,BJP,311,M,UTTARANCHAL,505223,504756,467,1012756,481969,530787,22.289870413011624,225742,44.681655427405325
44,RENUKA RAWAT,GEN,ALMORA,215568,4,INC,122,F,UTTARANCHAL,505223,504756,467,1012756,481969,530787,21.29733124266852,215690,42.69203896101325
48,KASHI SINGH AIRY,GEN,ALMORA,27311,1,UKKD,29,M,UTTARANCHAL,505223,504756,467,1012756,481969,530787,2.699564357061326,27340,5.411471765933063
38,GULJAR KHAN,GEN,ALMORA,8681,5,RSBP,0,M,UTTARANCHAL,505223,504756,467,1012756,481969,530787,0.8571659906236052,8681,1.7182511485027405
51,RADHA DEVI,SC,ALMORA,8038,9,IND,0,F,UTTARANCHAL,505223,504756,467,1012756,481969,530787,0.793675870594694,8038,1.5909806164802471
43,PURUSHOTTAM SHARMA,GEN,ALMORA,5820,6,CPI(ML)(L),0,M,UTTARANCHAL,505223,504756,467,1012756,481969,530787,0.5746695156582632,5820,1.1519665573420055
38,KAUSTUBHANAND,GEN,ALMORA,5527,7,IND,1,M,UTTARANCHAL,505223,504756,467,1012756,481969,530787,0.5458372994087421,5528,1.0941702970767364
42,CHANDRA SINGH BISHT,GEN,ALMORA,4646,2,SP,4,M,UTTARANCHAL,505223,504756,467,1012756,481969,530787,0.45914316972696284,4650,0.920385651484592
52,RATAN RAM,SC,ALMORA,3734,8,IND,0,M,UTTARANCHAL,505223,504756,467,1012756,481969,530787,0.3686969023140816,3734,0.7390795747620358
58,K C SINGH BABA,GEN,NAINITAL,275633,1,INC,25,M,UTTARANCHAL,616628,616560,68,1261688,667409,594279,21.848349195680708,275658,44.70410036521209
52,VIJAY BANSAL,GEN,NAINITAL,226435,4,BJP,39,M,UTTARANCHAL,616628,616560,68,1261688,667409,594279,17.950079575933195,226474,36.7278164468691
48,SYED GULAM HASNAIN,GEN,NAINITAL,50803,5,BSP,0,M,UTTARANCHAL,616628,616560,68,1261688,667409,594279,4.026589774968138,50803,8.238840921917266
33,RAJESH SHUKLA,GEN,NAINITAL,31690,3,SP,2,M,UTTARANCHAL,616628,616560,68,1261688,667409,594279,2.511872982861056,31692,5.139565507891305
53,HARI LAL,SC,NAINITAL,8182,15,IND,0,M,UTTARANCHAL,616628,616560,68,1261688,667409,594279,0.6484963001946598,8182,1.3268940106514786
35,BHUWAN CHANDRA JOSHI,GEN,NAINITAL,5271,2,UKKD,2,M,UTTARANCHAL,616628,616560,68,1261688,667409,594279,0.41793216706507474,5273,0.855134700337967
34,KUMARI BHAWANA PANDEY,GEN,NAINITAL,3506,13,IND,0,F,UTTARANCHAL,616628,616560,68,1261688,667409,594279,0.2778816949990806,3506,0.5685761918044591
48,CH VIJAY PAL SINGH,GEN,NAINITAL,2963,14,IND,0,M,UTTARANCHAL,616628,616560,68,1261688,667409,594279,0.23484411360019278,2963,0.48051661617701436
28,BHAWAN SINGH BISHT,GEN,NAINITAL,2336,12,IND,0,M,UTTARANCHAL,616628,616560,68,1261688,667409,594279,0.18514878480258196,2336,0.3788345647618986
53,BAHADUR SINGH JANGI,GEN,NAINITAL,2292,8,CPI(ML)(L),0,M,UTTARANCHAL,616628,616560,68,1261688,667409,594279,0.18166139330801276,2292,0.37169898220645187
48,CHANDRA RAWAL,GEN,NAINITAL,2055,6,BKLJP,0,F,UTTARANCHAL,616628,616560,68,1261688,667409,594279,0.16287703457590147,2055,0.33326413980552294
44,SHEESH PAL ARYA,SC,NAINITAL,1894,11,IJP,0,M,UTTARANCHAL,616628,616560,68,1261688,667409,594279,0.15011635206168245,1894,0.30715439454582016
32,RUPENDRA NAAGAR,GEN,NAINITAL,1686,9,SHS,0,M,UTTARANCHAL,616628,616560,68,1261688,667409,594279,0.1336305013600827,1686,0.27342254973825386
30,ZAHEER A ANSARI,GEN,NAINITAL,978,7,JP,0,M,UTTARANCHAL,616628,616560,68,1261688,667409,594279,0.07751520185656043,978,0.15860453952788392
43,CHAUDHARY SHYAM SINGH ADVOCATE,GEN,NAINITAL,836,10,RSBP,0,M,UTTARANCHAL,616628,616560,68,1261688,667409,594279,0.06626043839681443,836,0.1355760685534877
46,RAJENDRA KUMAR,SC,HARDWAR (SC),157331,4,SP,0,M,UTTARANCHAL,486352,486341,11,914440,493324,421116,17.20517475176064,157331,32.349203868802846
54,DR BHAGWANDASS,SC,HARDWAR (SC),119669,3,BSP,3,M,UTTARANCHAL,486352,486341,11,914440,493324,421116,13.08691658282665,119672,24.606046649340396
58,HARPAL SINGH SATHI,SC,HARDWAR (SC),117973,5,BJP,6,M,UTTARANCHAL,486352,486341,11,914440,493324,421116,12.901775950308386,117979,24.2579448629799
47,DEEPAK KUMAR,SC,HARDWAR (SC),75999,2,INC,2,M,UTTARANCHAL,486352,486341,11,914440,493324,421116,8.31120685884257,76001,15.626747705365663
43,ROOP CHAND,SC,HARDWAR (SC),5385,6,SHS,0,M,UTTARANCHAL,486352,486341,11,914440,493324,421116,0.5888850006561394,5385,1.1072227522452873
31,VINOD KUMAR,SC,HARDWAR (SC),3983,9,IND,0,M,UTTARANCHAL,486352,486341,11,914440,493324,421116,0.43556712304798567,3983,0.8189541731091885
28,ARVIND,SC,HARDWAR (SC),2982,1,UKKD,0,M,UTTARANCHAL,486352,486341,11,914440,493324,421116,0.32610122041905426,2982,0.6131361647531006
58,BABU RAM,SC,HARDWAR (SC),1531,8,IND,0,M,UTTARANCHAL,486352,486341,11,914440,493324,421116,0.16742487205284107,1531,0.31479257821495543
61,GHASITA,SC,HARDWAR (SC),1488,7,IND,0,M,UTTARANCHAL,486352,486341,11,914440,493324,421116,0.1627225405712786,1488,0.30595124518866995
65,MANORANJAN BHAKTA,GEN,ANDAMAN & NICOBAR ISLANDS,85785,5,INC,9,M,ANDAMAN & NICOBAR ISLANDS,153825,153804,21,337462,185157,152305,25.423306920482897,85794,55.77376889322282
54,BISHNU PADA RAY,GEN,ANDAMAN & NICOBAR ISLANDS,55286,3,BJP,8,M,ANDAMAN & NICOBAR ISLANDS,153825,153804,21,337462,185157,152305,16.385252265440258,55294,35.94604258085487
46,TAPAN KUMAR BEPARI,GEN,ANDAMAN & NICOBAR ISLANDS,4173,2,CPM,2,M,ANDAMAN & NICOBAR ISLANDS,153825,153804,21,337462,185157,152305,1.2371763339279682,4175,2.7141231919388917
40,R S UMA BHARATHY,GEN,ANDAMAN & NICOBAR ISLANDS,2363,1,NCP,1,F,ANDAMAN & NICOBAR ISLANDS,153825,153804,21,337462,185157,152305,0.70052331818101,2364,1.536811311555339
49,N K P NAIR,GEN,ANDAMAN & NICOBAR ISLANDS,1448,6,CPI(ML)(L),0,M,ANDAMAN & NICOBAR ISLANDS,153825,153804,21,337462,185157,152305,0.4290853488689097,1448,0.9413294327970096
28,DEEPAK BISWAS,GEN,ANDAMAN & NICOBAR ISLANDS,1186,12,IND,0,M,ANDAMAN & NICOBAR ISLANDS,153825,153804,21,337462,185157,152305,0.3514469777337893,1186,0.7710060133268325
60,A K BISWAS,GEN,ANDAMAN & NICOBAR ISLANDS,1121,4,BSP,1,M,ANDAMAN & NICOBAR ISLANDS,153825,153804,21,337462,185157,152305,0.3324818794412408,1122,0.7294002925402243
66,DR SHANMUGAM,GEN,ANDAMAN & NICOBAR ISLANDS,691,8,LJNSP,0,M,ANDAMAN & NICOBAR ISLANDS,153825,153804,21,337462,185157,152305,0.20476379562735952,691,0.4492117666179099
37,GOUR CHANDRA MAJUMDER,GEN,ANDAMAN & NICOBAR ISLANDS,543,11,IND,0,M,ANDAMAN & NICOBAR ISLANDS,153825,153804,21,337462,185157,152305,0.16090700582584114,543,0.3529985372988786
50,ASIT BARAN DUTTA,GEN,ANDAMAN & NICOBAR ISLANDS,523,9,IND,0,M,ANDAMAN & NICOBAR ISLANDS,153825,153804,21,337462,185157,152305,0.15498041260941972,523,0.3399967495530635
51,K KALIMUTHU,GEN,ANDAMAN & NICOBAR ISLANDS,387,10,IND,0,M,ANDAMAN & NICOBAR ISLANDS,153825,153804,21,337462,185157,152305,0.11467957873775418,387,0.25158459288152124
65,K PERUMAL,GEN,ANDAMAN & NICOBAR ISLANDS,298,7,SWD,0,M,ANDAMAN & NICOBAR ISLANDS,153825,153804,21,337462,185157,152305,0.08830623892467893,298,0.19372663741264426
55,PAWAN KUMAR BANSAL,GEN,CHANDIGARH,139873,1,INC,7,M,CHANDIGARH,268670,268639,31,527684,292438,235246,26.50828905178099,139880,52.063870175308004
51,SATYA PAL JAIN,GEN,CHANDIGARH,94610,2,BJP,22,M,CHANDIGARH,268670,268639,31,527684,292438,235246,17.93346017692407,94632,35.22239178173968
64,HARMOHAN DHAWAN,GEN,CHANDIGARH,17760,7,INLD,2,M,CHANDIGARH,268670,268639,31,527684,292438,235246,3.3660296692717613,17762,6.611084229724197
45,HEM RAJ,GEN,CHANDIGARH,6203,3,BSP,0,M,CHANDIGARH,268670,268639,31,527684,292438,235246,1.175514133458661,6203,2.3087802880857557
34,SURINDER PAL,GEN,CHANDIGARH,3187,17,IND,0,M,CHANDIGARH,268670,268639,31,527684,292438,235246,0.603959945725093,3187,1.1862135705512338
54,RAJINDER BANSAL,GEN,CHANDIGARH,2045,16,IND,0,M,CHANDIGARH,268670,268639,31,527684,292438,235246,0.38754254440157365,2045,0.7611568094688652
47,DHARAM PAUL SHARMA,GEN,CHANDIGARH,1232,12,IND,0,M,CHANDIGARH,268670,268639,31,527684,292438,235246,0.23347306342432214,1232,0.458555104775375
43,ARVIND JAIN,GEN,CHANDIGARH,718,8,IND,0,M,CHANDIGARH,268670,268639,31,527684,292438,235246,0.13606628209307084,718,0.2672423419064279
37,VINAY KUMAR,GEN,CHANDIGARH,515,6,BSJM,0,M,CHANDIGARH,268670,268639,31,527684,292438,235246,0.09759628868792686,515,0.19168496668775822
35,MUKESH KUMAR,SC,CHANDIGARH,488,14,IND,0,M,CHANDIGARH,268670,268639,31,527684,292438,235246,0.09247959005768605,488,0.18163546357985633
49,REKHA SHARMA,GEN,CHANDIGARH,481,15,IND,0,F,CHANDIGARH,268670,268639,31,527684,292438,235246,0.09115303856095694,481,0.17903003684817806
42,GHANSHYAM LAL,GEN,CHANDIGARH,376,10,IND,0,M,CHANDIGARH,268670,268639,31,527684,292438,235246,0.07125476611002039,376,0.13994863587300405
72,GURCHARAN SINGH,GEN,CHANDIGARH,312,9,IND,0,M,CHANDIGARH,268670,268639,31,527684,292438,235246,0.059126295282782876,312,0.11612759146908846
53,PUSHPA KUMAR SINGH,GEN,CHANDIGARH,269,4,IJP,0,M,CHANDIGARH,268670,268639,31,527684,292438,235246,0.05097747894573267,269,0.10012282726020769
38,MOHAMMAD IBRAHIM,GEN,CHANDIGARH,213,5,AD,0,M,CHANDIGARH,268670,268639,31,527684,292438,235246,0.04036506697189985,213,0.07927941340678156
28,BHUPINDER PAL,GEN,CHANDIGARH,188,13,IND,0,M,CHANDIGARH,268670,268639,31,527684,292438,235246,0.035627383055010196,188,0.06997431793650202
58,DAULAT KULDEEP SINGH,GEN,CHANDIGARH,169,11,IND,0,M,CHANDIGARH,268670,268639,31,527684,292438,235246,0.03202674327817406,169,0.06290244537908958
41,DELKAR MOHANBHAI SANJIBHAI,ST,DADRA & NAGAR HAVELI (ST),34665,6,BNP,0,M,DADRA & NAGAR HAVELI,84703,84699,4,122681,65059,57622,28.256209192947562,34665,40.92535093208033
48,GAVLI SITARAM,ST,DADRA & NAGAR HAVELI (ST),21768,1,INC,4,M,DADRA & NAGAR HAVELI,84703,84699,4,122681,65059,57622,17.746839363878678,21772,25.703930203180526
33,PATEL ANILBHAI,ST,DADRA & NAGAR HAVELI (ST),13178,3,BJP,0,M,DADRA & NAGAR HAVELI,84703,84699,4,122681,65059,57622,10.741679640694159,13178,15.55789051155213
37,PATEL UTTAMBHAI,ST,DADRA & NAGAR HAVELI (ST),5823,7,SHS,0,M,DADRA & NAGAR HAVELI,84703,84699,4,122681,65059,57622,4.746456256470032,5823,6.874608927664899
38,PATEL DHIRUBHAI SUKARBHAI,ST,DADRA & NAGAR HAVELI (ST),3652,10,IND,0,M,DADRA & NAGAR HAVELI,84703,84699,4,122681,65059,57622,2.9768260773876962,3652,4.311535600864196
39,HARISHCHANDRA KHULAT,ST,DADRA & NAGAR HAVELI (ST),1576,5,NCP,0,M,DADRA & NAGAR HAVELI,84703,84699,4,122681,65059,57622,1.2846325021804517,1576,1.8606188682809346
43,AMINBHAI PATEL,ST,DADRA & NAGAR HAVELI (ST),1213,9,IND,0,M,DADRA & NAGAR HAVELI,84703,84699,4,122681,65059,57622,0.988743163163,1213,1.4320626187974452
54,GIMBHAL LADAK,ST,DADRA & NAGAR HAVELI (ST),1158,2,CPM,0,M,DADRA & NAGAR HAVELI,84703,84699,4,122681,65059,57622,0.9439114451300527,1158,1.3671298537241892
25,SUMITRA RAMJI PATEL,ST,DADRA & NAGAR HAVELI (ST),941,8,SP,0,F,DADRA & NAGAR HAVELI,84703,84699,4,122681,65059,57622,0.7670299394364245,941,1.1109405806169794
26,PATEL GANESH,ST,DADRA & NAGAR HAVELI (ST),725,4,BSP,0,M,DADRA & NAGAR HAVELI,84703,84699,4,122681,65059,57622,0.59096355588885,725,0.8559319032383741
58,PATEL DAHYABHAI VALLABHBHAI,GEN,DAMAN AND DIU,27522,3,INC,1,M,DAMAN & DIU,55591,55590,1,79232,39595,39637,34.73722738287561,27523,49.50981273947222
51,GOPAL K TANDEL,GEN,DAMAN AND DIU,26916,1,BJP,0,M,DAMAN & DIU,55591,55590,1,79232,39595,39637,33.97112277867528,26916,48.4179093738195
28,DHODI DHIRU RANCHHOD,ST,DAMAN AND DIU,1152,2,BSP,0,M,DAMAN & DIU,55591,55590,1,79232,39595,39637,1.4539579967689822,1152,2.0722778867082803
40,AJAY MAKAN,GEN,NEW DELHI,105409,1,INC,6,M,NATIONAL CAPITAL TERRITORY OF DELHI,202557,202543,14,471813,261805,210008,22.34253825138349,105415,52.04214122444546
76,JAGMOHAN,GEN,NEW DELHI,92623,2,BJP,8,M,NATIONAL CAPITAL TERRITORY OF DELHI,202557,202543,14,471813,261805,210008,19.632990188909588,92631,45.730831321553936
55,VIKRAM,GEN,NEW DELHI,1983,3,BSP,0,M,NATIONAL CAPITAL TERRITORY OF DELHI,202557,202543,14,471813,261805,210008,0.42029363328267766,1983,0.9789836934788725
25,SANJAY KUMAR YADAV,GEN,NEW DELHI,680,15,IND,0,M,NATIONAL CAPITAL TERRITORY OF DELHI,202557,202543,14,471813,261805,210008,0.14412489694010125,680,0.3357079735580602
38,JAVED ABIDI,GEN,NEW DELHI,397,8,IND,0,M,NATIONAL CAPITAL TERRITORY OF DELHI,202557,202543,14,471813,261805,210008,0.08414350600767677,397,0.1959942139743381
46,RAMESH KUMAR,GEN,NEW DELHI,272,11,IND,0,M,NATIONAL CAPITAL TERRITORY OF DELHI,202557,202543,14,471813,261805,210008,0.05764995877604051,272,0.1342831894232241
46,VED PRAKASH,SC,NEW DELHI,222,14,IND,0,M,NATIONAL CAPITAL TERRITORY OF DELHI,202557,202543,14,471813,261805,210008,0.04705253988338601,222,0.10959877960277847
44,B S YADAV,GEN,NEW DELHI,177,5,JKNPP,0,M,NATIONAL CAPITAL TERRITORY OF DELHI,202557,202543,14,471813,261805,210008,0.037514862879996946,177,0.08738281076437743
41,RAM KUMAR AZAD,SC,NEW DELHI,146,13,IND,0,M,NATIONAL CAPITAL TERRITORY OF DELHI,202557,202543,14,471813,261805,210008,0.030944463166551153,146,0.07207847667570116
60,DR NINA DEY GUPTA,GEN,NEW DELHI,125,9,IND,0,F,NATIONAL CAPITAL TERRITORY OF DELHI,202557,202543,14,471813,261805,210008,0.02649354723163626,125,0.06171102455111401
54,MAHARAJ KUMAR ADVOCATE,GEN,NEW DELHI,125,4,DBP,0,M,NATIONAL CAPITAL TERRITORY OF DELHI,202557,202543,14,471813,261805,210008,0.02649354723163626,125,0.06171102455111401
34,VIMLA JOSHI,GEN,NEW DELHI,107,6,ABHM,0,F,NATIONAL CAPITAL TERRITORY OF DELHI,202557,202543,14,471813,261805,210008,0.02267847643028064,107,0.052824637015753594
51,RAMESH CHAND,SC,NEW DELHI,105,12,IND,0,M,NATIONAL CAPITAL TERRITORY OF DELHI,202557,202543,14,471813,261805,210008,0.02225457967457446,105,0.05183726062293576
43,MOHD ISLAM,GEN,NEW DELHI,93,10,IND,0,M,NATIONAL CAPITAL TERRITORY OF DELHI,202557,202543,14,471813,261805,210008,0.01971119914033738,93,0.045913002266028825
37,UMESH GULATI,GEN,NEW DELHI,79,7,IND,0,M,NATIONAL CAPITAL TERRITORY OF DELHI,202557,202543,14,471813,261805,210008,0.016743921850394118,79,0.03900136751630405
72,VIJAY KUMAR MALHOTRA,GEN,SOUTH DELHI,240651,2,BJP,3,M,NATIONAL CAPITAL TERRITORY OF DELHI,478876,478871,5,394428,197817,196611,61.01341689738051,240654,50.25392794794477
61,R K ANAND,GEN,SOUTH DELHI,224647,1,INC,2,M,NATIONAL CAPITAL TERRITORY OF DELHI,478876,478871,5,394428,197817,196611,56.95564209437464,224649,46.911726626517094
54,SHIV KHERA,GEN,SOUTH DELHI,4832,12,IND,0,M,NATIONAL CAPITAL TERRITORY OF DELHI,478876,478871,5,394428,197817,196611,1.225065157646009,4832,1.0090294773594835
45,SURJEET SINGH ASSIE (BILLA),GEN,SOUTH DELHI,4100,3,BSP,0,M,NATIONAL CAPITAL TERRITORY OF DELHI,478876,478871,5,394428,197817,196611,1.0394799557840722,4100,0.8561715350111512
31,SYED NASEER AHMED,GEN,SOUTH DELHI,1163,16,IND,0,M,NATIONAL CAPITAL TERRITORY OF DELHI,478876,478871,5,394428,197817,196611,0.2948573630675307,1163,0.24286036468730948
40,SAIFULLAH SIDDIQUI ALIAS SHAFI,GEN,SOUTH DELHI,817,15,IND,0,M,NATIONAL CAPITAL TERRITORY OF DELHI,478876,478871,5,394428,197817,196611,0.20713539606721632,817,0.17060784002539278
41,R RAVICHANDRAN,GEN,SOUTH DELHI,449,4,JKNPP,0,M,NATIONAL CAPITAL TERRITORY OF DELHI,478876,478871,5,394428,197817,196611,0.11383573174318254,449,0.09376122420000167
34,SUMITRA KUNDU,GEN,SOUTH DELHI,412,14,IND,0,F,NATIONAL CAPITAL TERRITORY OF DELHI,478876,478871,5,394428,197817,196611,0.1044550589714726,412,0.08603479815234007
36,KALPANA CHOWDHURY,GEN,SOUTH DELHI,372,5,IND,0,F,NATIONAL CAPITAL TERRITORY OF DELHI,478876,478871,5,394428,197817,196611,0.0943137911101646,372,0.07768190512784104
45,SATBIR CHANDELIA,SC,SOUTH DELHI,344,13,IND,0,M,NATIONAL CAPITAL TERRITORY OF DELHI,478876,478871,5,394428,197817,196611,0.08721490360724897,344,0.07183488001069172
71,COLONEL ( DR ) M P DHIR,GEN,SOUTH DELHI,277,9,IND,0,M,NATIONAL CAPITAL TERRITORY OF DELHI,478876,478871,5,394428,197817,196611,0.07022827993955805,277,0.057843784194655815
58,DINESH JAIN,GEN,SOUTH DELHI,206,8,IND,0,M,NATIONAL CAPITAL TERRITORY OF DELHI,478876,478871,5,394428,197817,196611,0.0522275294857363,206,0.04301739907617003
48,DR JANICE DARBARI,GEN,SOUTH DELHI,182,7,IND,0,F,NATIONAL CAPITAL TERRITORY OF DELHI,478876,478871,5,394428,197817,196611,0.04614276876895149,182,0.03800566326147061
28,JAI KISHAN BALGUHAR,GEN,SOUTH DELHI,157,6,IND,0,M,NATIONAL CAPITAL TERRITORY OF DELHI,478876,478871,5,394428,197817,196611,0.03980447635563398,157,0.03278510512115872
31,MAHINDER PAL SINGH TOKAS,GEN,SOUTH DELHI,153,10,IND,0,M,NATIONAL CAPITAL TERRITORY OF DELHI,478876,478871,5,394428,197817,196611,0.038790349569503176,153,0.03194981581870881
30,RAJIV HARJAI,GEN,SOUTH DELHI,109,11,IND,0,M,NATIONAL CAPITAL TERRITORY OF DELHI,478876,478871,5,394428,197817,196611,0.02763495492206436,109,0.022761633491759872
58,SAJJAN KUMAR,GEN,OUTER DELHI,855541,2,INC,2,M,NATIONAL CAPITAL TERRITORY OF DELHI,1553849,1553828,21,505236,291952,213284,169.33532052347812,855543,55.05959716806459
61,SAHIB SINGH,GEN,OUTER DELHI,631734,3,BJP,19,M,NATIONAL CAPITAL TERRITORY OF DELHI,1553849,1553828,21,505236,291952,213284,125.04116887949395,631753,40.657296815842464
34,BHARAT BHUSHAN NAGAR,GEN,OUTER DELHI,33495,1,BSP,0,M,NATIONAL CAPITAL TERRITORY OF DELHI,1553849,1553828,21,505236,291952,213284,6.629575089661069,33495,2.1556148634777252
26,SAJJAN KUMAR,GEN,OUTER DELHI,4052,25,IND,0,M,NATIONAL CAPITAL TERRITORY OF DELHI,1553849,1553828,21,505236,291952,213284,0.8020014409107823,4052,0.26077179957640667
41,AMARJEET KAUR,GEN,OUTER DELHI,3772,18,IND,0,F,NATIONAL CAPITAL TERRITORY OF DELHI,1553849,1553828,21,505236,291952,213284,0.7465817954381715,3772,0.24275203060271622
35,ANIL BHARTI,GEN,OUTER DELHI,3737,4,RVNP,0,M,NATIONAL CAPITAL TERRITORY OF DELHI,1553849,1553828,21,505236,291952,213284,0.7396543397540951,3737,0.2404995594810049
34,SWATI BHATNAGAR,GEN,OUTER DELHI,2644,16,RSD,0,F,NATIONAL CAPITAL TERRITORY OF DELHI,1553849,1553828,21,505236,291952,213284,0.5233197951056536,2644,0.1701581041658488
35,KEWAL KISHAN VIRMANI,GEN,OUTER DELHI,2312,19,IND,0,M,NATIONAL CAPITAL TERRITORY OF DELHI,1553849,1553828,21,505236,291952,213284,0.45760792975955794,2312,0.14879180666847294
32,ANIL GOGIA,GEN,OUTER DELHI,1717,17,IND,0,M,NATIONAL CAPITAL TERRITORY OF DELHI,1553849,1553828,21,505236,291952,213284,0.3398411831302599,1717,0.11049979759938063
33,HAFIZ ALI,GEN,OUTER DELHI,1644,28,IND,0,M,NATIONAL CAPITAL TERRITORY OF DELHI,1553849,1553828,21,505236,291952,213284,0.32539248984632924,1644,0.10580178640266846
50,SUSHMA,GEN,OUTER DELHI,1459,15,HM,0,F,NATIONAL CAPITAL TERRITORY OF DELHI,1553849,1553828,21,505236,291952,213284,0.28877593837335425,1459,0.09389586761648011
26,MOHD SALIM QURESHI,GEN,OUTER DELHI,1042,14,RPI(A),0,M,NATIONAL CAPITAL TERRITORY OF DELHI,1553849,1553828,21,505236,291952,213284,0.20624025208021596,1042,0.06705928310923391
53,SURINDER MOHAN,GEN,OUTER DELHI,966,27,IND,0,M,NATIONAL CAPITAL TERRITORY OF DELHI,1553849,1553828,21,505236,291952,213284,0.19119777688050732,966,0.0621682029592322
38,VIJAY KUMAR,GEN,OUTER DELHI,942,13,JP,0,M,NATIONAL CAPITAL TERRITORY OF DELHI,1553849,1553828,21,505236,291952,213284,0.18644752155428354,942,0.06062365133291587
52,SUNIL ANAND,GEN,OUTER DELHI,867,26,IND,0,M,NATIONAL CAPITAL TERRITORY OF DELHI,1553849,1553828,21,505236,291952,213284,0.17160297365983423,867,0.05579692750067735
56,ABDUL MAJID,GEN,OUTER DELHI,833,5,JHP,0,M,NATIONAL CAPITAL TERRITORY OF DELHI,1553849,1553828,21,505236,291952,213284,0.1648734452810172,833,0.053608812696729215
36,RAJESH SHARMA,GEN,OUTER DELHI,795,22,IND,0,M,NATIONAL CAPITAL TERRITORY OF DELHI,1553849,1553828,21,505236,291952,213284,0.15735220768116287,795,0.05116327262172836
53,MAHINDER SINGH BHAMRAH,GEN,OUTER DELHI,771,10,BGTD,0,M,NATIONAL CAPITAL TERRITORY OF DELHI,1553849,1553828,21,505236,291952,213284,0.15260195235493906,771,0.04961872099541204
60,JALIM,GEN,OUTER DELHI,679,9,LP(S),0,M,NATIONAL CAPITAL TERRITORY OF DELHI,1553849,1553828,21,505236,291952,213284,0.13439264027108125,679,0.04369793976119945
45,RAM KUMAR DABRIWAL,SC,OUTER DELHI,609,23,IND,0,M,NATIONAL CAPITAL TERRITORY OF DELHI,1553849,1553828,21,505236,291952,213284,0.12053772890292855,609,0.03919299751777682
59,RAJPAL SHARMA,GEN,OUTER DELHI,552,11,MJM,0,M,NATIONAL CAPITAL TERRITORY OF DELHI,1553849,1553828,21,505236,291952,213284,0.10925587250314704,552,0.03552468740527554
45,RAM AWADH,SC,OUTER DELHI,547,12,RSBP,0,M,NATIONAL CAPITAL TERRITORY OF DELHI,1553849,1553828,21,505236,291952,213284,0.10826623597685041,547,0.03520290581645964
28,RAGHVINDER BAKSHI,GEN,OUTER DELHI,545,21,IND,0,M,NATIONAL CAPITAL TERRITORY OF DELHI,1553849,1553828,21,505236,291952,213284,0.10787038136633179,545,0.035074193180933286
45,RAM JATAN,GEN,OUTER DELHI,539,24,IND,0,M,NATIONAL CAPITAL TERRITORY OF DELHI,1553849,1553828,21,505236,291952,213284,0.10668281753477583,539,0.0346880552743542
47,KIRAN SINGH,GEN,OUTER DELHI,534,6,RVP,0,M,NATIONAL CAPITAL TERRITORY OF DELHI,1553849,1553828,21,505236,291952,213284,0.10569318100847921,534,0.034366273685538296
33,KAISAR,GEN,OUTER DELHI,513,7,NBNP,0,F,NATIONAL CAPITAL TERRITORY OF DELHI,1553849,1553828,21,505236,291952,213284,0.10153670759803339,513,0.033014791012511514
29,NAWAB SINGH,GEN,OUTER DELHI,500,20,IND,0,M,NATIONAL CAPITAL TERRITORY OF DELHI,1553849,1553828,21,505236,291952,213284,0.09896365262966218,500,0.03217815888159017
50,JAG MOHAN KALIA,GEN,OUTER DELHI,487,8,RJAP,0,M,NATIONAL CAPITAL TERRITORY OF DELHI,1553849,1553828,21,505236,291952,213284,0.09639059766129096,487,0.03134152675066882
39,SANDEEP DIKSHIT,GEN,EAST DELHI,669526,3,INC,1,M,NATIONAL CAPITAL TERRITORY OF DELHI,1190814,1190803,11,289606,153747,135859,231.18547267667105,669527,56.224313788719314
62,LAL BIHARI TIWARI,GEN,EAST DELHI,439738,2,BJP,10,M,NATIONAL CAPITAL TERRITORY OF DELHI,1190814,1190803,11,289606,153747,135859,151.84353915319434,439748,36.92835321049299
35,BAL RAJ SINGH,GEN,EAST DELHI,50985,1,BSP,0,M,NATIONAL CAPITAL TERRITORY OF DELHI,1190814,1190803,11,289606,153747,135859,17.604952936057956,50985,4.281525074444875
42,ANIL KUMAR SHARMA,GEN,EAST DELHI,4977,4,LPI(V),0,M,NATIONAL CAPITAL TERRITORY OF DELHI,1190814,1190803,11,289606,153747,135859,1.7185417429196908,4977,0.4179494026774962
78,BRAHAMJEET,SC,EAST DELHI,2671,19,IND,0,M,NATIONAL CAPITAL TERRITORY OF DELHI,1190814,1190803,11,289606,153747,135859,0.9222875216673688,2671,0.22430035253196554
39,GOPAL HINDUSTANI,SC,EAST DELHI,2657,17,IND,0,M,NATIONAL CAPITAL TERRITORY OF DELHI,1190814,1190803,11,289606,153747,135859,0.9174533676788464,2657,0.22312468613906117
34,ANIL KUMAR JATAV,SC,EAST DELHI,2528,16,IND,0,M,NATIONAL CAPITAL TERRITORY OF DELHI,1190814,1190803,11,289606,153747,135859,0.8729100916417477,2528,0.21229176009015682
38,PAWAN KUMAR,GEN,EAST DELHI,2460,18,IND,0,M,NATIONAL CAPITAL TERRITORY OF DELHI,1190814,1190803,11,289606,153747,135859,0.8494299151260678,2460,0.20658138046747856
46,MOHD HASNAIN,GEN,EAST DELHI,2005,26,IND,0,M,NATIONAL CAPITAL TERRITORY OF DELHI,1190814,1190803,11,289606,153747,135859,0.6923199104990918,2005,0.1683722226980872
38,HARISH TYAGI,GEN,EAST DELHI,1564,24,IND,0,M,NATIONAL CAPITAL TERRITORY OF DELHI,1190814,1190803,11,289606,153747,135859,0.5400440598606383,1564,0.13133873132160018
34,RAM SAMUJHA,GEN,EAST DELHI,1377,14,AD,0,M,NATIONAL CAPITAL TERRITORY OF DELHI,1190814,1190803,11,289606,153747,135859,0.4754735744425184,1377,0.11563518735923495
48,SATYA RANI SHARMA,GEN,EAST DELHI,1131,15,BRPP,0,F,NATIONAL CAPITAL TERRITORY OF DELHI,1190814,1190803,11,289606,153747,135859,0.39053058292991166,1131,0.09497704931248709
52,AMAR SINGH,GEN,EAST DELHI,1102,5,LP(S),0,M,NATIONAL CAPITAL TERRITORY OF DELHI,1190814,1190803,11,289606,153747,135859,0.3805169782394011,1102,0.09254174035575664
64,ARJUN PRASHAD,SC,EAST DELHI,861,6,RSBP,0,M,NATIONAL CAPITAL TERRITORY OF DELHI,1190814,1190803,11,289606,153747,135859,0.2973004702941237,861,0.0723034831636175
59,R S ADIL,GEN,EAST DELHI,831,8,NLP,0,M,NATIONAL CAPITAL TERRITORY OF DELHI,1190814,1190803,11,289606,153747,135859,0.28694156889014727,831,0.0697841980359653
34,HARENDER KUMAR,GEN,EAST DELHI,788,25,IND,0,M,NATIONAL CAPITAL TERRITORY OF DELHI,1190814,1190803,11,289606,153747,135859,0.2720938102111144,788,0.06617322268633054
36,BHIMA WEL,GEN,EAST DELHI,719,13,PSJP,0,M,NATIONAL CAPITAL TERRITORY OF DELHI,1190814,1190803,11,289606,153747,135859,0.2482683369819686,719,0.060378866892730525
29,MANJIT,GEN,EAST DELHI,672,20,IND,0,M,NATIONAL CAPITAL TERRITORY OF DELHI,1190814,1190803,11,289606,153747,135859,0.23203939144907218,672,0.05643198685940877
37,PRADEEP KUMAR,GEN,EAST DELHI,638,11,AIFB,0,M,NATIONAL CAPITAL TERRITORY OF DELHI,1190814,1190803,11,289606,153747,135859,0.2202993031912322,638,0.05357679704806964
47,P C MOHAN,GEN,EAST DELHI,598,21,IND,0,M,NATIONAL CAPITAL TERRITORY OF DELHI,1190814,1190803,11,289606,153747,135859,0.20648743465259697,598,0.05021775021120006
28,MOHD IQBAL QUERESHI,GEN,EAST DELHI,573,9,BPTP,0,M,NATIONAL CAPITAL TERRITORY OF DELHI,1190814,1190803,11,289606,153747,135859,0.1978550168159499,573,0.04811834593815659
39,NAFEES,GEN,EAST DELHI,556,10,NBNP,0,M,NATIONAL CAPITAL TERRITORY OF DELHI,1190814,1190803,11,289606,153747,135859,0.19198497268702996,556,0.04669075103248702
54,AVINASH PURI,GEN,EAST DELHI,527,7,DBP,0,M,NATIONAL CAPITAL TERRITORY OF DELHI,1190814,1190803,11,289606,153747,135859,0.18197136799651942,527,0.04425544207575658
65,BALWANT SINGH PARWANA,SC,EAST DELHI,490,12,ABHM,0,M,NATIONAL CAPITAL TERRITORY OF DELHI,1190814,1190803,11,289606,153747,135859,0.16919538959828181,490,0.041148323751652234
52,SATISH KUMAR TYAGI,GEN,EAST DELHI,429,23,IND,0,M,NATIONAL CAPITAL TERRITORY OF DELHI,1190814,1190803,11,289606,153747,135859,0.14813229007686304,429,0.03602577732542613
46,RAM SINGH,GEN,EAST DELHI,400,22,IND,0,M,NATIONAL CAPITAL TERRITORY OF DELHI,1190814,1190803,11,289606,153747,135859,0.1381186853863525,400,0.0335904683686957
55,KAPIL SIBAL,GEN,CHANDNI CHOWK,127395,1,INC,1,M,NATIONAL CAPITAL TERRITORY OF DELHI,179007,179003,4,2606589,1482389,1124200,4.887460201819312,127396,71.16816660800974
28,SMRITI Z IRAANI,GEN,CHANDNI CHOWK,47978,3,BJP,3,F,NATIONAL CAPITAL TERRITORY OF DELHI,179007,179003,4,2606589,1482389,1124200,1.840758170927599,47981,26.80397973263615
45,GIAN PRAKASH SAINI,GEN,CHANDNI CHOWK,1444,2,BSP,0,M,NATIONAL CAPITAL TERRITORY OF DELHI,179007,179003,4,2606589,1482389,1124200,0.05539807004479801,1444,0.8066723647678582
32,MOHD SAMI,GEN,CHANDNI CHOWK,660,15,IND,0,M,NATIONAL CAPITAL TERRITORY OF DELHI,179007,179003,4,2606589,1482389,1124200,0.02532044752740075,660,0.3687006653371097
38,ROOP DHAR YADAV,GEN,CHANDNI CHOWK,434,4,SAP,0,M,NATIONAL CAPITAL TERRITORY OF DELHI,179007,179003,4,2606589,1482389,1124200,0.01665011246498777,434,0.24244861932773576
58,BASHIR AHMED,GEN,CHANDNI CHOWK,235,11,IND,0,M,NATIONAL CAPITAL TERRITORY OF DELHI,179007,179003,4,2606589,1482389,1124200,0.009015613892332087,235,0.13127978235487997
44,SATISH KUMAR,SC,CHANDNI CHOWK,168,14,IND,0,M,NATIONAL CAPITAL TERRITORY OF DELHI,179007,179003,4,2606589,1482389,1124200,0.0064452048251565554,168,0.09385107844944611
45,DR SANJAY KUMAR GUPTA,GEN,CHANDNI CHOWK,165,5,SHS,0,M,NATIONAL CAPITAL TERRITORY OF DELHI,179007,179003,4,2606589,1482389,1124200,0.006330111881850188,165,0.09217516633427743
39,ARUN KUMAR,GEN,CHANDNI CHOWK,123,7,IND,0,M,NATIONAL CAPITAL TERRITORY OF DELHI,179007,179003,4,2606589,1482389,1124200,0.004718810675561049,123,0.0687123967219159
41,SHIV HARI AGRAWAL,GEN,CHANDNI CHOWK,111,13,IND,0,M,NATIONAL CAPITAL TERRITORY OF DELHI,179007,179003,4,2606589,1482389,1124200,0.004258438902335581,111,0.06200874826124118
32,ALIM,GEN,CHANDNI CHOWK,96,8,IND,0,M,NATIONAL CAPITAL TERRITORY OF DELHI,179007,179003,4,2606589,1482389,1124200,0.003682974185803746,96,0.05362918768539778
51,MUKESH ARORA,GEN,CHANDNI CHOWK,54,12,IND,0,M,NATIONAL CAPITAL TERRITORY OF DELHI,179007,179003,4,2606589,1482389,1124200,0.002071672979514607,54,0.03016641807303625
31,AMIT WHIG,GEN,CHANDNI CHOWK,49,6,IND,0,M,NATIONAL CAPITAL TERRITORY OF DELHI,179007,179003,4,2606589,1482389,1124200,0.0018798514073373285,49,0.02737323121442178
56,JAGDISH KUMAR DEMBALA,GEN,CHANDNI CHOWK,46,10,IND,0,M,NATIONAL CAPITAL TERRITORY OF DELHI,179007,179003,4,2606589,1482389,1124200,0.0017647584640309616,46,0.025697319099253102
50,ASHOK KUMAR,SC,CHANDNI CHOWK,45,9,IND,0,M,NATIONAL CAPITAL TERRITORY OF DELHI,179007,179003,4,2606589,1482389,1124200,0.0017263941495955057,45,0.02513868172753021
60,JAGDISH TYTLER,GEN,DELHI SADAR,140073,1,INC,0,M,NATIONAL CAPITAL TERRITORY OF DELHI,271544,271542,2,455114,257765,197349,30.777563423669672,140073,51.58390537076865
50,VIJAY GOEL,GEN,DELHI SADAR,124097,3,BJP,2,M,NATIONAL CAPITAL TERRITORY OF DELHI,271544,271542,2,455114,257765,197349,27.267673593868793,124099,45.70124915299178
66,DHARAM PAL,GEN,DELHI SADAR,3628,2,BSP,0,M,NATIONAL CAPITAL TERRITORY OF DELHI,271544,271542,2,455114,257765,197349,0.7971629086338807,3628,1.336063400406564
44,MOHD IMRAN ANSARI,GEN,DELHI SADAR,1074,4,SP,0,M,NATIONAL CAPITAL TERRITORY OF DELHI,271544,271542,2,455114,257765,197349,0.23598483017441785,1074,0.3955160121379961
41,HARI KRISHAN,SC,DELHI SADAR,895,15,IND,0,M,NATIONAL CAPITAL TERRITORY OF DELHI,271544,271542,2,455114,257765,197349,0.1966540251453482,895,0.3295966767816634
34,VIJAY GOEL,GEN,DELHI SADAR,418,13,IND,0,M,NATIONAL CAPITAL TERRITORY OF DELHI,271544,271542,2,455114,257765,197349,0.09184512012374922,418,0.1539345373125534
29,SONI SONKAR,GEN,DELHI SADAR,385,14,IND,0,M,NATIONAL CAPITAL TERRITORY OF DELHI,271544,271542,2,455114,257765,197349,0.08459418958766375,385,0.14178181068261497
47,VIJAY KUMAR GUPTA,GEN,DELHI SADAR,237,12,IND,0,M,NATIONAL CAPITAL TERRITORY OF DELHI,271544,271542,2,455114,257765,197349,0.05207486475915925,237,0.08727867306955779
41,DR RAJESH KUMAR BHATIA,GEN,DELHI SADAR,138,7,AB,0,M,NATIONAL CAPITAL TERRITORY OF DELHI,271544,271542,2,455114,257765,197349,0.03032207315090285,138,0.05082049317974251
41,ANIL KUMAR CHADHA,GEN,DELHI SADAR,127,8,IND,0,M,NATIONAL CAPITAL TERRITORY OF DELHI,271544,271542,2,455114,257765,197349,0.02790509630554103,127,0.04676958430309637
40,PRAMOD TIWARI,GEN,DELHI SADAR,126,6,PMP,0,M,NATIONAL CAPITAL TERRITORY OF DELHI,271544,271542,2,455114,257765,197349,0.027685371137780863,126,0.0464013198597649
54,PT NAND KISHOR MISHRA BABA,GEN,DELHI SADAR,124,5,ABHM,0,M,NATIONAL CAPITAL TERRITORY OF DELHI,271544,271542,2,455114,257765,197349,0.027245920802260536,124,0.045664790973101964
38,MD ZAHID,GEN,DELHI SADAR,88,9,IND,0,M,NATIONAL CAPITAL TERRITORY OF DELHI,271544,271542,2,455114,257765,197349,0.01933581476289457,88,0.032407271013169134
44,RAFIULLAH,GEN,DELHI SADAR,79,11,IND,0,M,NATIONAL CAPITAL TERRITORY OF DELHI,271544,271542,2,455114,257765,197349,0.01735828825305308,79,0.02909289102318593
39,DILDAR HUSSIN BEG,GEN,DELHI SADAR,53,10,IND,0,M,NATIONAL CAPITAL TERRITORY OF DELHI,271544,271542,2,455114,257765,197349,0.011645433891288776,53,0.019518015496567776
49,KRISHNA TIRATH,SC,KAROL BAGH (SC),138595,2,INC,1,F,NATIONAL CAPITAL TERRITORY OF DELHI,249185,249184,1,3368399,1911438,1456961,4.114595687743643,138596,55.61972028813933
42,ANITA ARYA,SC,KAROL BAGH (SC),100967,1,BJP,0,F,NATIONAL CAPITAL TERRITORY OF DELHI,249185,249184,1,3368399,1911438,1456961,2.9974774366100925,100967,40.518891586572224
45,SATYA PAL SINGH,SC,KAROL BAGH (SC),6634,3,BSP,0,M,NATIONAL CAPITAL TERRITORY OF DELHI,249185,249184,1,3368399,1911438,1456961,0.19694816439501378,6634,2.6622790296366152
37,SAROJ,SC,KAROL BAGH (SC),987,14,IND,0,F,NATIONAL CAPITAL TERRITORY OF DELHI,249185,249184,1,3368399,1911438,1456961,0.02930175433492291,987,0.39609125749944823
38,YUDHVEER SINGH,SC,KAROL BAGH (SC),386,5,SJP(R),0,M,NATIONAL CAPITAL TERRITORY OF DELHI,249185,249184,1,3368399,1911438,1456961,0.011459450023586873,386,0.15490499026827456
45,SATISH KUMAR,SC,KAROL BAGH (SC),349,13,IND,0,M,NATIONAL CAPITAL TERRITORY OF DELHI,249185,249184,1,3368399,1911438,1456961,0.010361005332206784,349,0.14005658446535707
35,LAJPAT RAI,SC,KAROL BAGH (SC),299,12,IND,0,M,NATIONAL CAPITAL TERRITORY OF DELHI,249185,249184,1,3368399,1911438,1456961,0.008876620614125584,299,0.11999117121817124
45,GHAN SHYAM MORWAL,SC,KAROL BAGH (SC),260,4,DBP,0,M,NATIONAL CAPITAL TERRITORY OF DELHI,249185,249184,1,3368399,1911438,1456961,0.007718800534022246,260,0.10434014888536629
69,KISHAN PYARI,SC,KAROL BAGH (SC),171,7,IND,0,F,NATIONAL CAPITAL TERRITORY OF DELHI,249185,249184,1,3368399,1911438,1456961,0.005076595735837708,171,0.06862371330537552
60,DR P L PREMI,SC,KAROL BAGH (SC),137,10,IND,0,M,NATIONAL CAPITAL TERRITORY OF DELHI,249185,249184,1,3368399,1911438,1456961,0.004067214127542491,137,0.05497923229728916
53,BABU LAL,SC,KAROL BAGH (SC),122,11,IND,0,M,NATIONAL CAPITAL TERRITORY OF DELHI,249185,249184,1,3368399,1911438,1456961,0.0036218987121181307,122,0.04895960832313342
32,RAM BAHAU RAWAT,SC,KAROL BAGH (SC),122,6,RSBP,0,M,NATIONAL CAPITAL TERRITORY OF DELHI,249185,249184,1,3368399,1911438,1456961,0.0036218987121181307,122,0.04895960832313342
43,PRASHOTTAM DASS GUGRODIYA,SC,KAROL BAGH (SC),81,9,IND,0,M,NATIONAL CAPITAL TERRITORY OF DELHI,249185,249184,1,3368399,1911438,1456961,0.002404703243291546,81,0.03250596946044104
46,PALUSKAR KRHISHANARAO,SC,KAROL BAGH (SC),74,8,IND,0,M,NATIONAL CAPITAL TERRITORY OF DELHI,249185,249184,1,3368399,1911438,1456961,0.0021968893827601778,74,0.02969681160583502
55,DR P POOKUNHIKOYA,ST,LAKSHADWEEP (ST),15597,4,JD(U),0,M,LAKSHADWEEP,31820,31820,0,39033,19880,19153,39.958496656675116,15597,49.01634192331867
62,P M SAYEED,ST,LAKSHADWEEP (ST),15526,1,INC,0,M,LAKSHADWEEP,31820,31820,0,39033,19880,19153,39.77659928778213,15526,48.79321181646763
60,E P ATTAKOYA THANGAL,ST,LAKSHADWEEP (ST),468,3,JP,0,M,LAKSHADWEEP,31820,31820,0,39033,19880,19153,1.1989854738298362,468,1.4707730986800756
34,AMEER PUTHIYATHANODA,ST,LAKSHADWEEP (ST),229,2,SP,0,M,LAKSHADWEEP,31820,31820,0,39033,19880,19153,0.5866830630492148,229,0.7196731615336267
54,RAMADASS M,GEN,PONDICHERRY,241643,1,PMK,10,M,PONDICHERRY,483816,483800,16,636667,310658,326009,37.95594871416298,241653,49.947294012599826
45,LALITHA KUMARAMANGALAM,GEN,PONDICHERRY,172466,3,BJP,6,F,PONDICHERRY,483816,483800,16,636667,310658,326009,27.089828748780757,172472,35.6482629760074
52,K NAMBIYAR,GEN,PONDICHERRY,27546,5,JD(U),0,M,PONDICHERRY,483816,483800,16,636667,310658,326009,4.3265945934059715,27546,5.693486780098219
31,P R N THIRUMURUGAN,GEN,PONDICHERRY,10930,17,IND,0,M,PONDICHERRY,483816,483800,16,636667,310658,326009,1.7167530278779957,10930,2.259123303073896
54,Z M TAHER,GEN,PONDICHERRY,5175,16,IND,0,M,PONDICHERRY,483816,483800,16,636667,310658,326009,0.8128267995671207,5175,1.069621509003423
49,THANGA DEVADAS,SC,PONDICHERRY,4085,15,IND,0,M,PONDICHERRY,483816,483800,16,636667,310658,326009,0.6416227007210992,4085,0.8443292491360351
26,S SYAD FARUK,GEN,PONDICHERRY,3172,14,IND,0,M,PONDICHERRY,483816,483800,16,636667,310658,326009,0.49821963443998196,3172,0.6556211452287647
40,M RANGADAS,SC,PONDICHERRY,2891,19,IND,0,M,PONDICHERRY,483816,483800,16,636667,310658,326009,0.45408353189343875,2891,0.5975412140152455
36,THANGA KALAIMARAN,SC,PONDICHERRY,2665,2,BSP,0,M,PONDICHERRY,483816,483800,16,636667,310658,326009,0.4185861682794931,2665,0.5508292408684293
28,P ANBURAJ,GEN,PONDICHERRY,1684,8,IND,0,M,PONDICHERRY,483816,483800,16,636667,310658,326009,0.26450247931807364,1684,0.34806620698778046
58,S PONNURANGAM,GEN,PONDICHERRY,1601,7,JP,0,M,PONDICHERRY,483816,483800,16,636667,310658,326009,0.2514658369288812,1601,0.33091092481439227
43,V RAMAMURTHY,GEN,PONDICHERRY,1571,21,IND,0,M,PONDICHERRY,483816,483800,16,636667,310658,326009,0.24675379751110077,1571,0.3247102204143724
45,S BALASUBRAMANIAN,GEN,PONDICHERRY,1359,6,CPI(ML)(L),0,M,PONDICHERRY,483816,483800,16,636667,310658,326009,0.21345538562545255,1359,0.28089190932089886
54,G SUNDARAMOORTHY,GEN,PONDICHERRY,1328,4,RJD,0,M,PONDICHERRY,483816,483800,16,636667,310658,326009,0.20858627822707945,1328,0.2744845147742117
29,N SABITH,GEN,PONDICHERRY,1158,12,IND,0,M,PONDICHERRY,483816,483800,16,636667,310658,326009,0.18188472152632382,1158,0.2393471898407659
33,N SENTHILMURUGAN,GEN,PONDICHERRY,977,13,IND,0,M,PONDICHERRY,483816,483800,16,636667,310658,326009,0.15345541703904866,977,0.20193627329397953
49,E KUPPAN,GEN,PONDICHERRY,906,11,IND,0,M,PONDICHERRY,483816,483800,16,636667,310658,326009,0.14230359041696836,906,0.18726127288059924
49,J RAMADASS,GEN,PONDICHERRY,894,20,IND,0,M,PONDICHERRY,483816,483800,16,636667,310658,326009,0.1404187746498562,894,0.1847809911205913
46,S ELANGOVAN,GEN,PONDICHERRY,673,9,IND,0,M,PONDICHERRY,483816,483800,16,636667,310658,326009,0.10570675093887386,673,0.1391024687071118
39,G KRISHNARAJ,GEN,PONDICHERRY,556,10,IND,0,M,PONDICHERRY,483816,483800,16,636667,310658,326009,0.08732979720953025,556,0.1149197215470344
30,R NATARAJAN,GEN,PONDICHERRY,520,18,IND,0,M,PONDICHERRY,483816,483800,16,636667,310658,326009,0.08167534990819376,520,0.10747887626701061
